facility_id,infant_capacity,toddler_capacity,preschool_capacity,school_age_capacity,children_capacity,total_capacity,latitude,longitude,zip_code_cleaned
40163,0,10,110,0,0,120,41.089425,-73.920413,10960
41016,0,0,0,75,0,75,42.607043,-73.788606,12077
51349,0,0,0,0,6,6,40.818399,-73.888816,10474
73544,0,0,0,60,0,60,40.753216,-73.970794,10017
126425,0,0,0,0,12,12,40.841228,-73.823572,10465
135331,0,0,20,0,0,20,44.847878,-74.297567,12953
173555,0,0,85,0,0,85,42.574853,-76.216804,13045
234238,0,0,0,4,12,16,40.865752,-73.847882,10469
250057,0,0,0,240,0,240,40.819564,-73.848827,10473
262387,0,0,112,0,0,112,41.404252,-74.335359,10924
269090,0,0,0,15,0,15,40.721854,-73.903974,11378
274852,0,0,0,0,12,12,40.839556,-73.868169,10460
349917,0,0,0,0,10,10,40.830097,-73.921286,10452
386539,0,0,0,0,12,12,40.82677,-73.925507,10451
407335,0,0,0,44,0,44,43.052888,-78.957791,14072
414911,0,12,108,0,0,120,40.810875,-73.337204,11746
420887,0,0,30,0,0,30,41.093378,-73.814548,10532
461005,0,0,0,38,0,38,40.950933,-72.891727,11786
479379,0,0,0,4,12,16,43.237512,-75.447474,13440
496065,0,24,36,0,0,60,40.630779,-73.730383,11516
500895,0,0,0,4,12,16,40.820518,-73.854203,10473
545295,0,0,34,0,0,34,42.090366,-76.802279,14901
597006,0,0,0,0,6,6,40.844991,-73.884606,10460
620002,0,0,0,4,12,16,40.735085,-73.775096,11366
624233,0,0,0,245,0,245,40.84489,-73.858149,10462
659438,0,0,0,2,6,8,42.322848,-77.65388,14843
666034,16,23,34,20,0,93,42.894966,-78.508942,14004
675105,8,7,0,0,0,15,41.474747,-74.906077,12719
677764,0,0,0,180,0,180,40.647388,-73.891883,11236
689575,0,0,0,40,0,40,40.8071,-73.936369,10035
694283,0,24,0,0,0,24,43.185724,-77.473961,14580
699643,0,0,0,4,12,16,40.870249,-73.879746,10467
718461,0,0,0,100,0,100,42.941018,-76.5818,13021
720363,0,0,0,206,0,206,40.866987,-73.8508,10469
749905,0,0,0,40,0,40,40.843684,-73.784915,10464
781415,0,0,0,0,12,12,40.704553,-73.961388,11211
789544,0,0,0,0,12,12,40.636363,-73.980547,11218
791237,0,0,0,284,0,284,40.707164,-73.959423,11211
799481,0,0,0,152,0,152,40.646041,-73.673402,11563
818672,0,0,0,100,0,100,40.71236,-73.998909,10038
820511,0,0,0,20,0,20,42.72039,-77.869133,14510
825327,0,0,0,100,0,100,40.743341,-73.922791,11104
826115,0,0,0,62,0,62,40.763979,-73.985859,10019
831636,0,0,0,101,0,101,40.695267,-73.959658,11205
855006,0,0,0,100,0,100,42.595,-74.328966,12122
863516,0,42,95,0,0,137,40.801287,-73.433853,11747
874544,8,8,9,0,0,25,43.289831,-77.792299,14468
875372,0,0,0,60,0,60,40.954419,-73.726328,10543
875675,0,0,0,196,0,196,40.63544,-73.910885,11236
884416,0,0,0,2,6,8,42.626832,-76.469025,13092
885578,0,0,0,0,10,10,40.837575,-73.889189,10460
886656,0,0,0,4,12,16,40.831951,-73.851559,10462
888739,0,0,0,80,0,80,40.814984,-73.889068,10474
890556,0,0,0,57,0,57,40.7614,-73.5934,11590
892915,0,0,0,4,12,16,44.61004,-73.606143,12985
893252,0,0,0,105,0,105,40.932711,-73.887081,10701
894399,0,0,0,100,0,100,40.628558,-73.928246,11234
897056,0,0,18,0,0,18,43.205253,-77.613214,14617
905586,0,0,18,20,0,38,42.743784,-78.797903,14075
905995,0,0,0,4,12,16,41.128,-74.0668,10952
907572,24,29,10,0,0,63,41.080223,-73.863874,10591
914947,0,0,0,0,12,12,43.127918,-75.725644,13032
918817,8,23,28,0,0,59,41.048039,-71.952191,11954
921326,0,0,0,0,6,6,42.403399,-76.474761,14850
166018,8,24,18,0,0,50,43.352914,-73.656306,12804
40572,0,0,157,0,0,157,40.925379,-73.902449,10705
42263,0,0,0,160,0,160,43.13112,-76.236617,13090
10094,0,0,0,2,6,8,44.237606,-76.083991,13624
866209,0,0,0,243,0,243,41.096188,-73.986627,10994
568414,0,0,0,4,12,16,40.877149,-73.909284,10463
618944,0,0,0,4,12,16,40.684625,-73.924133,11233
732938,0,0,0,4,12,16,41.480766,-74.360879,10941
603731,0,0,0,4,12,16,42.923403,-78.833442,14215
840230,0,0,0,4,12,16,40.595291,-73.761357,11691
881862,0,0,0,4,12,16,40.664341,-73.958775,11225
53014,0,0,0,2,6,8,40.670309,-73.865678,11208
172380,0,0,0,4,12,16,40.559204,-74.125539,10306
769206,0,0,0,79,0,79,40.823296,-73.903164,10456
267366,0,0,0,4,12,16,40.63394,-73.950656,11210
791983,0,0,0,4,12,16,40.815962,-73.937661,10037
576262,0,0,0,2,6,8,40.816245,-73.862879,10473
74215,0,0,0,152,0,152,40.84928,-73.931431,10033
585734,0,0,0,4,12,16,40.647348,-74.011331,11220
607560,0,0,0,4,12,16,40.834317,-73.918321,10452
43269,8,10,48,20,0,86,43.330031,-73.647786,12804
841495,0,0,0,4,12,16,40.918421,-73.899095,10705
251464,0,0,0,4,12,16,40.698064,-73.91312,11237
728553,0,0,0,295,0,295,40.823491,-73.859805,10473
842127,0,0,0,4,12,16,40.917188,-73.895963,10705
815237,0,0,0,4,12,16,40.630146,-73.980706,11204
233516,0,0,0,40,0,40,40.838976,-73.910195,10457
647797,0,0,0,2,6,8,40.694618,-73.749959,11412
367235,0,0,0,4,12,16,40.684076,-73.918325,11233
867682,0,0,0,2,12,14,40.87136,-73.885563,10458
404046,0,0,0,2,12,14,40.645574,-73.963485,11226
73477,0,0,0,41,0,41,40.720388,-73.990992,10002
794955,0,0,0,4,12,16,40.624681,-73.978301,11204
72446,0,0,0,4,12,16,40.729852,-73.981527,10009
405628,0,0,0,4,12,16,40.682021,-73.855402,11416
216690,0,0,0,4,12,16,40.662905,-73.886155,11207
807903,0,0,0,2,12,14,40.844611,-73.911004,10457
823180,0,0,0,4,12,16,42.281603,-76.001242,13862
41550,0,0,0,125,0,125,43.112521,-76.173933,13088
732829,0,0,0,4,12,16,40.695873,-73.734437,11411
806808,8,10,26,10,0,54,44.930643,-74.883393,13662
449081,0,0,0,4,12,16,40.680565,-73.993092,11231
754427,0,0,0,53,0,53,40.835578,-73.90729,10456
378047,0,0,0,4,12,16,40.66575,-73.955458,11225
125354,0,0,0,4,12,16,40.69585,-73.891985,11385
573635,0,0,0,4,12,16,40.875861,-73.886327,10468
876851,0,0,0,4,12,16,40.712626,-73.911618,11385
858758,0,0,0,4,12,16,40.842716,-73.892266,10457
104200,8,12,69,0,0,89,41.425978,-74.158214,10992
154810,0,0,0,20,0,20,41.021809,-73.775925,10606
703767,0,0,0,4,12,16,40.915638,-73.841309,10550
581474,0,0,0,2,6,8,43.174012,-77.647765,14613
817412,0,0,0,2,6,8,42.736291,-73.841222,12205
375871,0,0,0,2,6,8,42.556886,-76.279423,13045
71190,0,0,0,4,12,16,40.790056,-73.968408,10025
735281,0,0,0,4,12,16,44.106619,-75.757271,13637
860161,0,0,0,77,0,77,40.793035,-73.951818,10029
565291,0,0,0,4,12,16,42.321466,-77.369144,14810
670507,0,0,0,2,6,8,40.872053,-73.361427,11740
40522,0,0,0,118,0,118,41.312836,-73.872196,10547
774636,0,0,0,4,12,16,40.852559,-73.933154,10033
368551,0,0,0,4,12,16,40.903516,-73.853622,10470
531505,0,0,0,4,12,16,42.515644,-77.518472,14826
853035,0,0,0,2,6,8,40.822194,-73.91239,10451
671714,0,0,0,4,12,16,40.889837,-73.831954,10466
824922,0,0,0,4,12,16,40.631946,-74.151345,10303
593803,0,0,0,4,12,16,40.876002,-73.858896,10469
709773,0,0,0,288,0,288,40.663881,-73.948373,11225
232581,0,0,0,200,0,200,40.821213,-73.825745,10465
395736,0,0,43,0,0,43,41.337485,-74.191084,10950
653486,0,0,0,4,12,16,43.034662,-75.603397,13409
43147,0,0,0,80,0,80,41.206405,-74.014782,10984
629294,0,0,0,4,12,16,40.831057,-73.921963,10452
72052,0,0,0,4,12,16,40.661967,-73.960425,11225
725643,0,0,0,4,12,16,40.825997,-73.907222,10456
786035,0,0,0,2,12,14,40.847764,-73.911001,10453
37893,0,0,0,2,6,8,42.866512,-78.271295,14011
527438,0,0,0,4,12,16,40.841252,-73.890454,10460
819527,0,0,0,4,12,16,40.867416,-73.851279,10469
846483,0,0,0,4,12,16,40.659866,-73.597891,11520
245090,0,0,0,4,12,16,40.640515,-73.9664,11218
59615,0,0,0,2,6,8,40.691715,-73.970174,11205
19168,0,0,0,4,12,16,41.539397,-73.724103,12582
693176,0,0,0,4,12,16,40.813154,-73.925272,10451
668643,0,0,0,4,12,16,41.818739,-74.066372,12561
257563,0,0,0,2,6,8,43.143995,-73.663532,12831
115986,0,0,0,4,12,16,40.85149,-73.93702,10033
44376,0,0,0,70,0,70,40.792691,-73.492324,11803
848494,0,0,0,4,12,16,40.596268,-73.774649,11691
851783,0,0,0,39,0,39,40.576555,-73.854043,11694
876491,0,0,0,2,6,8,40.853237,-73.909183,10453
44198,0,0,0,56,0,56,40.815509,-73.341519,11746
189651,0,0,0,2,12,14,40.711363,-73.906321,11385
192358,16,29,55,0,0,100,40.842561,-72.996569,11763
761379,0,0,0,4,12,16,44.296853,-75.399533,13642
450336,0,0,0,80,0,80,40.773826,-73.727001,11020
269754,0,0,0,2,12,14,40.849668,-73.937728,10033
396328,0,0,0,2,12,14,40.896639,-73.835665,10550
434713,0,0,0,2,12,14,40.836271,-73.902447,10456
836222,0,0,0,4,12,16,40.842518,-73.919922,10452
308883,0,0,0,4,12,16,40.616104,-74.082802,10304
41122,0,0,0,44,0,44,42.764913,-73.77952,12110
384626,0,0,0,4,12,16,41.303077,-73.914153,10566
623209,0,0,0,4,12,16,40.694482,-73.912735,11221
436306,0,0,0,2,12,14,40.854363,-73.899961,10457
838974,0,0,0,0,8,8,40.815483,-73.904693,10455
865285,0,0,0,0,9,9,40.61556,-73.755217,11096
201111,0,0,0,40,0,40,41.198586,-73.965845,10927
859768,0,0,0,50,0,50,42.128296,-76.039848,13760
199979,0,0,0,44,0,44,44.185619,-73.444361,12993
812950,0,0,0,0,12,12,40.837322,-73.856323,10462
266584,0,0,0,4,12,16,40.756719,-73.890111,11370
157449,0,0,47,0,0,47,42.469527,-75.064281,13820
485412,0,0,0,4,12,16,40.686606,-73.802758,11435
597346,0,0,0,4,12,16,40.647348,-74.011331,11220
160474,0,0,0,4,12,16,40.625009,-73.959237,11230
71901,0,0,0,2,12,14,40.629725,-74.106154,10310
759884,0,0,0,45,0,45,40.697738,-73.94609,11206
499128,0,0,0,2,6,8,40.818105,-73.940124,10030
145182,0,0,0,2,6,8,40.876322,-73.908645,10463
533406,0,0,0,4,12,16,40.599807,-73.992622,11214
773593,0,0,0,4,12,16,43.623932,-76.128552,13142
846720,0,0,0,4,12,16,40.918277,-73.292297,11768
765038,0,0,0,60,0,60,40.817657,-73.952936,10027
682310,0,0,0,110,0,110,40.96278,-73.878007,10703
873512,0,0,0,111,0,111,40.675123,-73.915349,11233
742495,0,0,0,97,0,97,40.792005,-73.95131,10029
627333,0,0,0,4,12,16,40.848144,-73.919266,10453
73945,0,0,0,74,0,74,40.79748,-73.941356,10029
659002,0,0,0,4,12,16,40.856473,-73.866754,10462
247489,0,0,0,2,12,14,40.8249772,-73.939092,10039
780092,0,0,0,2,6,8,43.097792,-79.036797,14301
749569,0,0,0,2,12,14,40.824083,-73.927082,10451
873202,0,0,0,4,12,16,44.598042,-75.592767,13669
150676,0,0,0,2,6,8,40.675663,-73.7651,11434
549304,0,0,0,4,12,16,40.822662,-73.912646,10451
412066,0,0,0,4,12,16,40.885975,-73.221279,11754
875558,0,0,0,2,6,8,43.148147,-76.402318,13027
560404,21,32,50,9,0,112,43.250953,-77.42023,14580
796280,0,0,0,60,0,60,41.957781,-73.995535,12401
770510,0,0,0,4,12,16,40.759672,-73.886886,11370
709769,0,0,0,257,0,257,40.848415,-73.892923,10457
348597,0,0,0,4,12,16,43.14147,-77.628007,14608
882466,0,0,0,4,12,16,40.841468,-73.913847,10452
736108,0,0,0,13,0,13,40.631467,-73.977107,11218
873026,32,58,65,16,0,171,40.850181,-73.165169,11787
391334,0,0,0,2,12,14,40.590407,-73.788551,11692
109408,0,0,0,4,12,16,43.048454,-73.872747,12020
316120,8,12,53,19,0,92,43.289045,-77.79799,14468
140142,0,0,0,2,12,14,40.919269,-73.902473,10705
854082,0,0,0,260,0,260,40.817224,-73.897428,10459
183462,0,0,0,4,12,16,40.649656,-73.935175,11203
683420,0,0,0,4,12,16,40.867935,-73.892547,10458
374580,0,0,0,4,12,16,40.831614,-73.921635,10452
39739,10,10,30,0,0,50,43.151726,-77.581735,14607
497314,0,0,0,2,6,8,40.805339,-73.128234,11779
359590,0,0,0,4,12,16,40.76079,-73.865331,11369
73173,0,0,0,22,0,22,40.709215,-73.947372,11206
43801,8,24,30,17,0,79,40.942349,-73.898336,10701
857791,0,0,0,4,12,16,40.885226,-73.904494,10463
848648,0,0,0,4,12,16,40.632285,-74.118826,10310
348885,0,0,0,216,0,216,40.757339,-73.926471,11106
470395,0,0,0,4,12,16,40.583993,-73.952815,11235
826888,0,0,0,2,6,8,43.267468,-77.682517,14612
852588,0,0,0,4,12,16,40.700877,-73.600258,11553
877214,0,0,0,50,0,50,42.522819,-73.709787,12033
882804,0,0,0,4,12,16,40.840834,-73.915176,10452
105304,16,34,32,28,0,110,42.9596,-77.1355,14432
633347,0,0,0,4,12,16,40.667743,-73.613421,11510
691172,0,0,0,2,6,8,42.098731,-76.821975,14901
856018,0,0,0,4,12,16,43.19767,-77.647673,14615
320468,0,0,0,2,6,8,43.017916,-74.373375,12095
280643,0,0,0,0,10,10,40.709794,-73.764859,11423
762562,0,17,45,30,0,92,40.902596,-73.271061,11768
847573,0,0,0,50,0,50,40.815996,-73.94497,10030
771629,0,0,0,40,0,40,41.503868,-73.977409,12508
791222,0,0,0,4,12,16,40.698016,-73.613259,11550
834754,0,0,0,4,12,16,40.661572,-73.572481,11520
210254,0,0,0,20,0,20,42.474374,-73.798405,12045
808574,0,0,0,4,12,16,40.922561,-73.825381,10552
256209,0,0,0,50,0,50,40.791477,-73.419602,11747
44760,0,0,121,8,0,129,40.845205,-72.840799,11949
748366,0,0,0,122,0,122,40.541666,-74.218138,10309
41808,8,8,18,5,0,39,41.611728,-73.988117,12542
873903,0,5,27,0,0,32,40.7784,-73.0314,11772
837597,0,0,0,84,0,84,40.748836,-73.99981,10001
558681,0,0,0,2,12,14,43.253137,-77.376331,14580
663091,0,0,0,2,12,14,40.861838,-73.927969,10040
874794,0,0,0,4,12,16,40.877515,-73.88201,10467
42407,12,34,55,18,0,119,42.903772,-78.743997,14227
260215,0,0,144,0,0,144,43.176003,-77.57422,14609
825716,0,0,0,2,6,8,40.885278,-73.852072,10466
782903,0,0,0,0,10,10,40.844839,-73.882689,10460
863025,0,0,0,80,0,80,40.641094,-73.898145,11236
327715,0,0,0,4,12,16,40.735711,-73.852938,11375
350876,0,0,0,0,6,6,40.871241,-73.898752,10468
35326,0,0,0,2,6,8,42.28782,-77.239131,14879
40519,16,24,55,0,0,95,41.070392,-73.811347,10523
380479,0,0,0,2,6,8,40.685015,-73.823362,11419
43207,0,0,0,20,0,20,43.979962,-75.597314,13619
872586,0,0,0,2,6,8,40.803345,-73.965097,10025
747457,0,0,0,4,12,16,40.684824,-73.961562,11238
713400,0,0,0,4,12,16,42.837304,-77.661183,14487
569517,0,0,0,4,12,16,40.880364,-73.849526,10469
663199,0,0,0,4,12,16,40.857319,-73.901051,10453
855294,24,52,63,51,0,190,42.870733,-73.740235,12065
779797,0,0,0,4,12,16,42.910171,-78.788058,14211
218090,0,0,0,4,12,16,40.823717,-73.818666,10465
756767,0,0,0,2,6,8,43.194013,-77.630917,14615
315852,0,0,74,0,0,74,42.086271,-76.836638,14905
790906,0,0,0,60,0,60,40.580546,-73.96593,11235
845466,0,0,0,2,6,8,40.854172,-73.900434,10457
128258,0,0,0,4,12,16,40.76157,-73.273919,11706
833947,0,0,0,2,6,8,40.645393,-73.589316,11520
42273,0,0,18,0,0,18,42.338312,-75.166739,13775
118175,0,0,0,62,0,62,40.668804,-73.983502,11215
878046,0,0,0,4,12,16,40.666852,-73.734463,11422
489165,0,0,0,4,12,16,40.625378,-73.920589,11234
715923,0,0,0,4,12,16,40.6808,-73.6545,11552
50495,0,0,0,2,6,8,40.861707,-73.863448,10467
366303,0,0,21,0,0,21,42.080716,-78.449508,14760
800709,0,0,0,267,0,267,40.740697,-73.808758,11365
865950,0,0,0,4,12,16,44.584456,-73.543836,12972
863615,0,0,0,2,6,8,43.137702,-76.224048,13090
362595,0,0,0,2,10,12,40.870237,-73.899768,10468
673741,0,0,0,2,6,8,43.038359,-76.17095,13204
248479,0,0,0,4,12,16,41.374496,-73.630372,10509
880325,0,0,0,4,12,16,40.65331,-73.926459,11203
603426,0,0,0,4,12,16,40.831847,-73.895986,10459
606328,0,0,0,4,12,16,40.770135,-73.773849,11361
230920,0,0,0,260,0,260,40.703812,-73.811993,11435
665593,0,0,0,4,12,16,40.632746,-73.957515,11210
39871,0,36,43,0,0,79,40.787,-73.715082,11021
765858,0,0,0,4,12,16,40.705252,-73.713518,11003
120214,0,0,0,4,12,16,40.632896,-73.941651,11210
222097,32,69,83,20,0,204,40.737996,-73.651878,11501
680477,0,0,0,2,6,8,40.816035,-73.907376,10455
212911,0,0,0,4,12,16,40.813027,-73.901705,10455
379420,0,0,0,4,12,16,40.640109,-74.135627,10302
867998,0,0,0,50,0,50,43.188488,-77.612831,14621
767618,0,0,0,4,12,16,40.857319,-73.901051,10453
812935,0,0,0,80,0,80,40.686178,-73.917285,11233
802791,0,0,0,4,12,16,40.667359,-73.656168,11570
43618,0,10,15,15,0,40,41.71512,-74.084675,12561
42761,0,0,0,60,0,60,41.2518,-73.9378,10548
139195,0,0,0,199,0,199,40.78531,-73.941321,10029
39686,25,30,30,0,0,85,43.096911,-77.587081,14623
778826,0,0,0,4,12,16,43.05981,-76.203833,13209
228794,0,0,0,2,6,8,42.78294,-73.714182,12047
543420,0,0,0,4,12,16,40.860186,-73.864816,10467
650114,0,0,0,2,6,8,40.632167,-73.8993,11236
323057,0,0,0,4,12,16,44.375494,-75.794066,13646
653844,0,0,0,4,12,16,40.850369,-73.939867,10033
385789,0,0,0,4,12,16,40.839549,-73.867099,10460
844004,0,0,0,4,12,16,40.828826,-73.824784,10465
863815,0,0,0,4,12,16,40.838582,-73.925661,10452
647000,0,0,0,2,6,8,42.827377,-78.735811,14224
702707,0,0,0,4,12,16,40.787222,-73.97354,10024
28164,0,0,0,2,6,8,41.72029,-73.870903,12603
675147,0,0,0,4,12,16,40.829269,-73.881397,10472
640154,0,0,0,4,12,16,40.852224,-73.885987,10458
615697,0,0,0,4,12,16,40.770489,-73.931268,11102
42566,16,20,21,0,0,57,43.094699,-75.27745,13413
684285,0,0,0,4,12,16,40.59674,-74.070921,10305
850098,0,0,0,4,12,16,43.049495,-76.175758,13204
832155,16,58,81,18,0,173,40.772689,-73.310798,11729
9,0,0,0,4,12,16,42.696243,-73.85138,12203
882480,0,0,0,4,12,16,40.831422,-73.892071,10459
374050,0,0,0,2,6,8,41.810724,-74.628172,12788
838028,0,0,0,4,12,16,40.674486,-73.998022,11231
704290,0,0,0,4,12,16,43.186088,-77.631296,14613
709788,0,0,0,160,0,160,40.667074,-73.951143,11225
711974,0,0,0,4,12,16,40.766668,-73.337982,11729
795812,0,0,0,4,12,16,40.7742,-73.9908,10069
851494,32,50,60,10,0,152,40.738317,-73.419422,11735
44247,0,0,0,40,0,40,41.333184,-74.367564,10921
839631,0,0,0,4,12,16,40.679776,-73.962686,11238
823379,0,0,0,0,12,12,40.814971,-73.866622,10473
694557,0,0,0,260,0,260,40.670824,-73.845487,11417
644259,0,0,0,2,6,8,43.408702,-73.263605,12832
880446,0,0,0,4,12,16,40.846589,-73.885351,10460
463666,0,0,0,4,12,16,40.652085,-73.937869,11203
874914,0,0,0,2,6,8,40.871521,-73.888089,10458
795781,0,0,0,4,12,16,40.824311,-73.88082,10472
878445,0,0,0,0,6,6,40.845852,-73.865193,10462
841154,0,0,0,4,12,16,43.24476,-77.658196,14616
661425,0,0,0,4,12,16,40.637469,-73.922253,11234
789628,0,0,0,4,12,16,40.907541,-73.830157,10550
41300,0,12,69,21,0,102,41.513641,-73.605487,12563
804777,0,0,0,182,0,182,40.685309,-73.993334,11201
339144,0,0,0,200,0,200,40.632703,-73.924262,11234
868654,0,0,0,77,0,77,41.050505,-73.817733,10523
875901,0,0,0,4,12,16,43.819463,-75.475019,13367
40131,24,28,158,0,0,210,42.780963,-73.671535,12182
868806,0,0,0,100,0,100,40.758881,-73.567324,11590
520607,0,0,0,4,12,16,40.800639,-73.956057,10026
685059,0,0,0,4,12,16,40.634895,-73.996712,11219
875795,0,0,0,4,12,16,40.600831,-73.976223,11223
470323,0,0,0,4,12,16,40.864905,-73.90289,10468
709709,0,0,0,120,0,120,40.848597,-73.908567,10453
726636,0,0,0,2,6,8,40.697198,-73.977255,11205
40659,12,22,40,0,0,74,41.385913,-74.280851,10924
494077,0,0,0,4,12,16,40.70418,-73.696821,11003
799509,0,0,0,4,12,16,40.650555,-73.598688,11520
115368,0,0,0,4,12,16,40.660641,-73.912001,11212
813459,0,0,0,320,0,320,40.75588,-73.772459,11361
802027,0,0,0,85,0,85,40.653779,-73.710514,11582
733880,0,0,0,4,12,16,40.663877,-73.738387,11422
641819,0,0,0,4,12,16,40.690432,-73.854874,11421
820587,0,0,0,2,6,8,42.83528,-75.560992,13346
867310,0,0,0,4,12,16,42.79938,-73.915028,12304
45171,16,36,21,0,0,73,43.050213,-76.153733,13261
877469,0,0,0,86,0,86,43.130629,-77.550099,14610
682013,0,0,0,4,12,16,40.637365,-73.913797,11236
817984,0,0,0,285,0,285,40.648912,-73.956363,11226
135779,0,0,0,4,12,16,40.657164,-73.916837,11212
596921,0,0,0,4,12,16,43.173454,-77.614128,14605
865469,0,12,33,0,0,45,40.760387,-72.935463,11713
134999,0,0,0,4,12,16,40.630949,-73.940482,11210
512675,0,0,0,4,12,16,40.846759,-73.923743,10453
532996,0,0,0,20,0,20,42.90824,-77.73923,14414
669953,0,0,0,2,12,14,40.858622,-73.905803,10453
12738,0,0,0,4,12,16,42.988958,-78.701353,14221
769739,0,0,0,2,6,8,42.716905,-77.293496,14507
761930,0,0,0,0,12,12,40.825904,-73.9229,10451
73013,0,0,0,244,0,244,40.836082,-73.928784,10452
878935,0,0,0,2,6,8,40.839451,-73.926419,10452
186523,0,0,0,130,0,130,40.634214,-74.097545,10301
848694,0,0,0,2,6,8,43.171617,-76.346309,13027
741920,0,0,0,86,0,86,40.708788,-74.002278,10038
880730,0,0,0,4,12,16,40.664446,-73.605728,11510
73114,0,0,0,100,0,100,40.690587,-73.950656,11216
498220,0,0,0,4,12,16,40.630572,-73.897537,11236
775515,0,0,0,4,12,16,40.727691,-73.804498,11366
43847,8,96,237,0,0,341,43.171166,-77.618348,14605
281163,0,0,0,4,12,16,40.753993,-73.868059,11368
824184,0,0,0,66,0,66,40.725041,-73.613772,11530
810805,0,0,0,0,12,12,43.111733,-79.048274,14305
101510,0,0,0,80,0,80,40.844797,-73.887251,10460
39761,0,0,0,172,0,172,43.091664,-77.443699,14450
401545,8,10,18,0,0,36,40.828455,-73.405421,11746
36889,0,0,0,2,6,8,43.091125,-79.043087,14301
702326,0,0,29,15,0,44,41.373619,-74.690895,12771
855554,0,0,0,4,12,16,40.859776,-73.907411,10468
180637,0,0,0,0,12,12,40.905373,-72.890201,11961
204151,0,0,0,4,12,16,40.629631,-73.902715,11236
869230,0,0,0,2,6,8,44.010616,-75.99583,13634
120981,0,0,0,306,0,306,40.72131,-73.986567,10002
349805,0,0,0,0,10,10,40.741652,-73.926458,11104
44473,8,12,21,0,0,41,41.234247,-73.703027,10507
872882,0,0,0,2,6,8,40.835154,-73.905486,10456
866628,0,0,0,4,12,16,43.15374,-77.715628,14624
577641,0,0,0,0,10,10,40.765341,-73.909242,11103
151224,0,0,0,4,12,16,40.863542,-73.89472,10458
818632,0,0,0,4,12,16,42.098879,-79.231428,14701
860513,0,0,14,56,0,70,42.862188,-77.001477,14456
335483,0,0,0,4,12,16,40.865088,-73.891588,10458
651687,0,0,0,4,12,16,40.83421,-73.921132,10452
743958,0,0,0,4,12,16,40.852326,-73.931737,10033
821738,16,21,46,34,0,117,42.312444,-77.658478,14843
852312,0,0,0,4,12,16,40.775612,-73.34578,11746
579209,0,0,0,4,12,16,40.870478,-73.889849,10458
645514,0,0,0,4,12,16,43.486657,-73.779966,12885
107869,0,0,95,0,0,95,42.795096,-73.924135,12304
283114,21,24,56,20,0,121,44.507593,-73.485668,12944
873653,0,0,0,2,6,8,40.823305,-73.917641,10451
879319,0,0,0,4,12,16,40.704209,-73.94027,11206
803420,0,0,47,32,0,79,43.103277,-77.466439,14450
39249,0,0,90,0,0,90,42.093753,-78.434242,14760
42838,0,0,0,91,0,91,40.831737,-73.698066,11050
766320,0,0,0,4,12,16,42.924103,-78.040868,14525
22152,0,0,0,2,6,8,43.110942,-76.151968,13212
627646,0,0,0,4,12,16,40.703877,-73.724569,11003
642608,0,0,0,2,12,14,40.827983,-73.920398,10451
349859,0,0,0,2,6,8,44.915172,-73.882648,12934
686600,0,0,0,4,12,16,40.594479,-74.067422,10305
874736,0,0,0,294,0,294,40.64617,-74.001798,11232
709965,0,0,0,75,0,75,43.302272,-76.419636,13069
700840,0,0,0,2,6,8,40.871721,-73.899359,10468
786945,0,0,0,57,0,57,40.6726,-73.928257,11213
875305,0,0,0,40,0,40,41.129208,-73.709766,10504
44545,0,0,0,80,0,80,41.003744,-73.835169,10502
383087,0,0,0,2,12,14,40.665786,-73.958547,11225
810401,0,0,0,4,12,16,40.867312,-73.885066,10458
761308,0,0,0,4,12,16,40.829893,-73.898116,10459
467968,0,0,0,4,12,16,40.681173,-73.844189,11417
39937,0,0,42,0,0,42,43.33949,-75.749264,13316
875253,0,0,0,4,12,16,40.816224,-73.899505,10455
830475,0,0,0,4,12,16,42.526687,-76.227773,13045
388051,0,0,0,2,12,14,40.594938,-73.754993,11691
761241,0,0,0,4,12,16,40.650877,-73.595474,11520
44145,0,0,0,40,0,40,42.922643,-78.703765,14043
845906,0,0,0,53,0,53,40.817779,-73.920839,10451
192915,40,44,32,30,0,146,43.034757,-78.820859,14228
223312,0,0,0,4,12,16,40.660039,-73.911375,11212
40298,0,0,30,0,0,30,40.932361,-72.966211,11764
264216,0,0,20,0,0,20,40.860101,-73.299786,11731
865585,0,0,0,4,12,16,42.776391,-73.898355,12304
41124,0,0,0,44,0,44,42.705983,-73.756651,12211
427223,0,0,0,4,12,16,40.669583,-73.589942,11520
685853,0,0,0,2,6,8,43.169497,-77.63578,14608
737411,0,0,0,2,6,8,43.093456,-75.211091,13501
849210,0,0,0,4,12,16,42.631066,-75.332137,13411
272103,0,0,0,2,5,7,40.738955,-73.859007,11368
761961,0,0,0,4,12,16,40.673216,-73.892149,11207
804642,0,0,0,4,12,16,40.890791,-73.86309,10466
788446,0,0,0,4,12,16,40.852495,-73.893618,10457
828741,0,0,0,2,12,14,40.6815,-73.865764,11208
131466,24,47,61,0,0,132,42.744181,-73.788829,12110
43041,8,20,14,15,0,57,42.878175,-78.813231,14206
174497,0,0,0,4,12,16,43.083543,-75.271397,13502
743353,0,0,0,200,0,200,40.728777,-73.890321,11378
836350,0,0,0,60,0,60,40.957927,-73.737975,10543
158798,0,0,0,13,0,13,41.612786,-73.988348,12542
763710,0,0,0,2,12,14,40.821678,-73.85916,10473
654100,0,0,0,4,12,16,40.853804,-73.929245,10040
261280,0,0,0,4,12,16,40.933681,-73.882694,10701
73557,0,0,0,141,0,141,40.712202,-73.996677,10002
534680,0,0,0,0,10,10,40.830935,-73.922774,10452
70653,0,0,0,2,6,8,40.687769,-73.97291,11205
16646,0,0,0,2,6,8,43.052039,-77.589334,14467
156188,0,17,63,0,0,80,40.622931,-73.720348,11516
546216,0,0,0,4,12,16,40.838885,-73.918084,10452
847164,0,0,17,0,0,17,40.97794,-73.881334,10701
712458,0,0,0,4,12,16,40.817887,-73.814729,10465
709684,0,0,0,80,0,80,40.827038,-73.818645,10465
874157,0,24,38,40,0,102,40.981919,-73.685585,10580
305058,0,0,0,4,12,16,42.923673,-78.88599,14213
854005,32,72,85,50,0,239,41.420951,-73.576899,10509
768279,0,0,0,0,12,12,40.834966,-73.885819,10460
538389,0,0,0,4,12,16,40.894136,-73.849592,10466
408535,0,0,0,4,12,16,43.191477,-77.639882,14613
731731,0,0,0,4,12,16,40.573923,-74.101734,10306
878595,0,0,0,60,0,60,42.769807,-73.904843,12304
709637,0,0,0,235,0,235,40.678282,-73.839646,11417
739393,0,0,0,4,12,16,42.915041,-78.799433,14211
441165,0,0,0,180,0,180,40.836461,-73.892784,10460
798524,0,0,0,2,6,8,40.870867,-73.890323,10468
787763,8,34,34,17,0,93,42.887574,-78.813411,14206
717364,0,0,101,0,0,101,41.786925,-73.935641,12538
847862,0,0,0,4,12,16,41.14562,-74.042516,10977
734457,0,0,0,250,0,250,40.883275,-73.891095,10463
853456,0,0,0,2,6,8,42.883458,-73.595046,12154
422386,0,0,0,4,12,16,40.655295,-73.936368,11203
610363,0,0,0,148,0,148,40.647057,-73.88145,11239
40714,16,24,50,0,0,90,43.053732,-76.124401,13203
41014,0,0,0,50,0,50,44.691352,-73.571817,12962
392860,0,0,0,0,10,10,40.856094,-73.903056,10453
45133,8,12,24,0,0,44,41.285859,-73.765891,10598
125444,0,0,0,4,12,16,40.884388,-73.855389,10466
26611,0,0,0,2,5,7,42.125219,-76.821762,14903
866329,0,0,0,2,6,8,42.727213,-76.761749,14541
31048,0,0,0,4,12,16,41.125866,-74.046811,10977
706211,0,0,0,4,12,16,40.852357,-73.937563,10033
816254,0,0,0,70,0,70,40.866265,-73.082417,11787
177617,0,0,0,40,0,40,42.077629,-79.220868,14701
233224,0,0,0,4,12,16,40.601037,-73.761555,11691
822545,0,0,0,2,6,8,44.73503,-73.684719,12918
652938,0,0,0,205,0,205,40.757339,-73.926471,11106
821932,0,0,0,4,12,16,42.087195,-76.838861,14905
869990,0,0,0,4,12,16,43.46583,-76.412614,13126
882115,0,0,0,13,0,13,40.754349,-73.855353,11368
679417,0,0,0,136,0,136,40.810501,-73.957398,10027
871559,0,0,0,2,6,8,43.297773,-76.140064,13036
43497,0,0,27,23,0,50,41.267417,-73.652482,10536
365706,0,0,0,4,12,16,40.838131,-73.864728,10460
732946,0,0,0,4,12,16,40.825904,-73.9229,10451
709850,0,0,0,100,0,100,40.634899,-73.981831,11204
818998,0,0,0,4,12,16,40.757483,-73.893058,11370
417562,0,0,0,2,6,8,43.182428,-77.465829,14526
371343,0,0,0,4,12,16,42.072116,-79.482498,14767
72650,0,0,0,4,12,16,40.846083,-73.915286,10452
608022,0,0,0,200,0,200,40.70468,-73.874738,11385
840069,0,0,0,200,0,200,40.807596,-73.912852,10454
801086,0,0,0,4,12,16,40.663555,-73.765123,11434
355973,0,0,0,191,0,191,40.685537,-73.922602,11233
867775,8,10,22,0,0,40,43.014201,-74.356631,12095
235027,0,0,0,4,12,16,40.681804,-73.742585,11413
694855,0,0,0,36,0,36,40.717059,-73.990634,10002
443528,0,0,0,4,12,16,40.662624,-73.911643,11212
829332,0,0,0,4,12,16,40.667964,-73.576966,11520
360715,0,0,0,2,6,8,43.487473,-75.336756,13309
221678,0,0,0,0,12,12,40.854083,-73.914708,10453
292267,0,0,0,0,6,6,40.840198,-73.890527,10460
206556,0,0,0,2,12,14,40.736421,-73.923664,11104
769989,0,0,0,0,12,12,42.093453,-75.89347,13903
554568,0,0,0,0,10,10,40.824244,-73.944818,10031
856743,0,0,0,4,12,16,40.599675,-73.760775,11691
707743,0,0,0,0,0,0,40.667762,-73.957164,11225
745853,0,0,0,4,12,16,40.763749,-73.775312,11361
698305,0,0,0,0,12,12,40.878961,-73.905939,10463
878258,0,0,0,4,12,16,40.841838,-73.886961,10460
603072,0,0,0,4,12,16,40.706558,-73.697965,11003
764637,0,0,0,4,12,16,40.825827,-72.978884,11763
208207,0,0,0,4,12,16,42.660015,-73.758697,12210
877962,0,0,0,2,6,8,41.300313,-73.89812,10566
829765,0,0,0,2,6,8,43.038014,-76.15621,13202
258860,0,0,0,161,0,161,42.084063,-78.442412,14760
621713,0,0,0,4,12,16,40.676402,-73.923836,11233
861079,0,0,0,4,12,16,44.545772,-75.205991,13617
150059,0,0,0,4,12,16,40.874168,-73.887813,10468
338029,0,0,0,2,12,14,40.711922,-73.986388,10002
675945,0,0,0,4,12,16,40.808534,-73.913077,10454
71743,0,0,0,4,12,16,40.561107,-74.181368,10312
514334,0,0,0,4,12,16,40.691988,-73.92845,11221
798017,0,0,0,4,12,16,40.970571,-73.834159,10710
861284,0,0,0,4,12,16,40.886712,-73.90319,10463
247404,0,0,0,2,6,8,40.710371,-73.98999,10002
114451,0,0,0,4,12,16,43.209391,-77.584529,14617
237212,0,0,0,60,0,60,40.644657,-74.009845,11220
318347,0,0,0,0,12,12,40.696081,-73.805897,11435
822800,0,0,0,4,12,16,43.136066,-77.671806,14624
657666,0,0,0,4,12,16,40.75254,-73.307529,11729
854827,0,0,0,2,12,14,40.841389,-73.912897,10452
331136,0,0,0,105,0,105,40.7545,-73.863271,11368
547464,0,0,0,2,6,8,40.769325,-73.872423,11369
824851,0,0,0,2,12,14,40.851435,-73.934742,10033
874430,0,0,0,4,12,16,40.726017,-73.824659,11367
848778,0,0,0,4,12,16,40.831427,-73.887596,10460
786158,0,0,0,4,12,16,42.795238,-73.893634,12309
73855,0,0,0,27,0,27,40.700524,-73.748386,11411
876055,0,0,0,4,12,16,40.8429,-73.913375,10452
715176,0,0,0,4,12,16,40.633442,-74.142443,10302
689120,0,0,0,4,12,16,40.6785,-73.96318,11238
864868,0,0,38,20,0,58,41.365858,-73.771383,10541
857431,0,0,0,4,12,16,40.883374,-73.897935,10463
839407,0,0,0,4,12,16,40.626581,-73.934676,11210
300057,0,0,0,2,6,8,42.994226,-75.991935,13104
656194,0,0,0,4,12,16,40.63272,-74.165429,10303
702559,0,0,0,2,6,8,42.082112,-76.855004,14905
871218,0,0,0,32,0,32,40.757482,-73.97818,10020
42966,0,0,0,44,0,44,42.641743,-73.789824,12209
225499,0,0,0,0,12,12,40.847961,-73.908821,10453
269076,0,0,0,94,0,94,40.744805,-73.559473,11590
867554,0,0,0,2,12,14,40.870786,-73.866042,10467
821324,0,0,0,4,12,16,40.84646,-73.821353,10465
428176,0,0,0,4,12,16,40.874168,-73.887813,10468
835505,0,0,0,80,0,80,40.878198,-72.994316,11727
278258,0,0,0,4,12,16,40.709031,-73.610495,11550
730075,0,0,39,0,0,39,42.12797,-76.023713,13760
801640,0,0,0,4,12,16,40.750726,-73.522131,11801
833097,0,0,0,4,12,16,40.68313,-73.886646,11207
814706,0,0,0,138,0,138,41.170338,-73.815424,10510
850507,0,0,0,2,6,8,42.495678,-77.210901,14873
262468,0,0,0,4,12,16,40.679114,-73.798692,11436
230569,0,0,0,2,6,8,42.861936,-76.994409,14456
811553,0,0,0,144,0,144,40.594991,-73.787624,11692
555644,0,0,0,164,0,164,40.812732,-73.905938,10455
68193,0,0,0,2,6,8,40.730615,-73.857784,11374
324884,0,0,0,4,12,16,40.868159,-73.889288,10458
839139,0,0,0,4,12,16,40.625613,-74.148378,10303
71421,0,0,0,4,12,16,40.662569,-73.764952,11413
875316,0,0,0,44,0,44,43.059887,-73.817692,12866
709528,0,0,0,81,0,81,40.726193,-73.974859,10009
788969,0,0,0,2,6,8,40.716421,-73.280998,11706
73285,0,0,0,230,0,230,40.680419,-73.991823,11231
133712,0,0,0,2,12,14,40.847841,-73.908513,10453
465908,0,0,0,141,0,141,40.755808,-73.799422,11358
377810,0,0,0,4,12,16,40.61673,-74.037306,11209
701226,0,0,0,4,12,16,40.694958,-73.764908,11412
180322,0,0,0,208,0,208,40.681812,-73.935556,11233
771963,16,48,0,57,0,121,42.89131,-78.848952,14212
483017,0,11,56,31,0,98,42.766448,-73.938461,12303
862108,0,0,0,4,12,16,40.722146,-73.747617,11428
625703,0,0,0,4,12,16,40.629218,-74.165934,10303
701367,0,0,0,4,12,16,42.482797,-75.529881,13815
372138,0,0,0,4,12,16,40.663486,-73.773524,11434
274704,0,0,0,4,12,16,40.707336,-73.901838,11385
843508,0,0,0,2,6,8,40.796669,-73.939517,10029
861936,0,0,0,100,0,100,42.097873,-76.045535,13760
839935,0,0,0,46,0,46,40.708911,-73.943644,11206
848536,0,0,0,4,12,16,43.173326,-77.582967,14609
41049,0,0,0,80,0,80,40.75175,-73.606118,11514
841997,16,12,72,179,0,279,41.199532,-73.966666,10927
797667,0,0,0,4,12,16,40.645354,-73.895046,11236
43550,0,0,22,0,0,22,41.567714,-74.497257,12790
601050,0,0,0,2,6,8,43.447335,-76.463666,13126
751985,0,0,0,4,12,16,40.736262,-73.711035,11001
239446,0,0,0,4,12,16,40.616806,-73.956105,11230
674759,8,23,10,13,0,54,42.916034,-78.853716,14208
72870,0,0,0,222,0,222,40.817605,-73.856893,10473
239956,0,0,0,2,6,8,43.057693,-77.454041,14450
142699,0,0,0,4,12,16,40.865172,-73.922131,10034
857375,0,0,0,2,6,8,40.654162,-73.572115,11520
372005,0,0,0,2,6,8,40.850806,-73.892309,10457
617037,0,0,0,4,12,16,40.673906,-73.889531,11207
833447,0,0,0,4,12,16,40.830096,-73.906476,10456
781695,0,0,0,4,12,16,40.684578,-73.591762,11575
506043,0,0,0,4,12,16,40.656193,-73.905509,11212
666032,0,0,0,2,12,14,40.840827,-73.891494,10460
732318,0,0,0,4,12,16,40.598823,-74.127422,10314
700190,0,0,0,2,6,8,43.205939,-77.569574,14622
871904,0,0,0,4,12,16,40.629525,-73.93401,11234
591,0,0,0,2,6,8,42.499491,-74.784303,12155
105213,0,0,0,4,12,16,41.02494,-73.791019,10530
821644,0,0,0,4,12,16,42.946095,-73.397722,12057
724276,0,0,0,363,0,363,40.83581,-73.919914,10452
866504,0,0,0,4,12,16,40.933115,-73.888554,10701
848103,0,0,0,4,12,16,41.156547,-74.068128,10952
788392,0,0,0,4,12,16,41.436197,-74.408708,10940
275348,0,0,0,2,12,14,40.686134,-73.967178,11238
667218,0,0,0,4,12,16,40.85845,-73.904869,10453
849904,0,0,0,2,12,14,43.066189,-76.07072,13057
720066,0,0,0,4,12,16,42.803289,-73.908809,12309
779093,0,0,54,0,0,54,43.080074,-75.754721,13032
467668,0,0,20,0,0,20,42.91762,-76.541212,13021
703363,8,72,36,0,0,116,40.7475,-73.1665,11739
825239,0,0,0,2,6,8,41.929004,-73.983254,12401
454029,0,0,0,4,12,16,40.663945,-73.929583,11212
637463,0,0,0,4,12,16,42.752635,-73.700194,12047
42152,16,24,44,0,0,84,42.600942,-76.166626,13045
266918,0,0,0,2,12,14,40.664807,-73.917151,11212
44511,0,0,0,78,0,78,42.433893,-76.492764,14850
842305,0,0,0,4,12,16,40.661288,-73.990561,11215
39518,0,0,0,44,0,44,42.98428,-78.852097,14223
812008,0,0,0,205,0,205,40.818113,-73.904557,10455
17129,0,0,0,2,6,8,42.253907,-73.769936,12534
155555,0,0,0,2,6,8,40.875064,-73.912657,10463
774248,0,0,0,55,0,55,40.739062,-73.094202,11796
545980,0,0,0,4,12,16,40.926425,-73.871851,10704
187274,0,0,0,4,12,16,42.949632,-78.808902,14226
29164,0,0,0,2,6,8,43.077967,-76.075966,13057
73521,0,0,0,172,0,172,40.716446,-73.993532,10002
605549,0,0,75,0,0,75,42.4596,-75.0581,13820
730542,0,0,0,128,0,128,40.765598,-73.923212,11102
816925,0,0,0,4,12,16,43.17139,-77.646806,14606
673310,0,0,0,4,12,16,40.878897,-73.860125,10467
158336,0,0,0,4,12,16,40.83971,-73.863664,10462
571641,0,0,0,4,12,16,40.83073,-73.936392,10039
252594,0,0,0,4,12,16,40.655962,-73.744343,11422
44061,0,0,0,120,0,120,40.941196,-73.815224,10709
38536,0,0,0,2,6,8,42.41379,-74.96992,13820
874271,0,0,0,4,12,16,40.723371,-73.811627,11367
44967,16,36,52,21,0,125,42.900175,-73.907123,12027
759571,0,0,0,4,12,16,40.84521,-73.882393,10460
42209,8,12,14,0,0,34,41.739462,-73.922915,12601
419407,0,0,0,2,6,8,43.174521,-77.566057,14609
549682,0,0,0,2,12,14,40.833131,-73.921488,10452
877027,8,10,14,10,0,42,43.20102,-77.635483,14615
39475,8,24,92,36,0,160,42.961206,-78.789057,14226
40598,22,36,137,136,0,331,41.019643,-73.740264,10605
330170,0,0,0,4,12,16,40.887677,-73.863772,10466
39845,0,0,56,0,0,56,40.784352,-73.70632,11030
407256,0,0,0,4,12,16,40.813244,-73.945527,10027
206177,0,0,0,2,12,14,40.727369,-73.807847,11366
877787,0,0,0,4,12,16,40.838775,-73.846176,10461
867027,8,12,0,0,0,20,42.502196,-76.298082,13053
138094,0,0,0,0,12,12,40.831081,-73.922975,10452
807275,0,0,0,39,0,39,40.798402,-73.932757,10035
866954,0,0,0,4,12,16,40.876496,-73.827159,10475
828738,0,0,0,4,12,16,40.867491,-73.855965,10469
739365,22,44,32,39,0,137,41.277386,-73.781087,10598
607806,0,0,0,4,12,16,40.846471,-73.830625,10461
112060,0,0,0,2,6,8,40.638235,-73.946004,11210
455098,0,0,0,4,12,16,40.60751,-74.006231,11214
316358,0,0,0,2,6,8,43.140617,-73.746948,12831
253878,0,0,0,2,6,8,43.980325,-75.601718,13619
72812,0,0,0,145,0,145,40.622114,-74.078513,10304
547326,8,10,17,9,0,44,42.263364,-78.683269,14731
793189,0,0,0,4,12,16,40.676814,-73.75864,11434
849142,0,0,0,4,12,16,40.866408,-73.922907,10034
40461,0,10,23,0,0,33,41.838508,-74.148836,12484
102052,0,0,0,61,0,61,40.688885,-73.759539,11412
806763,0,0,0,4,12,16,42.794078,-73.994036,12306
456796,0,0,37,12,0,49,42.124397,-76.990296,14830
845207,8,12,14,0,0,34,42.066755,-75.41901,13754
865750,0,0,40,0,0,40,41.529044,-74.153766,12586
822928,0,0,0,154,0,154,40.85064,-73.934555,10033
429815,0,0,0,4,12,16,40.842577,-73.937004,10032
643534,0,0,0,4,12,16,40.82677,-73.925507,10451
588974,0,0,0,0,12,12,43.173849,-77.564657,14609
508078,0,0,0,4,12,16,40.82972,-73.940374,10032
40694,8,12,169,0,0,189,42.716538,-73.692455,12180
842902,32,36,60,0,0,128,41.061876,-73.838517,10591
768444,0,0,0,74,0,74,40.827359,-73.898668,10459
687974,0,0,0,0,12,12,40.870278,-73.902682,10468
730725,0,0,0,4,12,16,40.637465,-73.956329,11210
809208,0,0,0,4,12,16,40.642102,-73.990531,11218
563025,0,0,23,0,0,23,40.960432,-73.732126,10543
879911,0,0,44,0,0,44,43.052031,-78.887453,14120
876428,0,0,0,211,0,211,40.693092,-73.935298,11221
568206,0,0,0,2,6,8,40.819479,-73.938348,10030
642030,0,0,0,4,12,16,42.945903,-78.829463,14214
720464,0,0,0,4,12,16,44.06069,-75.968152,13601
816075,8,24,22,9,0,63,40.925374,-72.660609,11901
854381,0,0,0,4,11,15,42.109146,-76.820637,14901
45290,0,0,0,34,0,34,42.791788,-73.922226,12304
834862,0,0,0,4,12,16,40.642597,-74.021619,11220
25552,0,0,0,2,6,8,42.369093,-76.525867,14850
861748,0,0,0,2,6,8,43.188978,-77.615984,14621
882144,0,0,0,4,12,16,40.690559,-73.692392,11003
784253,16,48,108,13,0,185,40.665074,-73.459364,11758
40366,0,0,37,0,0,37,40.831343,-73.118278,11779
599823,0,0,0,4,12,16,40.591044,-73.798131,11692
822221,0,0,0,4,12,16,40.870853,-73.893453,10468
837158,0,0,0,4,12,16,40.678058,-73.391644,11726
474217,0,0,0,4,12,16,40.677722,-73.9766,11217
71661,0,0,0,4,12,16,40.612251,-73.964159,11230
815337,0,0,0,4,12,16,40.871999,-73.880128,10467
439421,0,0,0,160,0,160,40.70794,-73.754937,11412
697558,0,0,0,4,12,16,40.616523,-74.026993,11209
452433,0,0,0,2,12,14,40.618093,-74.080916,10304
657429,0,0,0,2,12,14,42.348084,-76.540786,14867
809731,0,0,0,4,12,16,43.136858,-77.643201,14619
43293,0,0,0,44,0,44,42.987068,-78.844702,14150
42004,0,0,36,0,0,36,42.631174,-73.811432,12054
870859,0,0,0,4,12,16,40.662621,-73.601438,11520
313508,0,0,0,2,10,12,42.921953,-78.807062,14215
437820,0,0,16,0,0,16,43.226977,-77.067145,14581
44223,16,34,168,0,0,218,40.898391,-73.337158,11768
72298,0,0,0,2,12,14,40.852241,-73.902124,10457
445362,0,0,0,4,12,16,40.835447,-73.912618,10456
663848,0,0,0,4,12,16,40.663921,-73.886899,11207
757529,0,0,0,127,0,127,40.675207,-73.808143,11420
840772,0,0,0,4,12,16,44.118922,-75.814462,13637
585163,0,0,0,4,12,16,40.67102,-73.816056,11420
396566,0,0,0,2,12,14,40.805732,-73.957898,10026
756295,0,0,0,2,6,8,40.672347,-73.805269,11420
364597,0,0,0,214,0,214,40.640175,-73.99775,11219
781851,0,0,0,4,12,16,40.694049,-73.646378,11552
72417,0,0,0,4,12,16,40.682718,-73.741046,11413
1657,0,0,0,2,6,8,43.214528,-77.428056,14580
103325,0,0,0,4,12,16,40.593818,-74.063508,10305
267226,0,36,240,0,0,276,41.109,-74.0402,10977
681473,16,28,75,0,0,119,41.657669,-73.853465,12603
635927,0,0,0,4,12,16,40.64352,-74.083541,10301
573931,0,0,0,4,12,16,40.645055,-74.019009,11220
592074,0,0,0,4,12,16,40.694979,-73.922733,11221
840986,0,0,0,100,0,100,40.662277,-73.894594,11207
43572,0,0,0,73,0,73,42.549192,-76.294518,13068
111659,0,0,0,2,6,8,40.666946,-73.9147,11212
531889,0,0,0,4,12,16,40.67351,-73.984429,11215
71531,0,0,0,4,12,16,40.633368,-74.095409,10301
709758,0,0,0,213,0,213,40.859565,-73.90001,10468
288661,0,0,0,2,10,12,40.684979,-73.397323,11726
334091,0,0,0,4,12,16,41.47438,-74.431729,10940
662795,0,0,0,4,12,16,40.812412,-73.917239,10454
619312,0,0,0,2,12,14,40.84801,-73.937101,10033
840392,0,0,0,162,0,162,40.675086,-73.901318,11207
864716,0,0,0,4,12,16,40.753002,-73.773376,11364
816768,0,0,0,4,12,16,40.827469,-73.948512,10031
100010,0,24,58,0,0,82,41.602455,-73.935781,12590
848902,0,0,0,2,6,8,40.820729,-73.909893,10456
798942,0,12,20,0,0,32,40.65215,-73.679776,11563
521305,0,0,0,4,12,16,40.873761,-73.88541,10458
359189,0,0,92,0,0,92,41.05675,-73.955561,10913
670663,0,0,20,0,0,20,43.081088,-73.767035,12866
73704,0,0,0,75,0,75,40.744738,-73.934893,11101
774469,14,12,16,40,0,82,42.678134,-73.77798,12206
831423,0,0,0,213,0,213,40.761871,-73.914191,11103
770741,0,0,0,4,12,16,40.66718,-73.691045,11580
458050,0,19,90,0,0,109,40.951777,-73.729589,10543
429545,0,0,0,4,12,16,40.846394,-73.911205,10453
876821,0,0,0,48,0,48,40.750313,-73.757629,11364
321604,0,0,0,4,12,16,40.68487,-73.38944,11726
868297,0,0,0,4,12,16,40.710238,-73.591419,11553
799876,0,0,0,4,12,16,40.704181,-73.599044,11553
38772,0,0,0,4,12,16,40.607657,-73.646062,11558
8552,0,0,0,2,6,8,42.669856,-77.051356,14527
395109,0,0,0,4,12,16,42.917544,-78.803777,14211
74139,0,0,0,248,0,248,40.745681,-73.923377,11104
565116,0,0,0,180,0,180,42.881546,-76.996743,14456
807940,0,0,0,259,0,259,40.657293,-73.911,11212
817654,0,0,0,2,6,8,42.104535,-77.070031,14830
827160,0,0,20,160,0,180,42.969376,-78.774459,14226
680099,0,0,0,80,0,80,40.669204,-73.736081,11422
871698,0,0,0,4,12,16,40.837473,-73.901946,10457
319464,0,0,0,0,12,12,40.735351,-73.897678,11377
782871,0,0,0,80,0,80,40.760477,-73.9367,11106
825025,0,0,0,4,12,16,40.588873,-73.941854,11235
671261,0,0,0,2,6,8,40.692051,-73.429842,11758
853552,0,0,0,0,12,12,40.683773,-73.842891,11416
594704,0,0,0,2,12,14,40.813787,-73.94449,10027
792761,0,0,0,2,12,14,40.85598,-73.863949,10462
269474,0,0,0,146,0,146,40.67547,-73.816564,11420
881647,0,0,0,4,12,16,40.65226,-73.709632,11581
354989,0,0,0,2,6,8,40.669819,-73.893063,11207
870808,0,0,0,0,12,12,41.013908,-73.766876,10605
764684,0,0,26,0,0,26,41.973155,-73.920646,12504
431279,0,8,95,0,0,103,43.106074,-75.265144,13502
473178,0,0,0,4,12,16,40.688935,-73.791447,11433
44017,0,0,0,40,0,40,41.249956,-73.693039,10536
735524,0,0,0,88,0,88,40.837319,-73.855045,10462
815006,0,0,0,295,0,295,40.829192,-73.891787,10459
597120,0,0,0,4,12,16,40.68637,-73.79142,11434
232025,0,0,0,2,12,14,40.598889,-73.756262,11691
241075,0,0,0,4,12,16,40.686606,-73.802758,11435
709676,0,0,0,202,0,202,40.679749,-74.001652,11231
841469,0,0,0,96,0,96,40.803839,-73.048477,11742
795601,0,0,0,4,12,16,40.845796,-73.935612,10033
108292,16,36,42,0,0,94,42.738344,-73.684932,12180
450533,0,0,0,2,6,8,42.94595,-78.796079,14215
818375,0,0,0,4,12,16,40.82125,-73.151694,11779
875949,0,0,0,2,6,8,40.863814,-73.921669,10034
773294,0,0,0,40,0,40,41.209002,-73.576639,10576
846799,0,0,0,4,12,16,40.719675,-73.975178,10009
787626,0,0,0,2,6,8,43.159234,-77.628526,14608
750370,0,0,0,4,12,16,40.662326,-73.738608,11422
742500,0,0,0,235,0,235,40.719132,-73.979369,10002
869707,0,0,0,4,12,16,42.899302,-78.86,14204
628317,0,0,0,4,12,16,40.639329,-73.982333,11218
844479,12,24,18,0,0,54,42.906843,-76.842226,13165
45338,8,8,60,0,0,76,42.900458,-73.358913,12090
40004,32,48,80,80,0,240,43.035564,-76.093388,13224
266388,0,0,0,4,12,16,40.648292,-73.590969,11520
734382,0,0,0,0,12,12,40.805732,-73.957898,10026
487178,0,0,0,4,12,16,40.826634,-73.8927,10459
693615,16,56,212,0,0,284,40.747832,-73.183616,11752
307039,0,0,0,2,5,7,43.293897,-73.657788,12801
459691,0,0,0,2,12,14,40.825402,-73.88146,10472
660018,16,20,28,24,0,88,43.051937,-77.113715,14513
311662,0,0,90,0,0,90,42.856506,-78.827103,14220
613902,0,0,0,42,0,42,40.704927,-73.740166,11429
864645,0,0,0,4,12,16,42.916003,-78.844873,14208
347106,0,0,0,4,12,16,43.18152,-77.643195,14613
276358,0,0,0,4,12,16,40.726233,-73.71006,11001
396012,0,0,0,4,12,16,40.879827,-73.866106,10467
375714,0,0,0,4,12,16,40.698087,-73.928569,11221
879050,0,0,0,2,10,12,40.900312,-73.788058,10805
866875,0,0,0,2,6,8,42.9069,-78.898774,14213
793288,0,0,0,0,10,10,40.7584,-73.86565,11369
385372,0,0,0,4,12,16,40.769447,-73.532679,11801
40086,0,0,20,0,0,20,43.246698,-78.183393,14411
347163,0,0,0,4,12,16,40.826998,-73.825729,10465
852519,0,0,0,2,6,8,44.193231,-75.606223,13608
844320,0,0,0,4,12,16,40.78601,-73.253118,11717
494721,0,0,0,4,12,16,40.880456,-73.863528,10467
311471,0,0,0,73,0,73,40.647305,-73.999142,11232
741994,0,0,0,120,0,120,40.780585,-73.976682,10024
493444,0,0,0,4,12,16,40.888503,-73.834115,10466
811837,0,0,0,2,12,14,40.839092,-73.876993,10460
245018,0,0,0,231,0,231,40.621034,-73.912883,11234
866983,0,0,0,4,12,16,40.897585,-73.867971,10470
876167,0,0,0,4,12,16,40.615803,-73.755741,11096
692719,0,0,0,4,12,16,40.83796,-73.943762,10032
668773,0,0,0,2,12,14,40.814548,-73.906454,10455
260106,0,0,0,2,12,14,40.863616,-73.822204,10475
851230,0,0,0,4,12,16,40.595349,-73.792728,11692
795044,0,0,0,89,0,89,41.120238,-74.043193,10977
386822,0,0,0,4,12,16,40.660582,-73.910632,11212
269182,0,0,0,4,12,16,40.658366,-73.892479,11207
553818,0,0,0,2,12,14,40.85354,-73.918137,10453
106145,0,0,0,4,12,16,42.074757,-76.805954,14904
806127,0,0,0,191,0,191,40.7478,-73.906208,11377
870310,0,0,0,44,0,44,42.766858,-78.829186,14075
808817,0,0,0,2,6,8,40.809001,-73.940876,10027
760881,0,0,0,4,12,16,40.672907,-73.491497,11783
740016,0,0,0,4,12,16,40.762345,-73.211875,11717
869382,0,0,0,30,0,30,40.866623,-73.92143,10034
758294,0,0,0,67,0,67,43.218431,-77.608775,14617
806260,0,0,0,166,0,166,40.69648,-73.975981,11205
650521,0,0,0,4,12,16,43.09127,-76.28118,13164
714196,0,0,14,26,0,40,43.023436,-76.134528,13210
804305,0,0,0,4,12,16,44.576524,-73.473035,12972
396845,0,0,0,80,0,80,40.765897,-73.830207,11354
124026,0,0,0,4,12,16,40.903576,-73.836289,10550
39826,0,0,0,75,0,75,40.681773,-73.539816,11710
407337,0,0,16,84,0,100,43.029064,-78.965022,14072
445057,0,0,0,4,12,16,40.68647,-73.785186,11434
169670,8,12,109,0,0,129,42.654226,-73.751834,12210
281477,0,0,0,2,6,8,40.662454,-73.861331,11208
769035,0,0,0,4,12,16,40.831057,-73.921963,10452
873482,0,0,0,4,12,16,40.688332,-73.868186,11208
799391,0,0,0,2,6,8,40.835924,-73.884267,10460
44191,0,0,0,100,0,100,42.393804,-76.371659,14881
819459,0,0,0,4,12,16,40.83181,-73.871023,10472
140504,0,8,17,0,0,25,42.064783,-78.167851,14715
713115,0,0,0,4,12,16,40.825997,-73.907222,10456
41425,16,12,18,0,0,46,42.330423,-75.977308,13862
783667,16,29,31,0,0,76,41.034584,-73.692918,10577
850931,0,0,0,2,6,8,43.112492,-76.158069,13212
195607,24,36,36,33,0,129,43.084759,-75.662731,13421
874678,0,0,0,2,6,8,40.866787,-73.885986,10458
322730,0,0,0,4,12,16,40.647468,-73.908037,11236
823911,0,0,0,4,12,16,40.657988,-73.676205,11563
796436,0,0,0,185,0,185,40.79127,-73.947646,10029
866832,0,16,0,0,0,16,42.546847,-75.511591,13815
790052,0,0,0,4,12,16,41.475764,-74.372326,10941
791365,0,0,0,4,12,16,41.051735,-74.017844,10965
40891,0,0,0,162,0,162,43.109172,-76.219228,13088
843137,0,0,0,101,0,101,40.677635,-74.005112,11231
828467,0,0,0,2,6,8,43.021867,-74.359606,12095
216276,0,0,0,4,12,16,40.679504,-74.0074,11231
869600,0,0,0,2,6,8,40.905514,-73.842083,10550
882765,24,20,51,0,0,95,42.967229,-73.792069,12020
648051,0,0,0,4,12,16,40.666547,-73.989929,11215
308447,0,0,0,4,12,16,43.232374,-77.064311,14551
260924,0,0,0,4,12,16,40.853519,-73.92902,10040
836909,0,0,0,4,12,16,41.568844,-74.200829,12586
748149,0,0,0,143,0,143,40.612954,-74.069329,10305
697162,0,0,0,4,12,16,40.626778,-73.923634,11234
862282,0,0,0,20,0,20,40.82235,-73.896026,10459
45042,0,0,30,0,0,30,42.687249,-74.494534,12043
845599,0,0,0,4,12,16,40.881253,-73.904961,10463
162041,0,0,0,4,12,16,40.689777,-73.920368,11221
557549,0,0,0,4,12,16,40.611565,-74.087928,10304
737730,0,0,0,4,12,16,40.849042,-73.912675,10453
691483,0,0,0,31,0,31,40.672503,-73.941733,11213
870837,0,0,20,25,0,45,43.009403,-78.776689,14068
548798,0,0,0,4,12,16,41.75157,-73.799521,12569
458868,0,0,0,4,12,16,40.686418,-73.849503,11416
730944,0,0,0,4,12,16,40.663622,-73.915744,11212
214007,0,0,0,2,10,12,40.73528,-73.852809,11375
780805,0,0,0,4,12,16,40.864004,-73.898479,10468
672812,0,0,0,4,12,16,40.636066,-73.924047,11234
535618,0,0,0,4,12,16,40.756484,-73.926308,11106
764256,0,0,0,4,12,16,40.803558,-73.957717,10026
124413,0,0,0,25,0,25,40.65079,-73.947208,11226
243234,0,0,0,153,0,153,40.577013,-74.000529,11224
39698,8,60,20,0,0,88,43.170936,-77.597379,14605
608450,0,0,0,4,12,16,40.867406,-73.896165,10468
44719,0,0,21,0,0,21,42.415904,-76.50408,14850
680827,0,0,0,4,12,16,40.670495,-73.985861,11215
826093,0,0,0,4,12,16,40.669063,-73.983977,11215
413653,0,0,0,2,6,8,42.914241,-73.878538,12019
837880,0,0,0,4,12,16,40.845861,-73.906436,10457
855757,0,0,0,4,12,16,40.641905,-73.638599,11572
704694,0,0,0,4,12,16,40.814256,-73.908904,10455
736999,0,0,0,4,12,16,40.920172,-73.871836,10704
357777,0,0,0,2,12,14,40.846415,-73.917809,10452
489677,0,0,0,15,0,15,40.654041,-73.581925,11520
433263,0,48,188,0,0,236,40.79596,-73.446443,11747
41566,0,0,0,44,0,44,42.817951,-73.783961,12065
817838,0,0,0,2,12,14,40.828638,-73.899011,10459
51722,0,0,0,0,6,6,40.712107,-73.992011,10002
689613,0,0,0,80,0,80,40.682795,-73.970628,11238
809695,0,0,0,4,12,16,40.639757,-73.905121,11236
350539,0,0,0,2,12,14,40.675092,-73.997729,11231
449624,0,0,0,2,12,14,40.812261,-73.915854,10454
647226,0,0,0,0,12,12,40.618352,-73.74349,11096
867966,0,0,0,60,0,60,41.246798,-74.390254,10990
459796,0,0,0,4,12,16,40.814409,-73.909533,10455
784622,0,0,0,0,12,12,40.938622,-73.887235,10701
610011,0,0,0,4,12,16,40.713012,-73.964369,11249
219359,0,0,0,2,6,8,40.845026,-73.881472,10460
538069,24,24,16,24,0,88,43.16985,-79.031101,14092
233436,0,0,0,4,12,16,41.296779,-73.919094,10566
716269,0,0,0,80,0,80,40.70025,-73.928095,11221
166652,0,0,0,4,12,16,40.652374,-73.746199,11422
872515,0,0,0,2,6,8,42.785915,-76.140463,13159
44902,0,0,88,0,0,88,41.040294,-73.864714,10533
40788,0,0,0,90,0,90,42.160936,-76.823045,14845
390854,0,0,0,0,12,12,40.822955,-73.941634,10039
863654,0,0,0,4,12,16,40.848939,-73.913911,10453
605901,0,0,0,4,12,16,40.828502,-73.87451,10472
131026,16,42,18,0,0,76,42.947939,-78.858194,14216
807353,0,0,0,4,12,16,40.669536,-73.819404,11420
296295,0,0,0,4,12,16,42.950764,-78.905865,14207
139696,0,0,0,2,6,8,40.759085,-73.234073,11717
873945,0,0,0,0,12,12,40.878872,-73.90147,10463
362255,0,0,0,4,12,16,40.840366,-73.920554,10452
822040,0,0,0,66,0,66,40.670863,-73.908578,11212
734981,0,0,0,160,0,160,40.80939,-73.919901,10454
217511,0,0,0,4,12,16,40.830466,-73.922297,10452
776098,0,0,0,0,10,10,40.655313,-73.953658,11226
877294,0,0,0,4,12,16,41.033282,-73.746573,10604
866306,0,0,0,4,12,16,41.697424,-73.921002,12601
659757,0,0,0,4,12,16,40.744081,-73.332933,11703
318245,0,0,47,0,0,47,42.686514,-73.681082,12180
108969,0,0,0,108,0,108,40.964315,-72.299588,11963
53824,0,0,0,0,6,6,40.853983,-73.910654,10453
275912,0,0,35,78,0,113,42.075579,-75.905637,13903
718993,0,0,0,2,6,8,40.723775,-73.760632,11427
537679,0,0,0,2,6,8,40.675217,-73.760577,11434
415254,0,0,0,4,12,16,40.840196,-73.909716,10457
41066,0,0,0,70,0,70,40.710887,-73.598567,11553
42429,0,0,0,60,0,60,43.963904,-75.916597,13601
684001,0,0,0,4,12,16,40.684588,-73.994657,11201
327889,0,0,0,4,12,16,40.864701,-73.903479,10468
862635,0,0,0,4,12,16,40.665626,-73.660478,11563
693974,0,0,0,4,12,16,42.731556,-73.705994,12189
785207,0,0,0,4,12,16,40.888604,-73.852066,10466
410782,0,0,0,2,6,8,43.115857,-76.157428,13212
517397,0,0,0,4,12,16,40.673352,-73.742306,11413
339134,0,0,0,236,0,236,40.703921,-73.896377,11385
826563,0,0,52,0,0,52,43.059382,-76.149203,13208
709813,0,0,0,202,0,202,40.666567,-73.911103,11212
74003,0,0,0,290,0,290,40.601175,-73.959898,11229
229797,0,8,36,0,0,44,43.072762,-73.802483,12866
699180,0,0,0,4,12,16,40.866573,-73.923028,10034
711741,0,0,0,55,0,55,40.875109,-73.865284,10467
858286,0,0,0,4,12,16,42.706948,-75.511011,13460
874921,0,0,0,4,12,16,40.86526,-73.867851,10467
846564,0,0,0,4,12,16,40.698334,-73.599374,11553
258413,0,0,0,4,12,16,42.39369447,-79.44590077,14716
760623,0,0,0,68,0,68,40.647879,-73.972852,11218
42591,0,0,0,70,0,70,42.745886,-73.940671,12303
736237,0,0,0,4,12,16,40.68211,-73.888811,11207
304292,0,0,0,2,12,14,40.673993,-73.842366,11417
836664,0,0,0,4,12,16,40.837352,-73.92541,10452
802498,0,0,0,4,12,16,40.86924,-73.882024,10458
616192,0,0,0,4,12,16,40.820268,-73.910053,10456
666913,0,0,80,60,0,140,41.367022,-73.760086,10541
841085,32,36,60,28,0,156,42.628741,-73.811846,12054
539966,14,24,21,0,0,59,42.672898,-73.849305,12203
649680,0,0,0,4,12,16,40.735085,-73.775096,11366
43460,39,23,39,0,0,101,43.13105,-73.767072,12831
609377,12,20,32,0,0,64,42.090445,-79.238294,14701
669514,0,0,0,4,12,16,40.770985,-73.91257,11105
795883,0,0,0,74,0,74,40.687785,-73.93316,11221
135483,0,0,0,2,12,14,41.610312,-74.299064,12566
751254,0,0,10,84,0,94,43.16535,-77.575095,14609
602078,0,0,0,4,12,16,40.837623,-73.913411,10456
252999,0,0,0,2,6,8,40.834782,-73.946895,10032
35934,0,0,0,4,12,16,40.711488,-73.632126,11550
804630,0,0,0,300,0,300,40.772585,-73.989231,10023
870215,0,0,0,2,6,8,43.100003,-79.032258,14301
701812,0,0,0,92,0,92,40.759374,-73.074036,11782
766617,0,0,0,140,0,140,40.7588,-73.5189,11801
432453,0,0,0,2,6,8,40.636355,-74.123161,10310
339217,0,0,0,170,0,170,40.633794,-73.966373,11226
709035,0,0,0,4,12,16,43.077923,-76.14248,13208
147086,0,0,36,0,0,36,42.24932,-73.78433,12534
775633,0,0,0,0,12,12,40.750737,-73.877729,11372
853113,0,0,0,2,6,8,40.76326,-73.988021,10019
819585,0,0,0,2,6,8,43.038991,-77.25724,14522
823972,0,0,0,4,12,16,42.77502,-73.866314,12309
40027,16,16,108,0,0,140,43.043506,-76.12179,13210
55338,0,0,0,0,6,6,40.848308,-73.904864,10457
20829,0,0,0,4,12,16,42.852443,-77.702416,14414
818828,0,0,0,4,12,16,40.827967,-73.894012,10459
765514,0,0,0,4,12,16,40.699009,-73.424023,11701
868910,0,0,0,149,0,149,41.277701,-73.788814,10598
163033,0,0,0,2,6,8,40.686403,-73.877452,11208
863230,0,0,0,4,12,16,40.695932,-73.586956,11553
877736,0,0,0,4,12,16,40.91077,-73.900055,10471
880366,0,0,0,4,12,16,40.848289,-73.937898,10033
509973,0,0,0,2,6,8,41.121132,-74.066098,10952
707117,0,0,0,2,6,8,43.780114,-76.119333,13611
753384,0,0,0,2,6,8,42.210018,-76.750305,14845
72491,0,0,0,4,12,16,40.862107,-73.926058,10040
880704,0,0,0,2,12,14,40.88011,-73.876115,10467
44655,0,36,121,0,0,157,41.136291,-73.99114,10956
42520,0,0,0,100,0,100,41.127472,-73.985077,10956
881073,0,0,0,4,12,16,40.857079,-73.907452,10453
369879,0,0,0,4,12,16,40.594683,-73.775417,11691
352743,0,0,0,2,6,8,40.836724,-72.873031,11967
541618,48,58,99,49,0,254,42.642689,-73.78089,12209
204110,0,0,0,2,10,12,40.700036,-73.983288,11201
689986,0,0,0,4,12,16,40.6615,-73.991863,11215
475810,16,30,61,66,0,173,41.226022,-73.986237,10980
71947,0,0,0,2,12,14,40.829313,-73.918681,10456
850833,32,46,70,60,0,208,42.101227,-75.939074,13905
827654,0,0,20,0,0,20,42.153032,-77.063922,14830
721508,0,0,0,284,0,284,40.698341,-73.92024,11237
825614,0,0,0,2,6,8,44.629165,-73.583019,12985
572473,0,0,0,4,12,16,40.677604,-73.996616,11231
835787,0,0,0,4,12,16,40.680568,-73.836123,11417
40686,0,0,0,44,0,44,42.667601,-73.682973,12180
644484,0,0,0,4,12,16,41.026306,-73.942611,10983
299224,0,0,0,4,12,16,40.680193,-73.790483,11434
831942,0,0,0,0,9,9,40.818454,-73.893534,10459
229620,0,0,84,0,0,84,43.214087,-75.419633,13441
866809,0,0,36,0,0,36,42.112484,-76.070832,13760
781006,0,0,0,4,12,16,40.871622,-73.86914,10467
733979,0,0,0,2,6,8,40.864086,-73.889743,10458
502802,0,0,0,4,12,16,40.623822,-74.165808,10303
41665,0,0,0,104,0,104,43.124886,-77.579863,14618
744100,0,0,20,0,0,20,43.346136,-73.839239,12846
851065,0,0,0,4,12,16,40.865828,-73.90271,10468
312014,0,0,0,20,0,20,40.727983,-73.810822,11365
879275,0,0,0,4,12,16,40.864005,-73.892094,10458
760150,0,0,0,2,12,14,40.860112,-73.904896,10468
824262,0,0,0,4,12,16,40.83078,-72.98435,11763
22458,0,0,0,4,12,16,43.088969,-75.374297,13321
43721,0,0,254,0,0,254,40.813599,-73.50398,11791
39208,16,24,38,0,0,78,42.653397,-73.75678,12210
873771,0,0,0,34,0,34,40.824983,-73.854022,10473
709908,0,0,0,240,0,240,40.831482,-73.935884,10039
307559,0,0,0,2,6,8,43.622931,-75.370574,13368
806050,0,0,0,2,6,8,40.858606,-73.314312,11731
823783,0,0,0,2,6,8,43.102001,-75.249907,13502
44432,0,0,0,40,0,40,43.135884,-78.683739,14094
872773,0,0,24,30,0,54,42.911394,-78.86148,14209
759185,0,0,0,106,0,106,40.828134,-73.90886,10456
388850,0,0,0,45,0,45,40.763741,-73.922553,11106
876544,0,0,18,0,0,18,43.31851,-76.435409,13069
860765,0,0,0,4,12,16,43.01715,-76.158815,13207
717706,0,0,0,4,12,16,43.094931,-75.636101,13421
107216,0,6,30,8,0,44,40.698117,-73.714302,11003
275135,0,0,0,4,12,16,40.651398,-73.952238,11226
42291,0,0,0,80,0,80,40.653853,-73.515002,11793
24034,0,0,0,0,10,10,40.69794,-73.586762,11553
803112,0,0,0,4,12,16,40.812596,-73.906654,10455
851598,0,0,0,2,6,8,42.422181,-79.236099,14063
480751,0,0,0,2,12,14,40.861623,-73.909222,10468
117475,0,0,0,4,12,16,40.578368,-74.00385,11224
363387,8,10,32,21,0,71,43.069704,-78.825229,14120
850636,0,0,0,2,6,8,43.141828,-77.625657,14608
709890,0,0,0,108,0,108,40.799329,-73.933192,10035
847788,0,0,0,2,6,8,42.672132,-73.774849,12206
878762,0,0,0,93,0,93,40.591794,-73.681609,11561
853367,0,0,0,4,12,16,40.814501,-73.957518,10027
685391,0,0,0,2,6,8,40.663256,-73.757512,11413
422978,8,10,31,20,0,69,41.218676,-73.79662,10562
292829,0,0,0,2,6,8,40.86728,-73.843565,10469
825385,0,0,0,2,6,8,42.899272,-76.129513,13084
345863,0,0,0,4,12,16,40.617494,-73.629409,11572
202274,0,0,0,4,12,16,40.904407,-73.840626,10550
803025,0,0,0,4,12,16,40.870403,-73.887045,10458
309271,0,0,0,4,12,16,40.698265,-73.776191,11433
546658,0,0,0,2,6,8,40.865802,-73.901178,10468
676071,0,0,0,4,12,16,40.769877,-73.250684,11717
42999,0,0,0,40,0,40,44.719957,-73.389812,12901
612600,0,0,0,60,0,60,42.142268,-77.053429,14830
709626,0,0,0,134,0,134,40.738861,-73.821295,11367
337507,0,0,0,0,12,12,40.660304,-73.949396,11225
244132,0,0,0,193,0,193,40.649638,-73.966189,11226
764155,0,0,0,4,12,16,40.660618,-73.944697,11225
875102,0,0,0,2,6,8,42.08053,-76.840937,14905
263816,0,0,0,4,12,16,40.830146,-73.866753,10472
346163,0,0,0,0,12,12,40.768766,-73.914127,11103
812072,0,0,0,95,0,95,40.827038,-73.818645,10465
548610,8,12,26,0,0,46,40.845932,-73.635442,11542
637014,8,24,38,0,0,70,42.759263,-73.601604,12180
660486,0,0,0,4,12,16,40.666222,-73.890365,11207
711363,0,0,0,2,12,14,40.824669,-73.87743,10472
867729,0,0,0,4,12,16,40.853505,-73.909681,10453
709612,0,0,0,247,0,247,40.711679,-73.888217,11379
356420,8,22,32,0,0,62,41.402835,-73.636572,10509
213827,0,20,48,0,0,68,42.489456,-76.293517,13053
383426,8,24,0,0,0,32,40.936394,-73.096441,11733
130057,0,0,0,2,6,8,42.133172,-73.88764,12526
221426,0,0,0,4,12,16,43.08812,-79.02697,14303
44793,0,0,31,0,0,31,43.882325,-75.441363,13620
569566,0,0,0,44,0,44,42.930304,-78.813111,14215
820145,0,0,0,2,6,8,40.686183,-73.766364,11434
770083,0,0,21,0,0,21,42.815825,-73.949427,12305
805493,0,0,0,0,12,12,40.832191,-73.914901,10456
43970,16,16,60,0,0,92,43.051497,-77.101201,14513
837717,0,0,0,2,6,8,40.799504,-73.961037,10025
745309,0,0,0,280,0,280,40.815448,-73.885561,10474
246326,0,0,0,4,12,16,40.646617,-73.576617,11520
372595,0,0,0,4,12,16,40.835447,-73.912618,10456
661909,0,0,0,2,6,8,43.131556,-76.120407,13212
228256,0,0,0,4,12,16,40.67548,-73.804471,11420
881319,0,0,0,4,12,16,40.871996,-73.884906,10458
583364,0,0,0,4,12,16,40.864163,-73.901413,10468
110903,0,0,0,129,0,129,41.348967,-73.591393,10560
834557,0,0,0,2,12,14,40.830395,-73.89796,10459
782269,0,0,0,4,12,16,40.874554,-73.901617,10468
330729,0,0,0,4,12,16,44.953617,-73.528097,12958
842344,0,0,0,75,0,75,40.771195,-73.906179,11105
874180,0,12,123,21,0,156,40.817648,-73.117466,11779
6938,0,0,0,4,12,16,40.749087,-73.327968,11729
858883,0,0,0,4,12,16,40.70728,-73.68581,11003
877667,0,0,0,44,0,44,42.865107,-73.768346,12065
264842,0,0,0,2,6,8,42.095188,-79.2598,14701
440380,0,0,0,4,12,16,40.729332,-73.856967,11374
631492,0,0,0,4,12,16,40.75934,-73.875444,11369
176739,0,0,10,60,0,70,42.106573,-76.807815,14901
858413,0,0,0,4,12,16,40.709202,-73.757613,11412
64935,0,0,0,0,6,6,40.797237,-73.946644,10029
867514,0,0,0,4,12,16,40.754759,-73.770484,11364
712398,16,16,32,0,0,64,42.10624,-76.228517,13827
875709,4,9,14,15,0,42,43.208139,-78.38161,14103
73347,0,0,0,297,0,297,40.689585,-73.872988,11208
532238,0,0,0,2,6,8,43.183424,-77.635657,14613
854734,0,0,0,4,12,16,40.877455,-73.900143,10463
792077,0,0,0,149,0,149,40.623745,-73.946486,11210
587573,0,0,38,20,0,58,43.168115,-77.630638,14608
295562,0,0,0,4,12,16,43.195542,-77.575571,14609
882844,0,0,0,2,12,14,40.862023,-73.824154,10475
426783,0,0,0,4,12,16,40.624252,-74.165743,10303
393550,0,0,0,4,12,16,43.184324,-77.596222,14621
41326,0,0,0,80,0,80,40.994028,-73.868629,10706
71705,0,0,0,4,12,16,40.642718,-73.893772,11236
882607,0,0,0,0,12,12,40.862905,-73.899375,10463
877939,24,18,0,0,0,42,42.593028,-76.17897,13045
706478,0,12,100,0,0,112,40.669216,-73.484908,11783
412458,0,0,0,2,6,8,40.767459,-73.990226,10019
738497,0,0,0,4,12,16,40.825457,-73.904485,10456
670100,0,0,0,4,12,16,40.695438,-73.747492,11412
40862,0,0,18,0,0,18,43.063452,-77.233005,14522
879464,0,0,0,4,12,16,40.817437,-73.814634,10465
801844,0,0,0,4,12,16,40.855032,-73.863979,10462
878350,0,0,0,2,6,8,40.731858,-73.526974,11756
707924,0,0,0,4,12,16,41.007107,-73.7317,10605
793632,0,0,0,2,6,8,43.17598,-77.646675,14613
856791,0,0,0,2,12,14,40.830428,-73.913874,10456
143392,0,0,0,4,12,16,42.165988,-76.990449,14830
41793,0,0,0,174,0,174,43.275189,-73.631705,12803
834165,0,0,0,0,12,12,40.690478,-73.722188,11003
331559,0,0,0,2,12,14,40.834631,-73.91524,10456
874367,0,12,112,0,0,124,40.940926,-73.89762,10701
39320,8,24,30,0,0,62,42.609237,-76.185197,13045
689571,0,0,0,59,0,59,40.693069,-73.916666,11221
613125,0,0,0,73,0,73,40.771785,-73.645492,11507
752582,0,0,0,120,0,120,40.771102,-73.924139,11102
541898,0,0,0,4,12,16,41.507578,-73.968749,12508
715459,0,0,0,132,0,132,40.771126,-73.928905,11102
772859,0,0,0,4,12,16,40.657093,-73.742333,11422
872246,0,0,35,0,0,35,41.379112,-74.537183,10940
462877,0,0,0,4,12,16,43.09239,-79.041178,14301
722934,0,0,0,4,12,16,43.148402,-77.650713,14611
42834,0,0,0,35,0,35,41.333421,-74.186668,10950
42243,0,0,0,44,0,44,42.998706,-78.739652,14221
455578,0,0,0,4,12,16,40.855178,-73.893345,10458
273359,0,0,0,2,12,14,40.802199,-73.962448,10025
810700,8,8,21,0,0,37,40.943573,-73.066781,11777
357594,0,0,0,44,0,44,40.890094,-73.43839,11743
43347,16,36,55,12,0,119,42.829169,-78.770399,14224
822583,0,0,0,4,12,16,40.832111,-73.861451,10472
582652,0,0,0,215,0,215,40.863723,-73.289758,11725
813631,0,0,0,4,12,16,40.844134,-73.887439,10460
866783,0,0,0,4,12,16,40.882219,-73.846217,10466
686381,0,0,0,4,12,16,40.691482,-73.780065,11434
641590,0,0,0,4,12,16,40.695315,-73.914206,11221
816249,0,0,0,75,0,75,40.868881,-73.096232,11720
31717,0,0,0,2,12,14,43.20953,-77.680994,14626
843936,0,0,0,2,6,8,42.637698,-73.570289,12018
777654,0,8,108,0,0,116,42.825676,-78.81098,14218
629558,0,0,0,4,12,16,40.846414,-73.829914,10461
73793,0,0,0,115,0,115,40.599979,-73.743994,11691
841819,0,0,0,4,12,16,40.674627,-73.983222,11215
752110,0,0,0,4,12,16,40.684831,-73.825559,11419
303354,0,0,0,4,12,16,41.924681,-73.999521,12401
142310,0,0,0,4,12,16,42.804663,-78.820934,14219
723202,0,0,0,4,12,16,40.705146,-73.916184,11237
709546,0,0,0,176,0,176,40.743295,-74.002817,10011
132708,0,0,0,4,12,16,40.780655,-73.225686,11717
376351,0,0,0,4,12,16,40.673977,-73.896607,11207
843696,0,0,0,4,12,16,42.396175,-75.223904,13825
817027,0,0,0,0,6,6,40.849699,-73.937886,10033
482013,0,0,0,40,0,40,41.605129,-74.301479,12566
397537,0,0,0,2,6,8,40.698062,-73.378813,11757
74094,0,0,0,15,0,15,40.735847,-73.815749,11367
730247,0,0,0,4,12,16,40.662002,-73.603777,11510
878115,0,0,0,44,0,44,42.661376,-73.757372,12210
354220,0,0,0,2,12,14,40.821764,-73.907223,10456
620278,0,0,0,0,12,12,40.88315,-73.859893,10467
611055,8,13,38,9,0,68,41.105476,-74.031938,10977
631610,0,0,0,4,12,16,41.138863,-74.024061,10977
74051,0,0,0,191,0,191,40.692797,-73.952868,11205
131223,0,0,0,0,10,10,40.847005,-73.892675,10457
523553,0,0,0,4,12,16,40.89149,-73.862702,10466
615037,0,0,0,2,6,8,42.220812,-75.529085,13730
789547,0,0,0,4,12,16,40.58793,-73.941692,11235
803794,0,0,0,4,12,16,40.715223,-73.590159,11553
881814,0,0,0,4,12,16,40.648636,-73.708548,11557
796575,0,0,0,4,12,16,40.85701,-73.902735,10453
778518,0,0,0,4,12,16,41.049784,-73.813792,10523
257163,0,0,0,2,6,8,40.895269,-73.832557,10550
869672,0,0,0,2,6,8,43.169962,-76.226008,13090
628225,0,0,0,4,12,16,40.855345,-73.931236,10040
772033,0,0,0,140,0,140,40.695114,-73.987509,11201
56128,0,0,0,2,6,8,40.844169,-73.880369,10460
73617,0,0,0,75,0,75,40.714323,-73.995529,10002
833289,0,0,0,4,12,16,40.88738,-73.862081,10466
732200,0,0,0,2,6,8,42.802565,-73.936165,12307
64687,0,0,0,2,6,8,40.802643,-73.950775,10026
299734,0,0,0,2,10,12,40.722349,-73.978087,10009
325727,0,0,0,4,12,16,40.691489,-73.732705,11411
555859,0,0,26,54,0,80,40.681707,-73.591616,11575
880086,0,0,0,4,12,16,40.870958,-73.919613,10034
841393,0,0,0,4,12,16,40.844523,-73.868332,10460
32709,0,0,0,4,12,16,40.742161,-73.259275,11706
797979,0,0,20,0,0,20,43.085471,-77.582122,14623
370209,0,0,0,4,12,16,40.676567,-73.841824,11417
825203,0,0,0,4,12,16,40.778694,-73.265475,11717
152381,0,0,0,2,12,14,40.657082,-73.883511,11207
861831,0,0,0,4,12,16,40.866148,-73.896343,10468
774084,0,0,0,2,12,14,40.844611,-73.911004,10457
822914,0,0,0,48,0,48,40.674265,-73.353431,11787
760131,0,0,0,2,6,8,40.59659,-73.783133,11691
277112,0,0,0,4,12,16,42.973371,-78.520695,14001
387270,0,0,0,2,6,8,43.055524,-76.120543,13206
399605,0,0,0,4,12,16,40.650245,-74.006455,11232
105110,0,0,0,4,12,16,40.922372,-73.767796,10801
72115,0,0,0,4,12,16,40.701304,-73.85811,11385
730838,0,0,0,4,12,16,42.924307,-78.797464,14215
789953,17,0,53,15,0,85,43.170322,-77.540994,14609
34457,0,0,0,2,12,14,41.995017,-73.861926,12571
360343,0,0,0,4,12,16,40.724861,-73.565762,11554
667658,16,24,0,12,0,52,42.836952,-78.806967,14220
167612,0,0,0,4,12,16,42.44009,-75.595865,13830
698932,0,0,0,4,12,16,40.682438,-73.82439,11419
796988,0,0,0,4,12,16,40.844609,-73.910169,10457
40182,0,0,42,0,0,42,44.334766,-75.468393,13642
664549,0,0,0,2,6,8,40.815984,-73.947983,10030
454206,0,0,0,2,12,14,40.874978,-73.829175,10475
767387,0,0,0,4,12,16,40.66851,-73.973791,11215
58508,0,0,0,1,6,7,40.83409,-73.918596,10452
815866,0,0,0,19,0,19,40.675919,-73.926016,11233
782673,0,0,0,4,12,16,43.173035,-77.582812,14605
857237,0,0,0,104,0,104,40.691967,-73.931487,11221
625560,0,0,0,4,12,16,40.901802,-73.833555,10550
648917,0,0,0,2,6,8,40.832866,-73.917918,10456
792446,0,0,0,2,12,14,40.866011,-73.902574,10468
223737,0,0,0,0,6,6,40.709976,-73.952659,11211
797810,0,0,0,4,12,16,40.632094,-73.989979,11219
875139,0,0,0,4,12,16,40.815917,-73.860134,10473
882652,0,0,0,4,12,16,40.70166,-73.385985,11757
209013,0,0,0,2,6,8,40.71162,-73.989382,10002
790736,0,0,0,0,6,6,40.694154,-73.937051,11206
475779,0,0,0,4,12,16,40.69175,-73.58958,11553
506699,0,0,0,4,12,16,40.845781,-73.889163,10457
754087,0,0,0,4,12,16,40.743748,-73.915913,11104
800614,0,0,0,58,0,58,40.816293,-73.930148,10451
150493,0,0,0,2,6,8,43.144119,-75.312776,13492
251745,0,0,0,4,12,16,41.08392,-73.86411,10591
865775,0,0,0,4,12,16,40.928424,-73.889497,10701
831676,0,0,0,117,0,117,40.665835,-73.918238,11212
72791,0,0,0,4,12,16,40.660176,-73.926629,11212
856477,0,0,0,145,0,145,40.850674,-73.934108,10033
137564,32,53,58,0,0,143,42.813686,-73.892452,12309
678238,8,10,14,0,0,32,42.950201,-78.810987,14215
461146,0,0,0,2,6,8,43.014051,-76.149165,13205
419150,0,0,0,4,12,16,40.829082,-73.919963,10456
250945,0,0,18,44,0,62,40.741576,-73.687665,11040
400804,16,41,117,0,0,174,42.858267,-78.714445,14224
876940,0,0,0,4,12,16,40.818465,-73.864352,10473
39461,12,19,23,20,0,74,42.798733,-78.747679,14127
550918,0,0,0,4,12,16,41.56809,-74.234409,12549
114063,0,0,0,100,0,100,40.848597,-73.908567,10453
688321,0,0,0,4,12,16,40.683256,-73.99162,11231
367975,0,0,0,4,12,16,40.635043,-74.096235,10301
367950,0,0,0,0,10,10,40.843648,-73.939803,10032
161114,0,0,0,4,12,16,40.737719,-73.267835,11706
810144,0,0,0,4,12,16,40.839444,-73.92161,10452
6366,0,0,0,2,6,8,43.150593,-75.328871,13424
613591,0,0,0,4,12,16,40.843414,-73.822503,10465
128692,8,48,36,0,0,92,43.142155,-77.628015,14611
872361,0,0,0,4,12,16,40.683774,-73.611867,11510
881255,0,0,0,4,12,16,40.853857,-73.935669,10033
663474,0,0,0,4,12,16,40.746447,-73.317511,11703
822912,0,0,0,55,0,55,40.685723,-73.366048,11757
72597,0,0,0,4,12,16,40.735944,-73.859353,11368
762440,0,0,0,4,12,16,40.726523,-73.433881,11735
44936,16,12,18,20,0,66,41.638929,-73.963192,12547
454707,0,0,0,2,6,8,40.846083,-73.915286,10452
710053,0,0,0,4,12,16,40.84077,-73.914144,10452
837851,0,0,0,112,0,112,40.774577,-72.949436,11713
503684,0,0,0,4,12,16,40.832075,-73.898619,10456
225665,0,0,0,4,12,16,43.055074,-76.190125,13204
654596,0,0,0,35,0,35,40.823667,-73.920469,10451
718258,0,0,0,4,12,16,40.591894,-73.796233,11692
776937,0,0,0,2,6,8,40.829745,-73.906254,10456
743062,0,0,0,4,12,16,41.462681,-74.033069,12553
846020,0,0,0,4,12,16,40.679578,-73.871702,11208
437161,0,0,0,4,12,16,40.703042,-73.602055,11550
209561,0,0,0,2,12,14,40.65162,-73.935735,11203
44698,0,0,0,221,0,221,43.176935,-77.624321,14621
73869,0,0,0,40,0,40,40.710148,-73.801097,11432
72224,0,0,0,0,10,10,40.68472,-73.883288,11208
341437,7,15,26,18,0,66,43.186092,-77.621132,14621
4421,0,0,0,4,12,16,43.255484,-77.353439,14519
874069,16,60,63,0,0,139,40.680068,-73.532711,11710
855448,0,0,0,0,10,10,40.652438,-74.006037,11232
44863,0,0,0,217,0,217,40.740874,-73.253919,11706
840664,0,0,0,2,12,14,40.816596,-73.885945,10474
350279,0,0,0,2,10,12,40.932152,-73.901588,10701
729307,0,0,0,2,6,8,40.868686,-73.866109,10467
478036,0,12,48,0,0,60,40.825193,-73.664834,11050
744810,0,0,0,4,12,16,40.618078,-73.928929,11234
859493,0,0,0,4,12,16,40.856033,-73.900394,10457
255552,0,0,0,4,12,16,40.634145,-74.112311,10310
848194,0,0,0,4,12,16,40.844101,-73.910171,10457
765955,0,0,0,4,12,16,40.666488,-73.992624,11215
443194,16,29,36,16,0,97,43.034871,-78.802713,14228
519808,0,0,0,0,12,12,40.826443,-73.893145,10459
879839,0,0,0,0,12,12,40.842609,-73.914971,10452
858059,0,0,0,4,12,16,40.867785,-73.895565,10468
410849,0,0,0,4,12,16,43.25622,-78.181362,14411
563754,0,0,0,2,12,14,40.888034,-73.850401,10466
617453,0,0,0,157,0,157,40.697431,-73.74061,11411
562346,0,0,0,4,12,16,40.827912,-73.939318,10039
794252,0,0,0,4,12,16,40.847335,-73.849046,10461
733560,0,0,0,4,12,16,40.712163,-73.611422,11550
589324,0,0,0,4,12,16,40.67601,-73.78193,11434
427975,0,0,0,4,12,16,40.652094,-73.937979,11203
40591,0,12,56,0,0,68,40.992418,-73.818007,10583
793914,0,0,0,4,12,16,40.863579,-73.904163,10468
814479,0,0,0,90,0,90,40.806359,-73.921026,10454
262808,0,0,0,75,0,75,43.13413,-76.313449,13027
877064,8,12,15,0,0,35,40.743011,-73.569752,11590
29881,0,0,0,4,12,16,41.278358,-73.924684,10566
814806,0,0,0,251,0,251,40.757694,-73.859143,11368
733423,0,0,0,4,12,16,40.698472,-73.599402,11553
774320,0,0,0,4,12,16,42.482646,-76.564678,14850
841083,23,21,39,30,0,113,42.960009,-73.789483,12118
738422,0,0,0,4,12,16,43.169619,-75.526017,13478
361699,16,24,75,40,0,155,43.113805,-76.179315,13088
369613,0,0,0,4,12,16,40.619471,-74.081901,10304
592436,0,0,0,2,6,8,40.963603,-73.722458,10528
458801,0,0,0,2,12,14,40.862001,-73.907067,10468
236868,0,0,0,2,6,8,41.903973,-73.980589,12466
39157,7,12,30,30,0,79,42.654763,-73.925093,12186
73915,0,0,0,191,0,191,40.62516,-74.151186,10303
295398,0,0,0,30,0,30,40.687055,-73.942283,11221
8319,0,0,0,4,12,16,43.152684,-76.338235,13027
43405,0,58,42,0,0,100,40.960877,-72.195503,11937
71143,0,0,0,4,12,16,40.66988,-73.866509,11208
842964,0,0,0,4,12,16,40.870977,-73.88334,10458
40957,8,12,21,0,0,41,40.873459,-73.414797,11743
409927,0,0,0,4,12,16,44.717475,-73.478066,12901
285276,8,24,15,0,0,47,43.021351,-76.118677,13244
633801,24,42,107,40,0,213,42.99536,-73.79097,12020
794644,0,0,0,44,0,44,40.841548,-73.887022,10460
445794,0,0,0,0,12,12,40.731225,-73.857427,11374
322350,0,0,0,100,0,100,40.678313,-73.965735,11238
824483,0,0,0,4,12,16,40.649842,-73.707316,11581
876257,0,0,0,4,12,16,40.612493,-73.956233,11230
614514,0,0,0,4,12,16,40.717034,-73.959704,11249
297785,0,0,0,2,6,8,44.199757,-73.781444,12943
858960,0,0,0,7,0,7,40.688799,-73.97794,11217
811932,0,0,0,4,12,16,40.660896,-73.759519,11422
867335,0,0,0,54,0,54,40.836372,-73.939264,10032
433133,0,0,0,210,0,210,40.687111,-73.878345,11208
850389,8,0,10,12,0,30,42.473256,-78.940723,14070
45091,0,0,18,0,0,18,42.147244,-73.636614,12521
723217,0,0,0,4,12,16,40.702661,-73.605517,11550
756196,0,0,0,4,12,16,40.834905,-73.915712,10456
289770,0,0,0,4,12,16,41.364162,-73.783277,10541
446909,0,0,0,2,12,14,40.868878,-72.979726,11727
868200,16,8,0,0,0,24,42.306939,-77.658417,14843
744765,0,0,0,80,0,80,40.705365,-73.963403,11211
845087,0,0,0,4,12,16,40.875256,-73.858043,10469
848990,0,0,0,4,12,16,40.849508,-73.939037,10033
699732,0,0,0,70,0,70,40.649078,-73.665887,11518
103447,0,0,0,2,12,14,40.646263,-73.960083,11226
574999,0,0,0,4,12,16,40.681359,-73.577977,11575
380174,0,0,0,2,6,8,40.766769,-73.99247,10019
841650,0,0,0,4,12,16,40.879339,-73.859548,10467
231469,0,0,0,231,0,231,40.7277,-73.978,10009
198333,0,0,0,4,12,16,40.692167,-73.597015,11553
259838,0,0,0,4,12,16,40.784205,-73.517041,11801
444975,0,0,0,4,12,16,40.67378,-73.97893,11215
853631,0,0,0,34,0,34,40.827263,-73.907628,10456
867903,0,0,0,4,12,16,40.731535,-73.953872,11222
375442,0,0,0,191,0,191,40.815448,-73.885561,10474
284239,0,0,0,2,6,8,40.852059,-73.930348,10033
816373,0,0,0,4,12,16,40.595349,-73.792728,11692
726076,0,0,0,4,12,16,40.615922,-73.918656,11234
268369,0,0,0,4,12,16,40.838131,-73.864728,10460
790452,0,0,0,4,12,16,40.855357,-73.865596,10462
870660,0,0,0,4,12,16,40.696007,-73.362567,11757
819851,0,0,0,4,12,16,40.805487,-73.91683,10454
40217,15,10,32,0,0,57,42.850049,-73.94243,12302
726225,0,0,0,4,12,16,40.635657,-74.11583,10310
473911,0,0,0,0,12,12,40.848543,-73.931505,10033
762328,0,0,0,4,12,16,40.594834,-73.961131,11223
849336,0,0,0,4,12,16,44.71856,-73.403942,12901
879060,0,0,0,4,12,16,40.831652,-73.857805,10472
318947,0,0,95,0,0,95,42.341326,-76.841329,14865
556703,0,0,0,2,12,14,40.87603,-73.903146,10463
492772,0,0,0,4,12,16,40.917166,-73.895742,10705
684060,0,0,0,4,12,16,43.046993,-76.110626,13224
659830,0,0,0,4,12,16,42.796999,-73.945256,12303
71564,0,0,0,4,12,16,40.711839,-73.853455,11375
813661,0,0,0,2,6,8,43.026053,-76.13937,13210
346796,0,0,0,280,0,280,40.665223,-73.811415,11420
881565,0,0,0,4,12,16,42.21793,-78.270787,14727
724909,0,0,0,4,12,16,41.123036,-74.050337,10977
244586,0,0,0,360,0,360,40.833113,-73.914154,10456
250493,0,0,0,2,12,14,40.85446,-73.92894,10040
449424,8,34,47,0,0,89,40.70583,-73.50294,11793
750417,32,72,84,18,0,206,40.677536,-73.473946,11758
139278,0,0,0,2,6,8,42.058045,-76.143988,13732
431699,0,0,0,2,6,8,44.234942,-76.087683,13624
808132,0,0,0,0,12,12,43.037892,-73.829808,12866
146262,0,0,0,2,6,8,42.330318,-75.755002,13778
299068,16,28,37,13,0,94,43.065458,-77.407785,14450
24013,0,0,0,2,5,7,43.171627,-77.590642,14605
790174,0,0,0,4,12,16,40.908264,-73.831713,10550
643630,0,0,0,4,12,16,40.830702,-73.918584,10456
859412,0,0,0,4,12,16,40.79911,-73.182886,11722
876224,0,0,0,4,12,16,40.827322,-73.946954,10031
643864,0,0,0,2,6,8,40.83463,-73.941976,10032
858127,0,0,0,20,0,20,42.475317,-78.940982,14070
758322,0,0,0,2,6,8,43.145738,-77.626622,14608
750149,0,0,0,4,12,16,40.813228,-73.937072,10037
823378,0,0,0,4,12,16,40.859244,-73.893433,10458
837414,0,0,0,2,6,8,43.127617,-73.742748,12831
242573,0,0,0,4,12,16,40.923912,-73.829714,10552
682894,0,0,0,219,0,219,40.672846,-73.919755,11233
108853,0,0,0,2,6,8,40.812234,-73.938203,10037
276185,0,0,0,2,6,8,43.221339,-75.454491,13440
504439,0,0,0,2,12,14,40.844384,-73.909243,10457
873408,0,0,0,2,6,8,43.166594,-77.58308,14609
787307,0,0,0,4,12,16,40.693098,-73.763619,11412
880870,0,0,0,4,12,16,40.721729,-73.81712,11367
74169,0,0,0,198,0,198,40.714515,-73.983172,10002
844249,0,0,0,4,12,16,40.851101,-73.920151,10453
809460,0,0,0,2,6,8,43.222282,-75.450946,13440
45211,0,0,0,44,0,44,44.044999,-73.47928,12974
734854,0,0,0,4,12,16,40.737019,-73.923871,11104
626319,0,0,0,4,12,16,40.793419,-73.949424,10029
829578,0,0,0,2,12,14,43.074753,-76.161366,13208
392279,0,0,0,2,10,12,40.857424,-73.899559,10458
804143,24,30,46,20,0,120,42.955279,-78.69355,14221
275804,0,0,0,30,0,30,40.57468,-74.099432,10306
238729,8,12,27,14,0,61,42.097158,-75.909848,13901
734095,0,0,0,4,12,16,41.885048,-74.01732,12401
40932,32,48,36,28,0,144,42.772052,-78.611753,14052
869011,0,0,0,127,0,127,40.751533,-73.833887,11355
770230,0,0,0,2,6,8,43.171766,-77.577419,14609
400651,0,0,0,4,12,16,40.840751,-73.911308,10457
776956,0,0,0,4,12,16,40.638565,-73.580685,11520
683765,0,0,0,0,6,6,40.689151,-73.391245,11757
869053,0,0,0,4,12,16,40.602442,-73.654997,11558
863732,0,0,0,2,6,8,43.208419,-77.645815,14615
662314,0,0,0,4,12,16,40.863749,-73.898043,10468
200862,0,0,96,0,0,96,40.91729,-73.790138,10801
465010,0,0,0,0,12,12,40.824885,-73.903834,10456
553422,0,0,0,4,12,16,40.862101,-73.919612,10034
855082,16,19,123,12,0,170,41.166707,-73.938436,10920
869677,0,0,18,44,0,62,40.750521,-73.680064,11040
823965,0,0,0,4,12,16,40.942195,-73.879713,10701
41337,0,12,25,0,0,37,40.981538,-73.810194,10583
269204,0,0,0,120,0,120,40.832932,-73.43604,11743
817794,0,0,0,4,12,16,40.865545,-73.923469,10034
350333,0,0,0,4,12,16,41.209891,-74.004485,10923
828414,0,0,0,4,12,16,40.65557,-73.597698,11520
881074,0,0,0,0,9,9,40.85768,-73.89798,10458
825141,0,0,0,4,12,16,40.597601,-73.950873,11229
648485,0,0,0,40,0,40,41.643433,-73.928024,12601
843256,0,0,0,4,12,16,40.823162,-73.939042,10039
851227,0,0,0,168,0,168,40.884547,-73.840004,10466
430979,0,0,0,4,12,16,40.854606,-73.902973,10453
841641,0,0,0,2,6,8,42.683984,-73.760249,12211
882668,0,0,0,2,6,8,42.861772,-77.219739,14424
308662,0,0,0,4,12,16,40.669303,-73.592996,11520
613947,0,0,0,0,10,10,40.849997,-73.905063,10457
813232,0,0,0,48,0,48,40.67132,-73.734003,11422
184013,0,0,0,4,12,16,41.092018,-74.080575,10956
878857,0,0,0,4,12,16,40.764908,-73.218941,11717
245780,0,0,0,240,0,240,40.865842,-73.895083,10468
758202,0,0,0,2,6,8,40.658088,-73.727365,11422
866836,0,0,17,0,0,17,42.618131,-75.527317,13815
821443,0,0,0,4,12,16,40.828502,-73.87451,10472
38264,0,0,0,2,6,8,42.922583,-78.797062,14215
712948,0,0,0,4,12,16,40.626522,-73.938493,11210
709792,0,0,0,280,0,280,40.899309,-73.867301,10470
748898,0,0,0,294,0,294,40.87554,-73.861422,10467
783808,0,0,0,4,12,16,40.892327,-73.85686,10466
330119,0,0,0,0,12,12,40.760236,-73.872148,11369
848300,0,0,0,4,12,16,41.128393,-74.062928,10952
39833,0,0,0,150,0,150,40.653968,-73.557554,11566
408046,0,0,0,4,12,16,40.632188,-73.895925,11236
727712,0,0,0,4,12,16,42.656477,-73.780845,12208
876331,0,0,0,4,12,16,40.978396,-73.678259,10580
707139,0,0,0,75,0,75,40.960323,-73.887396,10701
339173,0,0,0,140,0,140,40.79235,-73.809864,11357
801440,0,0,0,4,12,16,40.837052,-73.847415,10462
832773,0,0,0,4,12,16,40.857422,-73.896297,10458
795816,0,0,0,4,12,16,40.852848,-73.886242,10458
696751,0,0,0,100,0,100,42.915573,-76.556853,13021
874557,0,10,16,0,0,26,41.859039,-73.554334,12501
475786,0,0,0,80,0,80,40.669473,-73.879455,11208
740547,16,46,97,10,0,169,40.67071,-73.42547,11758
874634,0,0,0,26,0,26,43.042541,-76.160948,13204
869253,16,10,0,0,0,26,40.80883,-72.779269,11934
270568,0,0,0,2,6,8,42.711749,-74.044388,12009
673127,0,0,0,4,12,16,40.846414,-73.829914,10461
871144,0,0,0,44,0,44,42.905799,-78.892052,14213
731188,0,0,0,4,12,16,40.666709,-73.741251,11422
866829,14,20,26,21,0,81,43.223806,-77.69487,14626
815021,0,0,0,4,12,16,40.706006,-73.595976,11553
541137,0,0,0,0,12,12,40.837242,-73.91546,10452
243199,0,0,0,164,0,164,40.685502,-73.96616,11238
862468,0,0,0,4,12,16,40.675603,-73.656249,11552
361938,0,0,84,0,0,84,42.939117,-78.891824,14207
128959,0,10,20,25,0,55,43.100641,-75.238188,13502
523808,0,0,0,140,0,140,42.990805,-78.755664,14221
222203,0,0,0,4,12,16,41.704353,-73.900148,12603
551489,0,0,0,4,12,16,42.44088,-73.557106,12136
845696,0,0,0,24,0,24,43.03498,-76.444322,13060
646482,0,0,0,2,6,8,40.853408,-73.929102,10040
852155,0,0,0,4,12,16,40.826836,-73.876693,10472
460301,0,0,14,20,0,34,42.140909,-77.05246,14830
344001,0,0,0,111,0,111,40.758676,-73.824384,11355
52238,0,0,0,2,5,7,40.823113,-73.953965,10031
215236,0,0,0,1,6,7,40.831081,-73.922975,10452
121816,0,0,0,4,12,16,41.095122,-73.993686,10994
44935,0,9,153,0,0,162,40.942944,-73.795321,10804
847689,0,0,0,4,12,16,40.632644,-73.975185,11218
420989,8,24,33,30,0,95,43.331956,-73.699812,12804
668108,0,0,0,2,6,8,43.097491,-75.214425,13501
175249,0,0,0,2,12,14,40.877835,-73.901647,10463
764164,0,0,0,4,12,16,41.096971,-74.060592,10977
754756,0,0,0,4,12,16,40.87148,-73.887392,10458
40333,0,0,0,190,0,190,40.758639,-73.119611,11716
51411,0,0,0,1,6,7,40.853729,-73.883473,10458
343639,13,17,41,0,0,71,40.64125,-73.637926,11572
807533,0,0,0,278,0,278,40.814686,-73.856283,10473
277736,0,0,0,4,12,16,40.899294,-73.853333,10470
347428,0,0,0,4,12,16,40.678549,-73.597229,11575
862375,0,0,0,4,12,16,40.852221,-73.928677,10033
40482,0,12,18,0,0,30,43.230241,-77.042989,14551
41790,0,0,0,44,0,44,43.2813,-73.661506,12803
72532,0,0,0,4,12,16,40.823663,-73.890335,10459
741564,0,0,0,4,12,16,40.770172,-73.873435,11369
802272,0,0,0,0,12,12,40.687,-73.756462,11412
800710,0,0,0,119,0,119,40.731797,-73.732403,11427
185078,29,43,63,0,0,135,41.120295,-73.717248,10504
680223,0,0,0,2,6,8,43.013788,-76.14887,13205
42433,0,0,0,20,0,20,43.971736,-75.883325,13601
40816,0,0,0,60,0,60,42.03556,-76.870496,14871
41084,8,11,24,75,0,118,40.930707,-73.898753,10701
328789,0,0,0,2,10,12,43.135556,-77.643871,14619
800716,0,0,0,111,0,111,40.79235,-73.809864,11357
478742,0,0,0,2,6,8,42.222743,-73.897985,12414
876535,0,0,0,4,12,16,40.883144,-73.879897,10467
41487,0,20,19,0,0,39,43.528668,-73.384601,12887
876700,0,0,0,4,12,16,40.833044,-73.910967,10456
760980,0,0,0,4,12,16,40.678081,-73.580263,11575
822138,0,0,0,4,12,16,42.936079,-78.828423,14215
17723,0,0,0,4,12,16,40.922484,-73.839198,10552
36450,0,0,0,2,6,8,40.959734,-72.895471,11786
776348,0,0,0,4,12,16,40.824871,-73.876256,10472
828024,0,0,0,4,12,16,40.65209,-73.980187,11218
357454,0,0,124,0,0,124,42.914377,-78.830373,14211
806397,0,0,0,207,0,207,40.720455,-73.731874,11428
709753,0,0,0,155,0,155,40.859831,-73.888294,10458
240760,0,0,0,4,12,16,40.640757,-73.967974,11218
872897,0,0,0,4,12,16,40.624816,-73.992222,11204
276019,0,0,0,2,5,7,40.790887,-73.94246,10029
873360,0,0,0,4,12,16,41.53082,-74.089051,12550
791498,0,0,26,0,0,26,44.845286,-74.29051,12953
871616,8,22,26,11,0,67,40.655979,-73.599391,11520
116776,0,0,13,0,0,13,43.043188,-76.160763,13204
536055,0,0,0,4,12,16,40.641976,-73.606185,11510
693675,0,0,0,4,12,16,40.83438,-73.916226,10456
399130,0,0,0,2,10,12,40.729791,-73.856357,11374
336701,0,0,0,4,12,16,40.673981,-73.759202,11413
665279,0,0,0,4,12,16,40.593472,-73.795983,11692
795990,0,0,0,4,12,16,40.625775,-73.925508,11234
50263,0,0,0,2,6,8,40.871241,-73.898752,10468
45058,16,16,17,0,0,49,42.200529,-78.144692,14739
413148,0,0,0,100,0,100,40.947231,-72.931568,11778
423614,0,0,0,4,12,16,40.666935,-73.576552,11520
769546,0,0,0,4,12,16,40.683232,-73.58808,11575
820959,0,0,0,4,12,16,40.690078,-73.951197,11216
532760,0,0,0,4,12,16,40.696039,-73.84708,11418
317771,0,9,17,30,0,56,40.881893,-72.950751,11953
760414,0,0,0,114,0,114,40.697832,-73.980741,11201
170007,0,0,0,70,0,70,42.629445,-78.115191,14066
537397,0,0,0,4,12,16,40.823554,-73.890326,10459
73348,0,0,0,278,0,278,40.712122,-73.939284,11211
71905,0,0,0,2,12,14,40.851996,-73.900984,10457
299648,0,0,0,128,0,128,40.87498,-73.832177,10475
881037,0,0,0,4,12,16,42.795726,-73.94491,12303
696042,0,0,0,130,0,130,40.708754,-73.939801,11206
839704,0,0,0,4,12,16,40.853743,-73.934805,10033
842141,0,0,0,2,6,8,40.834772,-73.906991,10456
775999,0,0,0,30,0,30,40.616725,-74.081191,10304
355316,0,0,0,4,12,16,40.853486,-73.903906,10453
649507,0,0,0,4,12,16,40.841818,-73.937199,10032
540436,0,0,0,4,12,16,40.822542,-73.908141,10456
364340,0,0,0,4,12,16,40.831067,-73.947391,10031
228995,0,0,0,60,0,60,40.853584,-73.908554,10453
773086,0,0,108,20,0,128,43.21675,-79.017517,14174
850684,0,0,20,0,0,20,42.096702,-76.806568,14901
386664,0,0,0,4,12,16,40.832241,-73.915613,10456
858583,0,0,0,4,12,16,40.685595,-73.590453,11575
602808,0,0,0,4,12,16,40.833544,-73.918202,10456
273383,0,0,0,4,12,16,40.635763,-73.892189,11236
221078,0,0,0,2,12,14,40.840232,-73.846164,10461
117283,0,0,0,60,0,60,40.978507,-73.714298,10528
846657,0,0,0,4,12,16,40.819479,-73.938348,10030
258096,0,0,0,2,6,8,40.59342,-73.78399,11692
42529,0,0,0,40,0,40,40.901252,-73.288506,11768
37395,0,0,0,4,12,16,40.674812,-73.581456,11575
44398,0,0,0,60,0,60,43.858834,-76.005934,13606
692106,0,0,0,2,6,8,43.108063,-79.0516,14305
836748,0,0,0,44,0,44,42.776094,-73.717515,12047
354965,0,0,0,4,12,16,40.69326,-73.95762,11205
831831,0,0,0,4,12,16,40.879287,-73.906022,10463
673941,0,0,0,2,6,8,40.690868,-73.792462,11433
638130,0,0,0,4,12,16,40.865168,-73.902522,10468
666434,0,0,0,4,12,16,40.591729,-73.658399,11561
609919,0,0,0,4,12,16,40.818482,-73.889338,10474
681312,0,0,0,4,12,16,40.848406,-73.905361,10457
818197,0,0,0,2,12,14,40.8276,-73.920315,10451
139887,0,0,400,0,0,400,40.902654,-73.086069,11733
709835,0,0,0,173,0,173,40.593476,-73.937794,11235
553906,0,0,0,4,12,16,40.617024,-73.986973,11204
870157,0,0,0,4,12,16,41.027899,-73.784641,10606
609098,0,0,0,4,12,16,40.761142,-73.577138,11590
450291,0,0,0,4,12,16,40.706073,-73.593641,11553
309825,0,0,0,2,12,14,40.832952,-73.908518,10456
511104,0,0,0,4,12,16,40.668306,-73.901459,11207
840496,0,0,0,4,12,16,40.589281,-73.947682,11235
767194,0,0,0,4,12,16,40.702466,-73.927043,11237
876150,0,0,0,2,6,8,43.161727,-77.655332,14606
359837,0,0,0,70,0,70,42.696375,-73.904674,12084
218468,0,0,0,4,12,16,40.682573,-73.401823,11726
878514,0,0,0,2,12,14,40.865655,-73.887705,10458
159864,0,0,0,4,12,16,40.761451,-73.222431,11717
24909,0,0,0,2,6,8,43.078572,-77.611745,14623
777759,0,0,0,4,12,16,40.704925,-73.611536,11550
476740,0,0,0,180,0,180,41.642852,-74.700911,12701
72012,0,0,0,2,12,14,40.722536,-73.815633,11367
432032,0,0,0,4,12,16,40.641271,-73.90807,11236
752986,0,0,0,4,12,16,40.670194,-73.741696,11413
43452,0,0,0,60,0,60,43.045969,-76.269906,13031
43988,0,34,77,20,0,131,41.061645,-73.86279,10591
656634,0,0,0,4,12,16,40.697342,-73.746494,11411
269161,0,0,0,132,0,132,40.735154,-73.814088,11367
365313,8,24,253,21,0,306,42.955841,-74.207944,12010
854559,0,0,0,50,0,50,40.734008,-73.86126,11374
706509,0,0,0,4,12,16,43.081234,-77.44439,14450
621245,0,0,0,2,6,8,42.894042,-73.920042,12302
42626,0,0,0,65,0,65,41.152729,-73.995253,10956
690097,0,0,0,4,12,16,40.6615,-73.911773,11212
245100,0,0,0,4,12,16,40.636182,-73.907513,11236
876852,0,0,0,4,12,16,40.689552,-73.907767,11207
804339,0,0,0,72,0,72,40.666855,-73.897643,11207
229366,0,0,0,238,0,238,40.699261,-73.901987,11385
352517,0,0,0,4,12,16,40.848129,-73.935989,10033
799489,0,0,0,2,12,14,40.879824,-73.876261,10467
203702,0,0,0,4,12,16,40.906963,-73.843169,10550
747848,16,24,24,0,0,64,42.75623,-74.071115,12056
40042,16,24,41,67,0,148,42.982748,-77.413722,14564
39609,24,10,56,0,0,90,42.821689,-75.548497,13346
552146,0,0,0,2,12,14,40.823692,-73.906371,10456
580392,0,0,0,4,12,16,42.569372,-75.518915,13815
410441,0,0,0,212,0,212,40.728668,-73.8472,11375
20973,0,0,0,2,5,7,41.581749,-73.857628,12590
799416,0,0,0,2,6,8,44.730023,-75.183599,13660
860382,0,0,0,2,6,8,40.703408,-73.589987,11553
709856,0,0,0,178,0,178,40.586866,-73.961812,11235
650680,0,0,0,168,0,168,40.660101,-73.834612,11414
243026,0,0,0,44,0,44,43.010832,-78.631966,14032
869938,0,0,0,2,6,8,42.921246,-78.800408,14215
880391,0,0,0,0,12,12,40.646177,-74.010851,11220
646772,0,0,0,4,12,16,40.678506,-73.963238,11238
778561,8,12,44,0,0,64,44.35335,-74.141509,12932
546874,8,15,28,4,0,55,41.710024,-73.963056,12528
838608,0,0,0,4,12,16,40.701203,-73.829287,11418
800081,0,0,0,4,12,16,40.713825,-73.616899,11550
803030,0,0,0,4,12,16,40.917471,-73.895289,10705
805823,0,0,0,4,12,16,40.837592,-73.938027,10032
823536,0,0,0,4,12,16,40.790886,-73.969188,10025
758946,0,0,0,4,12,16,40.69804,-73.369693,11757
613065,0,0,0,4,12,16,40.884324,-73.878688,10467
876615,0,0,0,2,6,8,40.698748,-73.779744,11433
72881,0,0,0,140,0,140,40.881441,-73.880939,10467
211249,0,0,0,23,0,23,40.669261,-73.751227,11413
766038,0,0,0,60,0,60,41.164733,-73.821765,10510
131311,0,24,90,0,0,114,41.509473,-73.973139,12508
830834,0,0,0,4,12,16,40.625315,-74.165552,10303
41573,0,0,0,60,0,60,42.794372,-73.987945,12307
241692,0,0,0,100,0,100,42.667048,-74.308236,12157
716794,0,0,0,2,6,8,40.829029,-73.913373,10456
760214,0,0,0,53,0,53,40.72622,-73.974919,10009
42317,0,0,0,80,0,80,40.784216,-73.509484,11801
772026,0,0,0,4,12,16,40.836123,-73.868324,10460
753672,0,0,0,159,0,159,40.843363,-73.920445,10452
40149,7,10,14,0,0,31,41.106177,-74.123969,10901
872945,0,0,0,0,10,10,40.662492,-73.498929,11783
644812,0,0,0,4,12,16,42.924605,-78.892458,14213
878680,0,0,0,150,0,150,40.852577,-73.866446,10462
274735,0,0,0,240,0,240,40.827229,-73.829441,10465
113654,0,0,0,2,12,14,40.862256,-73.929104,10040
779460,0,0,0,144,0,144,40.594219,-73.787327,11691
561909,0,0,0,4,12,16,40.621171,-73.954868,11210
879437,0,0,0,4,12,16,40.673427,-73.739719,11413
768894,0,0,0,100,0,100,40.636488,-73.920529,11234
660677,0,0,0,4,12,16,40.777141,-73.217282,11717
873864,0,12,32,16,0,60,41.282723,-73.793183,10598
243236,0,0,0,159,0,159,40.57469,-73.996125,11224
872838,0,0,0,40,0,40,41.525702,-73.92408,12524
397208,0,0,0,2,12,14,40.81395,-73.949502,10027
332252,32,40,62,30,0,164,42.927963,-78.695423,14043
384014,0,0,0,4,12,16,40.817534,-73.819974,10465
40547,0,15,30,0,0,45,40.91124,-73.809392,10803
41892,0,0,0,72,0,72,40.758497,-73.537875,11801
363887,0,0,0,150,0,150,40.83114,-73.926011,10452
127267,0,0,0,138,0,138,40.710335,-73.996702,10038
564204,0,0,0,4,12,16,43.173035,-77.582959,14605
325130,0,0,0,4,12,16,42.653741,-73.792,12208
64098,0,0,0,2,5,7,40.712323,-73.989475,10002
312424,0,0,0,2,12,14,40.918327,-73.833265,10552
314214,0,0,0,4,12,16,40.883403,-73.896921,10463
794081,0,0,0,4,12,16,40.707342,-73.613336,11550
836605,0,0,0,120,0,120,40.814988,-73.94333,10030
624443,0,0,0,4,12,16,44.696754,-73.448749,12901
751019,0,0,0,4,12,16,40.697961,-73.976984,11205
548711,0,0,0,4,12,16,40.85794,-73.896839,10458
856564,0,0,0,40,0,40,41.644604,-73.878147,12603
254147,0,0,0,4,12,16,40.657286,-73.595869,11520
424715,0,0,0,140,0,140,40.667433,-73.990841,11215
876774,0,0,0,4,12,16,40.7057,-73.722718,11003
694055,0,0,0,4,12,16,40.730562,-73.849263,11375
624395,0,0,0,4,12,16,40.635763,-73.892189,11236
676462,0,12,36,20,0,68,42.9985,-78.7893,14260
544662,0,0,0,4,12,16,40.817034,-73.955046,10027
598566,0,0,0,4,12,16,40.873474,-73.84474,10469
491962,0,0,0,0,10,10,40.860112,-73.904896,10468
830133,0,0,0,4,12,16,40.573794,-74.090801,10306
480116,0,0,0,4,12,16,40.687188,-73.871126,11208
785436,0,0,0,102,0,102,40.824999,-73.873766,10472
861501,0,0,0,40,0,40,40.795031,-73.973632,10025
875057,0,0,0,2,6,8,43.167682,-77.565022,14609
167289,48,204,112,0,0,364,40.612357,-73.739895,11559
805682,0,0,0,117,0,117,40.676316,-73.86306,11208
675670,0,0,0,2,6,8,43.157565,-77.637908,14611
209436,0,0,0,4,12,16,40.634684,-74.02629,11209
346314,0,0,0,70,0,70,40.840378,-73.91858,10452
43648,13,12,75,0,0,100,41.487686,-74.025946,12553
825608,0,0,0,2,6,8,40.748735,-73.2559,11706
72544,0,0,0,4,12,16,40.689459,-73.781093,11434
24330,0,0,0,4,12,16,43.148068,-77.647273,14611
455524,0,0,0,2,12,14,40.873835,-73.901859,10468
587975,0,0,0,2,6,8,42.096722,-76.819832,14901
882874,0,0,0,4,12,16,40.846589,-73.885351,10460
866713,0,0,0,4,12,16,40.913458,-73.846133,10550
880582,0,0,0,4,12,16,40.871655,-73.899344,10468
874252,0,0,0,4,12,16,40.604612,-73.757053,11691
842099,0,0,0,2,6,8,40.65191,-73.893511,11207
709548,0,0,0,217,0,217,40.735174,-73.981729,10003
882628,0,0,0,4,12,16,40.87606,-73.858915,10469
542562,16,22,11,40,0,89,43.106252,-79.009635,14305
874518,0,16,20,0,0,36,43.023928,-74.97842,13350
44084,16,10,44,10,0,80,42.999707,-77.508185,14506
688464,0,0,0,4,12,16,40.927547,-73.793309,10801
670981,0,0,0,4,12,16,40.859981,-73.909981,10453
871484,0,0,0,0,10,10,40.856295,-73.866507,10462
714740,16,42,0,0,0,58,41.917784,-74.050867,12443
404630,0,0,0,2,12,14,40.869803,-73.865962,10467
44813,0,0,0,80,0,80,41.259464,-73.889882,10567
425413,0,0,0,2,6,8,42.270564,-77.101422,14870
855926,8,12,31,0,0,51,40.833641,-73.040422,11738
148761,0,0,0,4,12,16,40.728959,-73.699365,11001
878276,0,0,0,60,0,60,44.035465,-75.855779,13616
532388,0,0,0,4,12,16,40.686595,-73.989888,11201
877293,0,0,0,4,12,16,40.633985,-73.979526,11204
228450,0,0,0,4,12,16,40.843132,-73.868904,10460
874924,0,0,0,30,0,30,40.720591,-74.010717,10013
679829,0,0,0,4,12,16,40.855465,-73.90867,10453
51271,0,0,0,2,6,8,40.687834,-73.830528,11419
720714,0,0,0,2,12,14,40.82314,-73.909947,10451
844741,0,0,0,2,12,14,40.816188,-73.866117,10473
103143,0,0,0,4,12,16,40.640906,-73.905357,11236
617738,16,24,19,0,0,59,41.920824,-73.987213,12401
877268,0,0,0,60,0,60,44.155174,-75.708288,13673
39339,0,48,130,39,0,217,41.572762,-73.844188,12533
42108,16,24,42,30,0,112,42.98686,-76.200615,13215
757181,0,0,0,2,6,8,42.929824,-78.808915,14215
801922,0,0,0,213,0,213,40.621006,-74.029796,11209
126872,0,0,0,2,6,8,40.645606,-73.958914,11226
652096,0,0,0,300,0,300,40.632606,-73.954562,11230
709696,0,0,0,163,0,163,40.67271,-73.742875,11413
711166,0,0,0,64,0,64,43.165818,-77.632094,14608
816198,0,0,0,2,12,14,40.861794,-73.895918,10458
877905,0,0,0,2,6,8,42.671857,-73.838516,12203
877562,0,0,0,2,12,14,40.846043,-73.910429,10453
403075,0,0,0,4,12,16,40.7623,-73.884886,11370
798237,0,0,0,4,12,16,40.752728,-73.188721,11752
541684,0,0,0,2,6,8,43.137917,-76.217614,13090
598513,0,0,0,2,6,8,42.915972,-76.800195,13148
793429,0,0,0,0,10,10,40.81527,-73.90552,10455
664785,0,0,0,2,6,8,40.684318,-73.98822,11217
461108,0,0,0,0,12,12,40.802,-73.945952,10026
246741,0,0,0,12,0,12,40.667302,-73.960643,11225
837687,16,10,17,12,0,55,42.952417,-78.824879,14214
840563,0,0,0,4,12,16,40.688476,-73.781544,11434
686210,0,0,0,0,5,5,40.837035,-73.90582,10456
72193,0,0,0,2,12,14,40.725328,-73.862972,11374
789456,0,0,0,4,12,16,40.645612,-73.943384,11203
7424,0,0,0,4,12,16,42.12127,-73.986835,12477
874022,0,0,0,4,12,16,40.669501,-73.593739,11520
687854,0,0,0,120,0,120,40.675989,-74.002679,11231
73705,0,0,0,225,0,225,40.767875,-73.928725,11102
440169,0,0,0,4,12,16,40.636036,-73.921264,11234
570544,0,0,0,2,12,14,40.883902,-73.877825,10467
600923,16,20,33,0,0,69,42.740821,-78.816896,14075
42797,0,22,150,21,0,193,41.165,-73.7751,10514
13741,0,0,0,2,6,8,43.422035,-76.069328,13131
205229,0,0,17,0,0,17,42.546413,-75.250622,13808
40403,0,0,170,0,0,170,40.744068,-73.264117,11706
456506,0,0,0,2,6,8,42.209972,-75.276282,13839
559321,0,0,0,4,12,16,41.292872,-73.909477,10566
500682,16,36,0,0,0,52,40.830933,-73.20185,11787
875661,0,0,0,2,6,8,42.183954,-78.237647,14727
54622,0,0,0,2,6,8,40.816261,-73.897755,10455
73293,0,0,0,240,0,240,40.719765,-73.948471,11222
794163,0,0,0,4,12,16,40.86876,-73.860628,10469
372988,0,0,0,2,12,14,40.829853,-73.922667,10452
662144,0,0,0,4,12,16,40.645847,-73.588318,11520
583072,0,0,0,50,0,50,42.437406,-76.503517,14850
43080,8,10,32,20,0,70,43.167912,-77.699293,14606
288486,0,0,0,4,12,16,40.819118,-73.812676,10465
777509,0,0,0,300,0,300,40.742133,-73.922506,11104
31405,0,0,0,2,6,8,43.113026,-77.431768,14450
629832,0,0,0,156,0,156,40.752755,-73.89289,11372
412886,0,0,0,228,0,228,40.761455,-73.988372,10036
41165,0,28,91,36,0,155,40.588085,-73.666613,11561
669285,0,0,0,4,12,16,40.828566,-73.896374,10459
106765,0,0,0,2,6,8,42.667565,-77.045953,14527
66981,0,0,0,2,6,8,40.806702,-73.956361,10026
486244,0,0,0,2,6,8,42.588492,-73.516951,12018
880914,0,0,0,144,0,144,40.670839,-73.908014,11212
418190,0,0,0,4,12,16,40.858923,-73.901548,10468
42225,0,0,0,104,0,104,43.130947,-77.447078,14526
868742,0,0,0,4,12,16,40.882537,-73.90374,10463
700480,0,0,0,4,12,16,40.90313,-73.829018,10553
712113,0,0,0,2,6,8,40.662295,-73.898923,11207
709670,0,0,0,120,0,120,40.822816,-73.920989,10451
272911,0,0,0,4,12,16,40.673388,-73.8724,11208
39315,0,0,0,115,0,115,42.598199,-76.181359,13045
847333,0,0,0,2,12,14,40.856613,-73.894419,10458
784443,0,0,0,50,0,50,42.417491,-74.02243,12083
871771,0,0,0,4,12,16,42.942148,-78.807078,14215
43917,0,9,58,0,0,67,42.063708,-76.796615,14904
760136,0,0,0,4,12,16,40.666638,-73.893675,11207
878239,0,0,0,0,10,10,40.856617,-73.903993,10453
868463,0,0,0,100,0,100,40.839065,-73.939058,10032
234071,8,20,22,20,0,70,42.91576,-78.783961,14225
523174,0,0,0,2,6,8,40.822917,-73.954249,10031
260758,0,6,21,60,0,87,43.041156,-76.275305,13031
827239,0,0,0,4,12,16,40.838622,-73.850363,10462
34764,0,0,0,4,12,16,43.102729,-77.496328,14534
880231,0,0,0,4,12,16,43.032503,-78.793773,14228
462275,0,11,12,0,0,23,40.657351,-73.665901,11563
326515,0,0,0,2,12,14,43.048843,-74.871646,13365
709650,0,0,0,117,0,117,40.595896,-73.781708,11691
735599,0,0,0,4,12,16,41.440058,-74.421248,10940
860224,8,24,30,20,0,82,40.674063,-73.374707,11757
304136,0,0,0,4,12,16,40.840049,-73.854829,10462
622556,0,0,0,0,12,12,40.836391,-73.914574,10456
822218,0,0,0,65,0,65,40.855839,-73.265693,11725
752063,0,0,0,40,0,40,41.605527,-74.174731,12589
447605,0,0,0,2,6,8,42.077878,-76.811874,14904
817242,0,0,0,96,0,96,40.774986,-73.987168,10023
371061,0,0,0,2,6,8,40.697733,-73.77686,11433
348173,8,12,16,59,0,95,40.68086,-73.587559,11575
132492,0,0,0,4,12,16,42.722933,-73.678401,12180
872105,0,0,0,2,6,8,43.18244,-77.646731,14613
20556,0,0,0,2,6,8,40.790313,-73.260781,11717
721198,0,0,0,2,6,8,42.171909,-76.836395,14845
73248,0,0,0,16,0,16,40.601909,-74.0027,11214
794849,0,0,0,4,12,16,40.818186,-73.900681,10455
710198,24,48,93,0,0,165,43.082915,-76.126313,13208
792330,0,0,0,4,12,16,40.702105,-73.470939,11758
354551,0,0,0,2,12,14,40.676433,-73.984019,11215
620751,0,0,0,160,0,160,40.621763,-73.908812,11234
742123,0,0,0,4,12,16,40.636324,-73.985478,11219
426455,0,0,0,59,0,59,43.461818,-76.236163,13114
631799,0,0,0,2,12,14,40.866309,-73.902347,10468
838116,0,0,0,0,12,12,40.869502,-73.863183,10467
267005,0,0,0,2,12,14,40.857449,-73.895557,10458
223798,0,0,0,4,12,16,44.68454,-73.452127,12901
400051,0,0,0,4,12,16,40.692257,-73.945154,11221
504356,0,0,0,4,12,16,42.920247,-78.845138,14208
244518,0,0,0,131,0,131,40.697962,-73.916651,11237
27659,0,0,0,2,6,8,40.943233,-73.884857,10703
776666,0,0,0,4,12,16,40.746783,-73.858198,11368
818616,0,0,0,4,12,16,42.703192,-73.778229,12205
613161,0,0,0,4,12,16,40.662197,-73.886682,11207
796833,0,0,0,60,0,60,40.608955,-73.75305,11691
376657,0,0,0,4,12,16,40.838049,-73.940412,10032
164294,0,0,0,4,12,16,43.291762,-73.587954,12839
881195,0,0,0,2,6,8,43.252519,-77.614004,14612
857187,0,0,0,4,12,16,40.872169,-73.917843,10034
143851,0,0,0,4,12,16,41.709478,-73.928251,12601
458046,0,0,0,2,12,14,40.875728,-73.884501,10458
611230,0,0,0,150,0,150,40.678313,-73.965735,11238
795531,0,0,21,0,0,21,42.441584,-76.496294,14850
74009,0,0,0,360,0,360,40.883275,-73.891095,10463
797946,0,0,0,200,0,200,40.756537,-73.932925,11106
841464,0,0,0,85,0,85,40.958919,-72.99502,11764
363279,0,17,42,0,0,59,40.865751,-73.62712,11542
881650,0,0,0,4,12,16,40.848901,-73.914713,10453
351777,0,0,0,4,12,16,40.829232,-73.92101,10451
857452,0,0,0,40,0,40,41.300744,-73.917789,10566
860925,0,32,0,0,0,32,43.118218,-77.540033,14618
868019,0,0,0,4,12,16,42.798804,-78.076888,14591
412368,0,0,0,4,12,16,42.906755,-78.812849,14211
109758,0,0,0,2,6,8,42.291159,-77.508294,14823
833768,0,0,0,2,6,8,40.842441,-73.827335,10461
811231,0,0,0,4,12,16,40.783842,-73.537769,11753
703238,0,0,0,80,0,80,40.939252,-73.895143,10703
861860,0,0,0,4,12,16,40.897164,-73.06234,11776
427784,16,24,16,20,0,76,42.453488,-79.334241,14063
39509,0,0,72,0,0,72,42.826802,-78.841884,14218
191045,0,0,0,2,5,7,40.803327,-73.939339,10035
435677,0,0,0,4,12,16,40.666848,-73.575571,11520
72397,0,0,0,4,12,16,40.701021,-73.76439,11412
8568,0,0,0,2,6,8,40.681489,-73.714314,11580
265114,0,0,0,4,12,16,40.670661,-73.87882,11208
34137,0,0,0,4,12,16,43.191841,-77.647532,14613
525032,0,0,0,79,0,79,42.920862,-76.568649,13021
772245,0,0,0,2,6,8,43.18779,-77.636583,14613
56992,0,0,0,2,6,8,40.88011,-73.876115,10467
137195,0,0,0,2,12,14,40.719644,-73.735821,11428
282081,0,0,0,4,12,16,40.66274,-73.917501,11212
826179,4,15,23,0,0,42,42.949379,-76.545065,13021
428139,0,0,0,2,12,14,40.883901,-73.837703,10466
844918,0,0,0,2,6,8,42.778393,-78.737114,14127
527957,0,0,0,2,6,8,43.124824,-77.771811,14624
789887,0,0,0,4,12,16,40.838177,-73.899924,10457
437309,0,0,0,65,0,65,40.652688,-73.911072,11236
480849,0,0,0,2,12,14,40.827845,-73.918951,10451
442177,0,0,0,4,12,16,42.607475,-76.369071,13073
718794,0,0,0,2,6,8,43.299682,-73.42395,12809
519132,0,0,0,4,12,16,40.636066,-73.924047,11234
879798,0,0,0,4,12,16,40.859111,-73.896186,10458
342208,0,0,0,4,12,16,40.638244,-73.967504,11218
339127,0,0,0,240,0,240,40.676152,-73.758254,11434
11758,0,0,0,2,6,8,43.16401,-77.69362,14606
768034,0,0,0,4,12,16,40.737237,-73.86135,11368
429445,0,0,0,2,6,8,40.880036,-73.848675,10469
764811,0,0,18,20,0,38,40.72417,-73.981253,10009
584235,0,0,0,4,12,16,40.86608,-73.891185,10458
124766,0,0,0,2,6,8,43.257559,-76.432993,13069
744969,0,0,0,4,12,16,40.646938,-73.969737,11218
799146,0,0,0,40,0,40,40.704125,-73.893936,11385
642756,0,0,0,4,12,16,40.85884,-73.90264,10468
110419,0,0,0,4,12,16,40.830634,-73.893467,10459
697733,0,0,0,180,0,180,40.594338,-73.795059,11692
253757,0,0,0,0,10,10,40.690543,-73.695038,11003
477451,0,0,0,40,0,40,40.750069,-73.037528,11715
849122,0,0,0,4,12,16,40.877631,-73.873686,10467
292333,0,0,0,4,12,16,40.892216,-72.973295,11953
861315,0,0,0,4,12,16,40.820585,-73.863907,10473
778312,0,0,0,4,12,16,42.980957,-78.584048,14031
416020,0,0,0,0,12,12,40.660905,-73.727652,11422
443292,0,0,0,561,0,561,40.820462,-73.893146,10459
207319,0,0,0,40,0,40,41.392282,-73.774237,10541
875410,0,0,0,2,12,14,40.859111,-73.896186,10458
736899,0,0,0,4,12,16,44.639685,-75.469888,13669
783629,0,0,0,4,12,16,40.669679,-73.878581,11208
831722,0,23,59,0,0,82,40.617282,-73.727604,11559
366682,0,0,0,4,12,16,40.699428,-73.98103,11201
678537,0,0,0,4,12,16,40.818365,-73.895127,10459
875997,0,0,0,4,12,16,40.863019,-73.898841,10468
226063,0,0,21,149,0,170,40.813297,-73.937435,10037
43735,0,0,0,40,0,40,42.594842,-76.175537,13045
709914,0,0,0,120,0,120,40.833598,-73.94226,10032
792971,0,0,0,4,12,16,40.621628,-74.083014,10304
773970,0,0,0,68,0,68,40.669012,-73.863829,11208
825380,0,0,0,460,0,460,40.771812,-73.957852,10021
600382,0,0,0,2,6,8,40.893892,-73.850389,10466
877118,0,0,0,2,12,14,40.836054,-73.866252,10460
739133,0,0,0,4,12,16,40.843366,-73.939877,10032
714007,0,0,0,155,0,155,41.083173,-73.858509,10591
29963,0,0,0,2,6,8,43.430304,-73.285939,12832
872159,0,0,0,44,0,44,42.722515,-78.940157,14085
44718,8,12,42,0,0,62,41.931914,-74.015313,12401
411234,0,0,0,44,0,44,41.372106,-73.726037,10541
738566,0,0,0,0,12,12,40.837417,-73.859254,10462
670215,0,0,0,4,12,16,40.666906,-73.59978,11520
687153,0,0,0,4,12,16,43.465459,-76.41476,13126
506901,0,0,0,4,12,16,40.611816,-73.947392,11229
298234,0,0,0,4,12,16,40.866404,-73.820593,10475
384936,0,0,0,301,0,301,40.81422,-73.886888,10474
728938,0,0,0,4,12,16,40.687621,-73.851709,11421
296927,0,0,0,2,12,14,40.698929,-73.816541,11418
461692,0,0,0,4,12,16,40.832653,-73.879951,10472
864265,0,0,0,4,12,16,40.648433,-73.583276,11520
819496,0,0,26,0,0,26,43.046192,-73.847972,12020
119999,0,0,0,2,6,8,41.500699,-73.972175,12508
835502,0,0,0,75,0,75,40.844281,-72.932997,11980
833337,0,0,0,2,6,8,40.838235,-73.910991,10456
846184,0,0,0,4,12,16,40.867641,-73.86332,10467
742889,0,0,0,4,12,16,41.537308,-73.910829,12524
804012,0,0,0,4,12,16,42.638915,-73.77461,12209
752494,16,36,111,45,0,208,40.68811,-73.568065,11566
722954,0,0,0,2,6,8,42.614335,-74.734549,12197
828953,0,0,0,4,12,16,40.843883,-73.936536,10032
475386,0,0,0,2,6,8,40.822013,-73.950168,10031
5403,0,0,0,2,6,8,42.936461,-76.560766,13021
669080,0,0,0,4,12,16,40.763452,-73.881322,11369
880216,0,0,0,145,0,145,41.062164,-73.863493,10591
877511,0,0,0,2,10,12,41.469196,-74.111202,12553
722094,0,0,0,43,0,43,40.648666,-73.957285,11226
856354,0,0,0,2,6,8,43.318648,-73.727986,12804
780513,0,0,0,4,12,16,40.661543,-73.575575,11520
855318,0,0,0,104,0,104,43.1703,-77.602088,14605
251944,0,0,18,0,0,18,43.046827,-75.378298,13323
842441,0,0,0,162,0,162,40.684403,-73.67724,11010
358641,0,0,0,4,12,16,40.577055,-73.961515,11235
452757,0,0,0,4,12,16,40.814385,-73.899956,10455
823839,0,0,0,4,12,16,40.725181,-73.357817,11704
616952,0,0,0,2,6,8,40.853503,-73.912225,10453
432335,16,23,49,20,0,108,43.233848,-77.926965,14420
709783,0,0,0,231,0,231,40.690105,-73.904892,11207
724735,0,0,0,2,6,8,40.678641,-73.728263,11422
217139,0,0,0,4,12,16,40.622655,-73.922261,11234
141911,0,0,0,2,6,8,43.207044,-77.575381,14622
822947,0,0,0,4,12,16,40.891328,-73.861582,10466
849512,0,0,0,2,6,8,42.243152,-76.375768,13864
168818,8,22,44,18,0,92,42.773267,-73.935768,12303
831143,0,0,0,4,12,16,40.821149,-73.910184,10451
771496,0,0,0,4,12,16,40.601108,-74.126956,10314
616755,0,0,0,4,12,16,40.836543,-73.034921,11738
872577,23,25,70,0,0,118,40.920899,-73.804761,10803
176022,0,0,0,50,0,50,40.875897,-73.140575,11780
647689,0,0,0,4,12,16,40.813804,-73.91359,10455
26546,0,0,0,4,12,16,41.640311,-73.922298,12601
430757,0,0,0,34,0,34,40.591101,-74.066993,10305
867623,0,0,0,4,12,16,40.758088,-73.929412,11106
855950,0,0,0,4,12,16,40.898436,-73.847529,10466
843105,0,0,0,4,12,16,40.861387,-73.925879,10040
72335,0,0,0,4,12,16,40.682675,-73.824543,11419
661102,0,0,0,4,12,16,40.716809,-73.985242,10002
854095,0,0,0,4,12,16,41.694234,-73.904952,12603
465715,0,0,0,4,12,16,41.77063,-73.577642,12522
634359,0,0,0,120,0,120,40.665536,-73.939353,11213
837878,0,0,0,2,6,8,40.859489,-73.868699,10467
406209,0,0,0,82,0,82,40.72064,-73.371673,11704
178463,0,0,0,194,0,194,40.783336,-73.80611,11357
512387,0,0,0,4,12,16,40.640482,-73.612474,11510
817392,0,0,0,4,12,16,40.8367,-73.852478,10462
71318,0,0,0,4,12,16,40.671121,-73.944113,11213
575478,0,0,0,4,12,16,40.847889,-73.934993,10033
785634,0,0,0,44,0,44,44.824768,-74.520948,12916
549482,0,0,0,4,12,16,40.683471,-73.878416,11208
39709,40,60,93,120,0,313,43.096422,-77.567972,14618
820583,0,0,0,2,12,14,40.872938,-73.903225,10463
42485,8,20,30,20,0,78,43.062881,-77.327505,14502
862842,0,0,0,4,12,16,40.633412,-73.906929,11236
640701,0,0,0,2,12,14,40.86416,-73.901488,10468
713796,0,0,0,100,0,100,43.041131,-74.343932,12078
881129,0,0,0,4,12,16,40.648186,-73.880972,11239
305733,32,48,58,11,0,149,43.217851,-77.446181,14580
820431,0,0,0,2,6,8,42.792696,-73.971272,12306
874818,0,0,0,4,12,16,40.643606,-73.714192,11598
232875,0,0,0,154,0,154,40.80665,-73.951129,10027
134504,16,0,0,0,0,16,42.122756,-75.963228,13790
807622,0,0,0,2,6,8,42.164043,-76.822621,14845
39787,0,0,84,0,0,84,40.838173,-73.699612,11050
21699,0,0,0,4,12,16,43.099742,-79.041732,14301
429270,0,0,0,2,6,8,41.455915,-73.763167,10512
779846,0,0,0,4,12,16,43.070343,-76.154423,13208
829418,0,0,0,52,0,52,40.67312,-73.743795,11413
868134,0,0,0,4,12,16,40.854871,-73.933669,10040
72018,0,0,0,4,12,16,40.870403,-73.887045,10458
333086,0,0,0,4,12,16,40.740193,-73.977057,10016
756200,0,0,0,4,12,16,40.864905,-73.90289,10468
774776,0,0,0,4,12,16,43.148965,-77.441877,14526
320045,0,0,0,4,12,16,41.02494,-73.79073,10530
853259,0,0,0,2,6,8,42.232953,-76.351399,13743
813862,0,0,0,4,12,16,40.909477,-73.896842,10471
866071,0,0,0,4,12,16,40.620536,-73.738135,11096
850323,0,0,0,4,12,16,40.849494,-73.886033,10457
876449,0,0,0,30,0,30,42.684396,-73.733206,12204
725757,0,0,0,4,12,16,41.08309,-73.861094,10591
604376,0,0,0,2,6,8,40.701237,-73.608855,11550
860025,0,0,0,0,12,12,42.814438,-73.788287,12065
704060,0,0,0,2,6,8,43.020012,-75.048547,13357
45244,8,21,21,19,0,69,41.398885,-73.632548,10509
41114,0,0,18,0,0,18,44.704689,-73.468241,12901
863653,0,0,0,4,12,16,40.838885,-73.918084,10452
819734,0,0,0,4,12,16,40.854902,-73.914447,10453
74213,0,0,0,314,0,314,40.853052,-73.89342,10457
249079,0,0,21,160,0,181,40.735882,-73.68069,11040
738311,0,12,49,0,0,61,41.135349,-73.859073,10510
880615,0,0,0,255,0,255,40.771195,-73.906179,11105
716038,0,0,0,150,0,150,42.166806,-77.096309,14870
420062,0,0,0,4,12,16,40.886915,-73.860003,10466
368993,0,0,0,4,12,16,44.691763,-73.47677,12901
378699,0,0,0,2,6,8,43.079193,-77.41492,14450
196824,0,0,0,2,6,8,43.201212,-78.730626,14094
767523,0,0,0,4,12,16,40.593953,-73.761936,11691
451155,0,0,0,4,12,16,40.923947,-73.790243,10801
103705,0,0,36,37,0,73,42.330423,-75.977308,13862
144713,0,0,0,25,0,25,40.877714,-73.848987,10469
870517,0,0,0,4,12,16,40.744071,-73.479133,11714
878885,0,0,0,4,12,16,43.029382,-73.583525,12834
761499,0,0,0,2,6,8,40.873969,-73.906839,10463
284550,0,0,0,2,12,14,40.849466,-73.886373,10457
821549,0,0,0,4,12,16,42.106624,-75.887566,13904
626946,0,0,0,4,12,16,40.865376,-73.891289,10458
827002,0,0,0,4,12,16,40.601033,-73.943778,11229
658355,0,0,0,2,6,8,40.815659,-73.900227,10455
588557,0,0,0,4,12,16,40.761769,-73.922091,11106
838779,0,0,0,2,6,8,40.709656,-73.621194,11550
875187,8,21,18,0,0,47,42.995385,-78.637224,14031
41355,0,0,0,58,0,58,41.213766,-73.981484,10993
375230,0,0,0,2,12,14,41.749393,-73.850395,12601
497788,0,0,0,4,12,16,40.61801,-73.917921,11234
433589,0,0,0,202,0,202,40.863781,-73.645047,11542
525814,0,0,0,2,12,14,40.619578,-73.919457,11234
742413,0,0,0,4,12,16,41.063136,-73.809383,10523
450694,0,0,0,2,12,14,40.857162,-73.929955,10040
156344,0,0,0,4,12,16,40.593953,-73.646095,11561
272196,0,0,0,60,0,60,41.746012,-73.814913,12569
825894,0,0,0,4,12,16,40.602482,-73.961288,11223
597567,38,72,216,20,0,346,40.747493,-73.638852,11501
392403,0,0,0,4,12,16,40.662573,-73.915408,11212
114721,0,0,0,44,0,44,43.240052,-73.831291,12822
727224,0,0,0,4,12,16,40.670007,-73.895132,11207
23036,0,0,0,2,6,8,42.85809,-74.027587,12306
777181,0,0,0,4,12,16,40.594367,-74.083959,10305
71826,0,0,0,4,12,16,40.640363,-73.962086,11226
693209,0,0,0,4,12,16,40.847889,-73.934993,10033
385942,0,0,0,4,12,16,40.635278,-73.915347,11236
847009,0,0,15,0,0,15,42.713242,-73.872669,12203
718131,0,0,0,4,12,16,40.802695,-73.266934,11717
154355,0,0,0,2,6,8,40.785487,-73.247634,11717
40338,0,0,0,80,0,80,40.905785,-73.341055,11768
520576,0,0,0,4,12,16,40.689003,-73.907529,11207
623678,0,0,0,4,12,16,40.657515,-73.744147,11422
518005,0,0,0,154,0,154,40.710712,-73.946898,11206
821377,0,0,0,4,12,16,40.826888,-73.889689,10459
866888,0,0,80,20,0,100,41.300744,-73.917789,10566
490318,0,0,0,20,0,20,40.634156,-73.947528,11210
859167,0,0,0,4,12,16,40.809896,-73.946854,10027
411466,0,0,0,0,12,12,40.842951,-73.937035,10032
728231,0,0,0,4,12,16,43.264592,-77.686516,14612
62398,0,0,0,1,6,7,40.673345,-73.957826,11238
265545,0,0,0,0,6,6,40.677745,-74.003551,11231
39487,14,21,21,11,0,67,42.972387,-78.886433,14217
723566,0,0,0,60,0,60,40.999102,-73.826131,10583
858205,0,0,0,80,0,80,42.117968,-76.016921,13760
786937,0,0,0,90,0,90,40.833457,-73.904359,10459
353048,0,0,0,4,12,16,40.841952,-73.828177,10461
813356,0,0,0,4,12,16,40.875607,-73.876257,10467
129572,0,0,0,1,12,13,42.590539,-76.17063,13045
837522,0,0,0,4,12,16,40.69698,-73.404662,11701
435150,0,0,0,1,6,7,40.833161,-73.854319,10462
874607,0,0,0,4,12,16,40.663568,-73.591283,11520
453870,0,0,0,4,12,16,40.637248,-74.165664,10303
764935,0,0,0,4,12,16,40.646045,-73.58467,11520
877188,0,0,0,4,12,16,40.877388,-73.886561,10468
882834,0,0,0,4,12,16,40.918555,-73.897171,10705
301509,0,0,135,0,0,135,40.690556,-73.508178,11793
247926,0,0,0,2,12,14,42.002888,-76.540586,14892
43284,0,0,0,100,0,100,43.084443,-78.973353,14304
709092,0,0,14,0,0,14,43.077144,-75.264145,13501
859317,0,0,0,4,12,16,40.662707,-73.612917,11510
812484,0,0,0,41,0,41,40.633877,-73.902454,11236
43832,14,10,39,16,0,79,41.658158,-73.793248,12603
691708,0,0,15,0,0,15,42.854169,-74.989048,13439
73939,0,0,0,90,0,90,40.78485,-73.9498,10128
415550,0,0,0,4,12,16,43.181208,-77.611684,14621
34557,0,0,0,4,12,16,42.235723,-76.178649,13811
795407,0,0,0,2,6,8,43.28105,-73.657026,12803
218622,0,0,0,4,12,16,40.862006,-73.902972,10468
349114,0,0,0,4,12,16,40.863233,-73.893005,10458
471424,0,0,0,4,12,16,40.633162,-73.988736,11219
773921,0,0,0,4,12,16,40.856929,-73.902502,10453
38503,0,0,0,2,6,8,43.045098,-76.229478,13219
758083,0,0,0,0,12,12,40.847013,-73.909058,10453
182153,0,0,0,0,6,6,40.659429,-73.934333,11203
384253,0,0,0,0,6,6,40.727543,-73.9773,10009
732474,0,0,0,4,12,16,40.854927,-73.901994,10453
672936,0,0,0,4,12,16,43.250504,-73.661662,12828
818044,0,0,0,145,0,145,40.785348,-73.94215,10029
806980,0,0,0,60,0,60,40.594425,-73.940436,11229
803568,0,0,0,4,12,16,43.180153,-77.585126,14621
561137,0,0,0,2,12,14,40.83238,-73.921183,10452
484304,0,0,16,0,0,16,40.947709,-72.29965,11932
848683,0,0,0,4,12,16,40.67183,-73.581294,11575
279886,0,0,0,2,12,14,40.880152,-73.865975,10467
882353,0,0,0,2,6,8,42.968753,-77.118196,14432
735800,0,0,0,4,12,16,40.617123,-74.024664,11228
235963,0,0,0,4,12,16,40.69082,-73.863429,11421
623185,0,0,0,4,12,16,40.776646,-72.825636,11951
801270,0,0,0,64,0,64,43.224776,-77.295317,14519
681612,0,0,0,4,12,16,40.854192,-73.938328,10033
713657,0,0,0,4,12,16,40.649664,-73.60034,11520
71348,0,0,0,2,12,14,40.840571,-73.858153,10462
323223,0,0,0,4,12,16,40.729356,-73.725956,11426
216607,0,0,0,4,12,16,40.727963,-73.466305,11735
827834,0,0,0,4,12,16,40.86171,-73.927138,10040
178181,0,0,0,4,12,16,40.7243,-73.752547,11427
40503,24,52,74,13,0,163,41.043671,-73.826501,10523
765741,32,48,148,30,0,258,40.700029,-73.379834,11757
52698,0,0,0,2,5,7,40.848671,-73.911101,10453
26286,0,0,0,4,12,16,42.053937,-76.137333,13732
828260,0,0,0,2,6,8,42.37555,-78.165681,14717
872427,0,0,0,4,12,16,40.656024,-73.903694,11212
878007,0,0,0,2,6,8,41.715532,-74.954059,12726
867683,0,0,0,78,0,78,40.812082,-73.951124,10027
672317,0,0,0,4,12,16,40.739454,-73.850741,11368
40574,0,12,74,0,0,86,40.971382,-73.713355,10528
327106,0,0,0,301,0,301,40.695491,-73.915173,11221
351057,16,24,90,16,0,146,41.213844,-73.986108,10993
755001,0,0,0,2,6,8,40.860936,-73.928719,10040
800842,0,0,0,2,12,14,40.893759,-73.857858,10466
381167,16,36,60,42,0,154,40.906376,-73.315636,11768
655318,0,0,0,2,12,14,40.677259,-73.791184,11434
808450,0,0,0,16,0,16,40.817751,-73.895847,10459
651234,0,0,0,4,12,16,40.812101,-73.901705,10455
698309,0,0,0,4,12,16,40.863536,-73.90691,10468
806802,0,0,0,4,12,16,40.683177,-73.823512,11419
682476,0,0,0,217,0,217,40.814956,-73.91229,10455
101277,8,12,55,0,0,75,41.599193,-74.000086,12542
39768,0,0,0,74,0,74,43.20563,-77.566482,14622
732945,0,0,0,4,12,16,40.669088,-73.709843,11580
836874,0,0,0,4,12,16,41.069897,-73.784933,10595
44005,16,21,39,0,0,76,40.714386,-73.482605,11758
489030,0,0,0,4,12,16,40.644245,-73.935011,11203
41729,0,0,18,0,0,18,41.342205,-74.162708,10950
606700,0,0,0,2,12,14,40.680464,-73.781407,11434
837622,0,0,0,4,12,16,41.654112,-73.840469,12603
121475,0,0,0,720,0,720,40.746048,-73.879795,11373
741074,0,0,24,20,0,44,43.077095,-78.864368,14120
759470,0,0,0,4,12,16,40.587263,-73.935382,11235
593221,0,0,0,4,12,16,41.440613,-74.433518,10940
632874,0,0,0,160,0,160,40.879094,-73.911022,10463
321229,0,0,0,2,6,8,40.805789,-73.95688,10026
654788,0,0,0,2,6,8,42.574391,-76.591449,14882
664049,0,0,0,4,12,16,41.152879,-73.997442,10956
879191,0,0,0,236,0,236,40.769788,-73.831751,11354
400311,0,0,0,2,12,14,40.821932,-73.915647,10451
333329,0,0,0,4,12,16,40.603119,-73.945127,11229
122355,0,0,0,269,0,269,40.716998,-74.01405,10282
762827,0,0,0,4,12,16,40.7535,-73.592699,11590
389368,0,0,0,4,12,16,40.766297,-73.569896,11590
159211,0,0,0,0,8,8,40.714266,-73.295315,11795
15688,0,0,0,2,6,8,43.113197,-75.563752,13478
781971,0,0,0,4,12,16,40.822807,-73.92437,10451
873556,0,0,0,4,12,16,40.843456,-73.847819,10461
654099,0,0,0,60,0,60,40.918286,-73.829487,10552
838021,0,0,0,2,12,14,40.849118,-73.886323,10457
864059,0,0,0,120,0,120,40.736166,-73.75333,11364
875821,0,0,0,2,6,8,43.180991,-77.757629,14559
844172,0,0,0,4,12,16,40.907001,-73.016309,11776
769289,0,0,0,40,0,40,42.100865,-79.240774,14701
28384,0,0,0,2,6,8,40.908486,-73.539303,11709
469643,0,0,0,4,12,16,43.173307,-73.696652,12831
117015,0,0,0,4,12,16,43.294649,-73.583755,12839
344398,0,0,0,4,12,16,40.860386,-73.926937,10040
709743,0,0,0,266,0,266,40.838333,-73.928126,10452
260411,0,0,0,4,12,16,40.706844,-73.732252,11429
379573,0,0,0,2,6,8,42.111696,-76.807743,14901
879351,0,0,0,4,12,16,40.863827,-73.868544,10467
796165,8,9,14,10,0,41,43.165889,-77.689086,14606
617913,0,0,0,4,12,16,40.663681,-73.58106,11520
138925,0,0,0,4,12,16,40.683463,-73.851585,11416
881479,0,0,0,340,0,340,40.842601,-73.916238,10452
866034,0,10,20,11,0,41,43.722843,-74.930977,13420
855186,0,0,0,240,0,240,40.811012,-73.956823,10027
748552,0,0,0,290,0,290,40.789687,-73.944647,10029
880282,0,0,0,4,12,16,40.873682,-72.970793,11953
629021,0,0,0,0,8,8,40.816651,-73.904432,10455
520779,0,0,0,2,12,14,40.695723,-73.973911,11205
740727,0,0,0,4,12,16,40.901499,-73.899553,10471
17276,0,0,0,4,12,16,41.506301,-73.978363,12508
39861,28,72,285,75,0,460,40.760536,-73.660562,11040
537140,0,0,0,4,12,16,40.808621,-73.910362,10454
824899,0,0,0,0,9,9,40.697019,-73.501407,11793
870999,15,12,0,0,0,27,40.592535,-73.669563,11561
645334,0,0,0,4,12,16,40.640353,-73.967865,11218
44102,24,30,46,65,0,165,43.184546,-77.688138,14606
791620,16,48,42,21,0,127,40.823501,-73.185998,11788
42532,0,0,0,50,0,50,40.85334,-73.193027,11787
188772,0,0,0,2,10,12,42.923793,-78.798508,14215
64373,0,0,0,0,6,6,40.764859,-73.993758,10019
399447,0,0,0,4,12,16,40.860984,-73.907984,10468
879624,0,0,0,0,12,12,40.805916,-73.927028,10454
865316,0,0,0,4,12,16,44.277983,-73.564407,12950
752820,0,0,0,4,12,16,40.814409,-73.909533,10455
868581,0,15,20,10,0,45,40.667227,-73.573738,11520
875947,0,0,0,2,6,8,40.716345,-73.611495,11550
704107,0,0,0,4,12,16,42.539267,-79.168849,14136
709862,0,0,0,131,0,131,40.622902,-73.978874,11204
603394,0,0,0,4,12,16,40.94797,-73.86618,10701
43121,0,0,0,104,0,104,42.425626,-73.687127,12184
729698,0,0,0,2,6,8,41.296908,-73.791659,10598
310300,0,0,0,4,12,16,40.802855,-73.268121,11717
40238,16,10,17,0,0,43,42.778592,-73.893224,12304
181311,0,0,0,8,0,8,40.577055,-73.961515,11235
795797,0,0,0,4,12,16,40.979648,-73.676927,10580
339148,0,0,0,172,0,172,40.61591,-73.912726,11234
100934,8,20,157,17,0,202,43.091888,-78.907078,14304
227305,0,0,0,139,0,139,40.712764,-73.780172,11423
823469,0,0,23,14,0,37,41.266165,-74.34505,10990
767094,0,0,0,260,0,260,41.121651,-73.983182,10994
618040,0,0,0,4,12,16,40.645096,-74.019079,11220
557077,0,0,0,4,12,16,40.85948,-73.904241,10468
145480,0,0,0,4,12,16,40.61923,-73.919476,11234
684677,0,0,0,168,0,168,40.680813,-73.944253,11216
832358,0,0,0,4,12,16,40.824078,-73.937617,10039
637571,0,0,0,297,0,297,40.82989,-73.944573,10031
493475,0,0,0,4,12,16,40.889913,-73.860335,10466
373861,0,0,0,4,12,16,40.750775,-73.530552,11801
136541,0,0,0,2,6,8,41.455884,-73.66979,10512
228604,0,0,0,2,6,8,40.675941,-73.721973,11580
301020,0,0,0,4,12,16,40.688956,-73.799791,11435
880812,0,0,0,4,12,16,40.995451,-73.741309,10605
778026,0,0,0,4,12,16,40.631901,-73.92071,11234
41511,0,0,34,0,0,34,42.146758,-74.617892,12406
12159,0,0,0,2,6,8,41.018948,-73.770671,10606
791099,0,0,0,2,6,8,43.101705,-76.131233,13211
533166,0,0,0,2,6,8,40.827796,-73.881145,10472
876518,0,0,0,4,12,16,40.662679,-73.993817,11232
302211,0,0,0,2,12,14,40.813127,-73.907287,10455
742640,0,0,0,2,6,8,42.111507,-76.954071,14830
703009,0,0,0,0,12,12,40.878872,-73.845522,10469
879623,0,0,0,4,12,16,40.757728,-73.873134,11369
274273,0,0,0,105,0,105,43.044871,-76.073166,13214
396969,0,0,0,4,12,16,40.67724,-73.945322,11216
851965,0,0,0,4,12,16,40.601083,-73.750884,11691
822812,0,0,0,4,12,16,40.656511,-74.003822,11232
614093,0,0,0,4,12,16,40.818219,-73.8998,10459
73420,0,0,0,114,0,114,40.718631,-73.993771,10002
37056,0,0,0,2,6,8,43.109295,-77.489984,14445
799642,0,0,0,4,12,16,40.681191,-73.866035,11208
652483,0,0,0,4,12,16,40.838538,-73.866675,10460
464147,0,0,0,4,12,16,40.857424,-73.899559,10458
199918,0,0,0,4,12,16,40.733081,-73.240709,11706
42791,0,0,0,45,0,45,40.848808,-73.433572,11743
882519,0,0,0,4,12,16,40.67646,-73.764039,11434
715764,0,0,0,0,12,12,40.862761,-73.891014,10458
674352,0,0,0,20,0,20,40.874886,-73.892828,10468
579947,7,12,10,0,0,29,42.195113,-74.135319,12485
789788,0,0,0,120,0,120,42.867808,-78.851175,14210
881986,0,0,0,4,12,16,42.801449,-73.94699,12303
247438,24,30,66,60,0,180,42.688691,-74.962076,13326
564709,0,0,0,4,12,16,40.84363,-73.905323,10457
278060,0,0,0,4,12,16,40.871763,-73.898976,10468
835935,16,12,45,13,0,86,41.2152,-73.5177,10590
847272,0,0,58,0,0,58,40.634183,-73.654882,11572
447996,0,0,0,4,12,16,43.103579,-75.249073,13502
821149,0,0,0,0,12,12,40.86124,-73.90889,10468
44297,16,22,30,23,0,91,42.651954,-78.891018,14057
696397,0,0,0,2,6,8,40.884591,-72.532328,11946
863222,16,24,76,50,0,166,41.443771,-74.02271,12520
842213,4,12,29,0,0,45,40.656392,-73.700775,11581
549217,0,0,0,4,12,16,40.680074,-73.931138,11233
775367,0,0,75,0,0,75,41.461861,-74.021312,12553
45075,16,30,72,52,0,170,40.768238,-72.990615,11772
150726,0,0,0,4,12,16,40.697914,-73.913492,11237
796352,0,0,0,4,12,16,42.640174,-73.782459,12209
43385,0,36,74,0,0,110,40.873214,-73.410532,11743
835906,0,0,0,2,6,8,43.159694,-77.573668,14609
356808,0,0,0,2,6,8,40.750136,-73.308502,11729
41595,8,32,34,0,0,74,42.130161,-77.959277,14895
483253,0,0,0,4,12,16,40.882487,-73.847638,10466
858476,0,0,0,2,6,8,43.176696,-77.572054,14609
401095,0,0,0,47,0,47,40.683922,-73.954182,11216
761617,0,15,65,16,0,96,43.137192,-75.26396,13403
684753,0,0,0,260,0,260,40.693579,-73.844466,11418
791756,0,0,0,4,12,16,42.918663,-78.848596,14208
656349,0,0,0,2,12,14,40.849614,-73.905327,10457
364887,0,0,0,2,6,8,43.051073,-76.177268,13204
869891,0,0,0,4,12,16,40.818353,-73.900026,10459
142950,0,0,0,164,0,164,42.736167,-73.709971,12189
42361,0,0,17,0,0,17,44.630793,-74.812103,13672
786807,0,0,0,4,12,16,40.827661,-73.896007,10459
39760,0,0,0,240,0,240,43.102194,-77.408299,14450
820845,0,0,0,4,12,16,40.57955,-73.954201,11235
621227,0,0,0,4,12,16,41.084433,-73.864168,10591
877454,0,0,0,2,6,8,44.697566,-73.552942,12962
878536,0,0,0,200,0,200,40.68129,-73.884184,11208
872655,0,0,24,38,0,62,42.741147,-78.848663,14075
522223,0,0,0,100,0,100,40.623481,-74.081681,10304
314540,0,0,0,0,8,8,40.648672,-73.96176,11226
734633,0,0,0,2,6,8,40.807297,-73.93609,10035
40384,0,0,301,0,0,301,40.866401,-72.929574,11953
595385,0,0,0,4,12,16,40.702649,-73.632741,11550
838542,0,0,0,0,5,5,43.039876,-76.161081,13204
42854,0,0,0,45,0,45,41.535962,-73.90043,12524
41128,0,0,0,44,0,44,42.72107,-73.775806,12211
768575,0,0,0,4,12,16,43.103157,-75.263507,13502
263139,0,0,0,2,5,7,40.823543,-73.937998,10039
523798,0,0,0,100,0,100,42.984371,-78.716161,14221
750919,0,0,0,4,12,16,40.770636,-73.911191,11105
869168,0,0,0,4,12,16,40.865971,-73.904187,10468
20132,0,0,0,2,6,8,42.78349,-74.008678,12306
119146,0,0,0,4,12,16,40.694843,-73.924736,11221
737278,0,0,0,4,12,16,40.84546,-73.889211,10457
882937,0,0,0,4,12,16,40.820459,-73.821034,10465
687033,0,0,0,4,12,16,40.609105,-73.986641,11204
381946,0,0,0,4,12,16,40.643729,-73.908887,11236
630614,0,19,144,0,0,163,41.01984,-73.870383,10522
852767,0,0,0,4,12,16,40.829286,-73.822194,10465
843653,0,0,0,2,6,8,42.604171,-76.181578,13045
149672,0,0,0,2,6,8,40.796276,-73.961533,10025
468356,0,0,0,60,0,60,42.871389,-73.819972,12065
787855,0,0,0,4,12,16,40.96836,-73.833949,10710
474696,0,0,0,4,12,16,40.963775,-73.869449,10710
44216,0,0,18,0,0,18,42.796049,-78.823744,14219
873974,0,0,0,2,6,8,40.870738,-73.865357,10467
612449,0,0,0,190,0,190,40.875125,-73.833338,10475
779237,0,0,0,2,12,14,40.852962,-73.902755,10457
865663,0,0,0,110,0,110,42.867721,-73.802283,12065
876927,0,0,0,2,6,8,40.849991,-73.91759,10453
39187,24,18,40,0,0,82,42.655166,-73.765368,12210
40747,0,0,0,80,0,80,42.196148,-75.852816,13901
460961,0,0,0,2,12,14,40.648152,-73.962059,11226
204483,0,0,0,70,0,70,40.744828,-73.64772,11501
873580,0,12,18,0,0,30,41.943155,-74.020303,12401
876879,0,0,0,4,12,16,40.83413,-73.929961,10452
874764,0,0,0,4,12,16,40.846527,-73.861587,10462
214643,0,0,167,21,0,188,40.965106,-73.71418,10528
709924,0,0,0,298,0,298,40.765161,-73.789884,11358
336037,0,0,0,4,12,16,40.695255,-73.766867,11412
132229,0,24,58,0,0,82,42.09722,-76.806165,14901
861047,0,0,0,4,12,16,40.879577,-73.867577,10467
690389,0,0,0,2,12,14,40.748212,-73.858933,11368
615240,0,0,0,4,12,16,41.660316,-74.006367,12547
834621,8,24,15,19,0,66,42.950043,-78.869216,14216
675329,0,0,0,2,12,14,40.866701,-73.917976,10034
689605,0,0,0,126,0,126,40.87156,-73.911522,10034
870069,0,0,0,2,6,8,40.663776,-73.903539,11212
874949,0,0,0,39,0,39,40.740807,-73.901337,11377
766079,0,0,0,4,12,16,40.683642,-73.581886,11575
390125,0,0,0,0,12,12,40.777687,-73.265629,11717
271341,0,0,0,60,0,60,43.12345,-77.829976,14428
794134,0,0,0,94,0,94,40.831777,-73.935471,10039
853898,0,0,0,4,12,16,40.933473,-73.884269,10701
408914,0,0,0,2,6,8,40.706672,-73.343952,11704
64035,0,0,0,2,6,8,40.717675,-73.982399,10002
578420,0,0,0,4,12,16,40.86739,-73.892954,10458
563785,16,24,39,39,0,118,42.99299,-77.439945,14564
877870,0,0,0,2,6,8,42.147076,-76.942468,14814
31233,0,0,0,4,12,16,41.77008,-73.909364,12538
845769,0,12,21,21,0,54,40.673195,-73.709058,11580
798853,0,0,0,4,12,16,40.693873,-73.842982,11418
830328,0,0,0,18,0,18,40.760761,-73.76704,11361
502211,12,12,72,82,0,178,43.10731,-77.564395,14618
387418,0,0,0,4,12,16,40.665437,-73.894435,11207
232906,0,0,18,177,0,195,40.80223,-73.947704,10026
763069,0,0,0,4,12,16,40.596251,-73.799837,11692
252256,16,24,34,16,0,90,42.1201,-76.019289,13760
744464,0,0,0,4,12,16,40.666618,-73.993551,11215
571543,0,0,0,4,12,16,40.821112,-73.906892,10456
283483,19,30,46,0,0,95,41.273086,-74.329468,10990
567308,0,0,0,4,12,16,40.673975,-73.751759,11413
793957,0,0,0,4,12,16,40.692345,-73.921499,11221
836513,0,0,48,60,0,108,40.852801,-73.322669,11731
354880,0,0,0,44,0,44,40.7247,-73.685134,11530
186750,0,0,0,4,12,16,40.837292,-73.941262,10032
849238,0,0,0,4,12,16,40.719568,-73.513567,11756
874255,0,36,39,0,0,75,40.69862,-73.652265,11552
487579,0,0,0,4,12,16,40.747054,-73.858,11368
254509,0,0,0,36,0,36,40.581819,-74.098951,10306
778671,0,22,68,0,0,90,40.712782,-73.558217,11554
545560,0,24,191,0,0,215,42.743122,-73.701532,12189
800214,3,17,50,0,0,70,42.825781,-73.908624,12308
543868,0,0,0,4,12,16,40.771374,-73.22175,11717
788611,0,0,0,4,12,16,41.264172,-74.287645,10990
841391,0,0,0,0,12,12,40.676433,-73.984019,11215
44567,0,0,0,80,0,80,40.966115,-73.700488,10580
40541,8,36,60,19,0,123,40.907786,-73.833385,10550
822384,0,0,0,66,0,66,40.780585,-73.976682,10024
128047,0,0,0,20,0,20,43.0917,-75.3022,13417
603017,0,0,0,4,12,16,40.602062,-74.002989,11214
808586,0,0,0,140,0,140,40.864187,-73.836302,10469
42195,16,42,34,0,0,92,42.448497,-76.504251,14850
40757,0,0,0,81,0,81,42.133864,-77.04106,14830
700270,0,0,0,20,0,20,40.631592,-74.148481,10303
528760,0,0,0,4,12,16,40.692322,-73.960361,11205
871846,8,9,7,10,0,34,42.908314,-78.898505,14213
170822,14,19,57,0,0,90,41.354248,-74.280158,10918
733178,0,0,0,2,6,8,40.634096,-73.610662,11510
318574,0,0,0,4,12,16,40.682002,-73.578667,11575
697928,0,0,0,2,6,8,40.835769,-73.916038,10456
819186,0,0,0,4,12,16,42.755375,-73.678883,12180
757290,0,0,0,4,12,16,44.782239,-75.351665,13658
41021,0,0,0,60,0,60,42.626017,-73.860535,12054
649358,0,0,0,138,0,138,41.088536,-74.011511,10954
857054,0,0,0,160,0,160,40.697839,-73.943652,11206
27111,0,0,0,2,6,8,43.034572,-75.274182,13319
566839,0,0,0,4,12,16,40.822807,-73.92437,10451
840218,0,0,0,2,6,8,40.710808,-73.994435,10002
866389,0,0,0,44,0,44,42.693325,-73.66083,12180
568367,0,9,56,10,0,75,41.450911,-74.420832,10940
352072,0,0,0,2,6,8,44.229918,-73.458346,12993
816291,0,0,0,143,0,143,40.603999,-73.749412,11691
71817,0,0,0,4,12,16,40.864146,-73.927296,10040
566088,0,0,0,4,12,16,40.680354,-73.888713,11207
847970,0,0,0,4,12,16,40.911128,-73.893552,10705
875203,0,0,0,64,0,64,41.165703,-73.858206,10562
220268,0,0,0,4,12,16,40.867138,-73.888294,10458
709688,0,0,0,220,0,220,40.845664,-73.829742,10461
856619,0,0,0,4,12,16,40.683669,-73.589475,11575
529581,0,34,82,0,0,116,41.153579,-73.769085,10514
882058,0,0,0,4,12,16,40.661805,-73.885668,11207
679107,0,0,0,2,6,8,40.773425,-73.985796,10023
42693,0,0,0,30,0,30,43.161842,-75.341101,13424
801856,0,0,0,4,12,16,40.842418,-73.920497,10452
709843,0,0,0,320,0,320,40.623745,-73.946486,11210
349961,0,0,0,4,12,16,40.695471,-73.891343,11385
781273,0,0,0,4,12,16,40.70722,-73.607769,11550
824741,0,0,0,70,0,70,40.730738,-73.852885,11374
838037,0,0,0,44,0,44,40.812484,-73.95342,10027
42082,0,0,52,0,0,52,43.462495,-76.506579,13126
801933,0,0,0,2,6,8,40.870831,-73.879975,10467
834480,0,0,0,4,12,16,42.989151,-76.109234,13078
603277,0,0,0,198,0,198,40.727355,-73.332066,11703
126327,24,72,73,49,0,218,41.175394,-73.868007,10562
786482,0,0,0,2,6,8,43.156688,-76.139718,13041
772990,0,0,0,4,12,16,40.674816,-73.749226,11413
871526,0,0,0,4,12,16,40.686806,-73.875203,11208
730596,0,0,0,4,12,16,40.691664,-73.79046,11433
441483,0,0,0,2,6,8,41.151864,-73.979826,10956
763538,0,0,0,40,0,40,40.858134,-73.863865,10467
872117,0,0,0,4,12,16,40.60743,-73.993465,11214
615234,0,0,0,4,12,16,41.1908,-73.658,10506
360095,0,0,0,2,6,8,44.182588,-75.353021,13648
880961,0,0,0,4,12,16,40.598723,-73.759825,11691
815681,0,0,0,4,12,16,40.705586,-73.770676,11412
224595,0,0,0,116,0,116,40.656121,-73.954113,11226
112327,0,0,0,4,12,16,40.782371,-73.653229,11577
43546,16,36,134,0,0,186,40.69893,-73.409172,11701
268858,0,0,0,17,0,17,40.703648,-73.740213,11429
225659,0,0,0,2,12,14,40.865764,-73.920845,10034
39578,6,12,18,21,0,57,42.411637,-74.067634,12083
426309,0,0,0,4,12,16,40.666443,-73.961411,11225
43924,0,0,0,111,0,111,41.020347,-73.774347,10606
18661,0,0,0,4,12,16,40.830946,-73.637533,11545
875731,0,0,0,4,12,16,40.759,-73.88333,11370
762085,0,0,52,0,0,52,40.984354,-73.87967,10706
657810,0,0,0,4,12,16,40.854972,-73.912799,10453
73867,0,0,0,40,0,40,40.790127,-73.811672,11357
876093,0,0,0,4,12,16,40.672366,-73.884612,11207
394671,0,0,46,0,0,46,44.749899,-74.99348,13668
212096,0,0,0,4,12,16,40.676357,-73.650932,11552
667859,0,0,0,4,12,16,40.67271,-73.718168,11580
879909,0,0,120,0,0,120,43.18013,-78.685329,14094
204975,0,0,0,2,6,8,42.661192,-78.554935,14080
264261,0,0,0,4,12,16,40.660014,-73.898775,11207
66000,0,0,0,0,6,6,40.806552,-73.938958,10035
513498,0,0,0,0,6,6,40.820653,-73.943313,10030
852865,0,0,0,4,12,16,40.60811,-73.742956,11559
555435,0,0,0,4,12,16,40.933681,-73.882694,10701
709666,0,0,0,78,0,78,40.718605,-73.806127,11432
247054,0,0,0,135,0,135,42.99225,-77.418889,14564
679512,0,0,0,4,12,16,41.461008,-73.663006,10512
746460,0,0,0,2,6,8,40.800299,-73.943874,10035
39186,24,66,132,72,0,294,42.649069,-73.806294,12208
562485,0,0,0,2,6,8,40.852359,-73.913787,10453
547927,0,0,0,4,12,16,40.804069,-72.789691,11934
72718,0,0,0,4,12,16,40.665008,-73.91958,11212
558715,0,0,0,4,12,16,40.870567,-73.891975,10468
416848,0,0,0,4,12,16,40.739304,-73.867141,11373
783433,0,0,0,4,12,16,40.708019,-73.60422,11550
848698,0,0,0,72,0,72,40.797481,-73.941356,10029
349542,15,28,58,27,0,128,42.718102,-78.829095,14075
764462,0,0,0,4,12,16,40.765607,-73.208672,11722
622296,0,0,0,2,6,8,43.963566,-75.925174,13601
865077,0,0,0,4,12,16,40.710452,-73.703487,11003
161161,0,0,0,2,6,8,43.159328,-75.766331,13032
797254,0,0,0,40,0,40,40.61128,-73.913256,11234
719626,0,0,0,25,0,25,41.484559,-74.107865,12557
13236,0,0,0,2,6,8,41.529259,-74.899803,12732
55152,0,0,0,0,6,6,40.831343,-73.918478,10456
500459,0,0,0,4,12,16,40.62939,-74.14398,10302
18688,0,0,0,2,6,8,43.058096,-76.239471,13209
538630,0,0,0,2,6,8,40.832583,-73.942932,10032
810984,0,0,0,4,12,16,40.673142,-73.862104,11208
868435,0,0,0,4,12,16,42.539825,-73.804498,12158
843287,0,0,0,4,12,16,43.00765,-75.044408,13357
832979,0,0,0,4,12,16,40.847037,-73.938449,10033
40612,16,12,78,0,0,106,42.662267,-77.058997,14527
839877,0,0,0,4,12,16,40.871937,-73.888552,10468
627605,0,0,0,4,12,16,42.924113,-78.893706,14213
882278,0,0,0,83,0,83,40.697101,-73.847813,11418
700022,8,36,218,18,0,280,41.659166,-73.925269,12603
695409,0,0,0,4,12,16,40.655928,-73.733559,11422
851059,5,7,16,8,0,36,40.756851,-73.376064,11798
705921,0,0,0,2,6,8,40.853336,-73.916201,10453
821715,8,36,39,20,0,103,44.66323,-74.966649,13676
797481,0,0,0,125,0,125,43.892497,-75.677776,13626
852313,0,0,0,4,12,16,40.982347,-73.836722,10710
877063,0,0,0,2,6,8,42.820449,-73.92599,12308
388170,0,0,0,139,0,139,40.791538,-73.970764,10025
816790,0,0,0,4,12,16,40.88011,-73.876115,10467
311025,11,24,36,11,0,82,40.809693,-73.023326,11742
141308,8,24,18,0,0,50,40.764111,-73.015016,11772
867154,16,46,82,12,0,156,43.034623,-78.975813,14072
695146,0,0,0,4,12,16,40.685129,-73.592507,11575
42980,0,34,84,0,0,118,40.779485,-73.638495,11577
355691,0,0,0,2,10,12,43.139551,-77.639607,14619
788766,0,0,0,4,12,16,40.631961,-73.976358,11218
852384,0,0,0,70,0,70,40.760992,-73.012223,11772
445486,0,0,0,4,12,16,40.83298,-73.880027,10472
377170,39,58,120,32,0,249,41.449356,-74.348016,10941
294474,0,0,0,4,12,16,43.078436,-76.789933,13146
642427,0,0,0,2,6,8,40.624559,-74.077364,10304
876054,0,0,0,4,12,16,40.616909,-73.981602,11204
250065,0,0,0,4,12,16,40.768482,-73.231308,11717
179188,0,0,0,2,6,8,43.20405,-77.620598,14617
39263,8,12,53,0,0,73,42.097323,-79.241767,14701
54290,0,0,0,2,6,8,40.851758,-73.908156,10453
720886,0,0,0,4,12,16,40.70582,-73.941041,11206
774301,0,0,0,0,12,12,40.88408,-73.89835,10463
42931,12,20,32,20,0,84,42.867808,-78.851175,14210
844584,0,0,0,44,0,44,43.000785,-73.867623,12020
249431,0,0,0,4,12,16,40.618522,-73.992438,11204
865672,0,0,0,2,6,8,43.121601,-75.670492,13054
388093,0,0,0,4,12,16,40.686348,-73.994556,11201
234295,0,0,0,39,0,39,40.710335,-73.996702,10038
868660,0,0,0,4,12,16,43.2345,-73.4585,12809
822374,0,0,0,4,12,16,40.857244,-73.905887,10453
827406,0,0,0,4,12,16,41.704145,-74.141232,12561
818450,0,0,0,2,12,14,40.826504,-73.888043,10459
306284,0,0,0,4,12,16,40.682847,-73.783489,11434
821864,0,0,0,4,12,16,40.927381,-73.898661,10701
71614,0,0,0,4,12,16,40.600567,-73.758205,11691
880006,0,0,0,4,12,16,43.155421,-77.697166,14624
866544,0,0,0,4,12,16,40.697535,-73.408735,11701
466520,0,0,37,0,0,37,41.925109,-73.986812,12401
880667,0,0,0,4,12,16,40.617436,-73.978374,11204
874313,0,0,0,4,12,16,43.225793,-75.446086,13440
583704,0,0,0,4,12,16,40.638581,-73.916343,11236
814150,0,0,0,4,12,16,40.656635,-73.910524,11212
16757,0,0,0,2,6,8,43.046501,-74.848946,13365
156143,0,0,0,0,12,12,40.829266,-73.92308,10452
245338,0,0,0,4,12,16,43.236916,-76.138134,13029
28929,0,0,0,4,12,16,40.701506,-73.410658,11701
847817,0,0,0,4,12,16,43.026077,-76.150269,13205
853300,0,0,0,2,6,8,40.823739,-73.90379,10456
70573,0,0,0,2,5,7,40.836089,-73.926146,10452
867850,16,27,84,0,0,127,41.455774,-74.383287,10940
730605,16,48,48,38,0,150,40.871562,-73.62605,11542
857635,8,34,27,0,0,69,41.642384,-73.563391,12594
291181,0,0,0,4,12,16,40.673373,-73.862068,11208
459462,0,0,0,2,6,8,41.713312,-73.929445,12601
134193,0,0,0,4,12,16,42.911579,-78.891303,14213
39395,20,37,52,20,0,129,42.962597,-78.869306,14217
44477,0,0,0,102,0,102,42.046085,-73.948463,12432
877233,0,0,0,0,10,10,40.879082,-73.873276,10467
666306,0,0,0,4,12,16,40.761033,-73.892771,11370
249795,0,0,0,2,6,8,40.712201,-73.983522,10002
263166,0,0,0,2,6,8,43.968264,-75.897353,13601
878191,0,0,0,71,0,71,40.589589,-73.805555,11693
604766,0,0,0,2,12,14,40.839542,-73.889417,10460
788063,0,0,0,4,12,16,40.577085,-74.106423,10306
601431,0,0,0,4,12,16,40.640363,-73.962086,11226
444341,0,0,0,2,6,8,40.853511,-73.91262,10453
872222,0,0,0,4,12,16,40.6796,-73.781703,11434
73581,0,0,0,161,0,161,40.71873,-73.998443,10013
533473,0,0,0,4,12,16,40.809046,-73.918097,10454
688997,48,0,178,0,0,226,42.10947,-79.241363,14701
652466,0,0,0,4,12,16,41.379117,-74.685047,12771
467260,0,0,0,80,0,80,43.057912,-76.207786,13209
875460,0,0,0,2,6,8,42.699348,-74.563565,12043
854348,0,0,0,160,0,160,40.82941,-73.850256,10472
366912,0,0,0,4,12,16,40.75933,-73.886727,11370
835311,0,0,0,4,12,16,40.813104,-73.93716,10037
792888,0,0,0,0,12,12,43.194887,-77.626982,14615
340509,0,0,0,4,12,16,40.687699,-73.997842,11201
43800,16,20,60,0,0,96,44.671056,-73.455715,12903
427399,0,0,0,4,12,16,40.734897,-73.895804,11377
809965,0,0,0,120,0,120,40.822076,-73.907219,10456
495625,0,0,0,4,12,16,40.835419,-73.916313,10456
102485,0,0,0,4,12,16,43.242641,-73.82532,12822
710423,0,0,0,4,12,16,40.803397,-73.956625,10026
738903,0,32,80,0,0,112,40.81473,-73.324119,11746
44781,0,0,0,60,0,60,40.91843,-73.797742,10801
30235,0,0,0,2,6,8,43.975603,-75.890633,13601
339130,0,0,0,155,0,155,40.602282,-73.970083,11223
41864,16,15,14,0,0,45,43.016889,-78.13817,14020
619985,0,0,0,4,12,16,40.81646,-73.897225,10455
414378,0,0,0,2,6,8,42.959568,-77.06512,14532
881683,0,0,0,80,0,80,43.224819,-74.175627,12134
840066,0,0,0,4,12,16,42.887165,-78.849051,14206
342797,0,0,0,4,12,16,40.842663,-73.911757,10457
749170,0,0,0,88,0,88,41.535529,-73.893753,12524
287464,0,0,0,4,12,16,43.049606,-73.835626,12866
770499,0,0,0,4,12,16,42.932703,-78.837595,14214
207542,0,0,0,4,12,16,40.782199,-73.221034,11717
163763,0,0,0,159,0,159,40.697083,-73.78693,11433
867857,0,0,39,0,0,39,41.256093,-74.386274,10990
620190,0,0,0,4,12,16,40.62973,-74.008153,11219
649005,0,0,0,2,6,8,41.221201,-74.299028,10925
371407,16,19,33,24,0,92,42.98828,-78.88358,14217
72627,0,0,0,2,12,14,40.704675,-73.739212,11429
451719,0,0,0,4,12,16,40.822891,-73.950628,10031
819525,0,0,0,4,12,16,40.86892,-73.865417,10467
736585,0,0,0,4,12,16,40.709556,-73.782228,11432
754086,0,0,0,4,12,16,40.851428,-73.905589,10453
559725,0,0,0,2,6,8,40.830295,-73.918364,10456
753989,0,0,0,2,6,8,40.912537,-73.828497,10550
700664,0,0,0,4,12,16,40.919703,-73.871902,10704
784199,0,0,0,166,0,166,40.73601,-73.486851,11714
457284,0,0,0,4,12,16,40.847565,-73.904926,10457
39838,0,0,53,0,0,53,40.659345,-73.584624,11520
406595,0,0,0,2,6,8,41.953894,-74.029424,12401
731350,0,0,0,4,12,16,40.854044,-73.927961,10040
829327,0,0,0,4,12,16,40.790133,-72.839584,11950
848409,0,0,0,2,6,8,42.332099,-77.654576,14843
810638,0,0,0,4,12,16,40.868487,-73.900706,10468
873249,0,0,0,4,12,16,43.012364,-78.873918,14150
751825,0,0,0,4,12,16,40.695689,-73.611269,11550
39953,16,30,66,10,0,122,43.097175,-75.220718,13501
33470,0,0,0,4,12,16,41.01739,-73.768573,10606
809279,0,0,0,4,12,16,41.04784,-73.79491,10603
767831,0,0,198,0,0,198,40.981138,-73.816705,10583
10820,0,0,0,2,6,8,44.237827,-74.489702,12986
329711,0,0,0,4,12,16,40.691627,-73.699897,11003
243830,0,0,0,2,6,8,40.868319,-73.895456,10468
316926,0,0,0,4,12,16,40.686595,-73.989888,11201
636349,24,36,60,20,0,140,41.277701,-73.788814,10598
173576,0,0,0,4,12,16,40.883127,-73.864842,10467
656720,0,0,0,120,0,120,40.604257,-73.955303,11229
102429,16,36,60,24,0,136,40.8232,-73.500912,11791
283041,0,0,0,102,0,102,40.691137,-73.763727,11412
826306,0,0,0,60,0,60,43.115663,-79.039751,14305
844824,0,0,0,4,12,16,42.569423,-76.477429,13073
25778,0,0,0,2,6,8,43.05902,-73.84127,12866
705760,4,5,25,15,0,49,43.200722,-77.562472,14622
437632,0,0,0,4,12,16,40.915622,-73.897585,10705
230286,0,0,0,4,12,16,40.686595,-73.989888,11201
264581,0,0,0,4,12,16,41.32647,-74.197612,10950
257002,0,0,0,4,12,16,43.014235,-77.093807,14513
717958,0,0,0,4,12,16,40.854784,-73.884248,10458
138478,0,0,0,2,6,8,42.609498,-74.691171,12197
394110,0,0,0,0,12,12,40.878532,-73.857583,10469
839196,0,0,0,200,0,200,40.880758,-73.907119,10463
761106,8,12,33,10,0,63,40.810916,-73.09117,11741
438602,0,0,0,50,0,50,40.68466,-73.663187,11552
828993,0,0,0,0,12,12,40.844298,-73.911186,10457
842621,0,0,0,4,12,16,41.115964,-74.048861,10977
856125,0,0,0,4,12,16,43.073373,-76.137431,13208
780304,0,0,0,4,12,16,40.826821,-73.945754,10031
728705,0,0,0,2,6,8,43.033024,-76.173851,13204
722551,0,0,0,254,0,254,40.906881,-73.862266,10704
331165,0,0,0,170,0,170,40.577011,-74.100576,10306
607940,0,0,0,4,12,16,40.86739,-73.892954,10458
73215,0,0,0,281,0,281,40.632637,-73.891053,11236
834284,0,0,0,4,12,16,40.793283,-73.200186,11722
799212,0,0,0,97,0,97,40.870672,-73.897589,10468
806718,0,0,0,2,6,8,40.855647,-73.931012,10040
734454,0,0,0,4,12,16,40.747758,-73.243869,11706
676650,0,0,0,2,6,8,42.64694,-75.330477,13411
861592,16,24,57,21,0,118,40.751257,-73.194932,11752
246248,0,0,0,2,6,8,43.07886,-77.948841,14416
787164,0,0,0,4,12,16,42.670056,-73.797548,12203
313300,0,0,0,4,12,16,40.693031,-73.978512,11201
837242,0,0,0,2,6,8,41.15667,-73.995469,10956
847603,0,0,0,0,12,12,40.847889,-73.934993,10033
555656,0,0,0,4,12,16,40.84903,-73.92071,10453
803801,0,0,0,4,12,16,40.880631,-73.905583,10463
810648,0,0,0,2,6,8,43.071238,-76.140459,13203
122317,0,0,0,248,0,248,40.611384,-74.083373,10304
811701,0,0,0,4,12,16,40.668626,-73.893256,11207
791525,0,0,0,4,12,16,40.857467,-73.903196,10453
772036,0,0,0,120,0,120,40.578407,-73.992382,11224
320540,0,0,0,58,0,58,40.751476,-73.609092,11514
879197,0,0,0,4,12,16,40.647867,-74.000058,11232
764367,0,0,0,2,12,14,40.825805,-73.926071,10451
663060,0,0,0,4,12,16,40.752547,-73.578219,11590
466315,0,0,0,4,12,16,43.17322,-77.572122,14609
799479,0,0,0,44,0,44,40.637535,-73.67635,11518
262522,0,0,0,2,12,14,40.831448,-73.87651,10472
864867,0,0,0,400,0,400,40.70034,-73.987477,11201
878199,0,0,0,2,6,8,42.210292,-73.878135,12414
33286,0,0,0,4,12,16,41.661839,-73.876325,12603
855220,0,0,42,0,0,42,42.667536,-73.790364,12203
748394,0,0,0,296,0,296,40.686119,-73.75724,11413
74108,0,0,0,13,0,13,40.768729,-73.96518,10065
730003,0,0,0,4,12,16,40.872651,-73.885312,10458
808558,0,0,0,4,12,16,43.220561,-75.456298,13440
833094,0,0,0,55,0,55,40.641065,-73.965579,11226
43561,0,24,126,40,0,190,40.979263,-73.761735,10583
747196,0,0,0,4,12,16,41.478229,-74.05403,12553
872504,8,12,0,0,0,20,42.669586,-73.756048,12210
73663,0,0,0,17,0,17,40.71724,-74.012179,10007
839932,0,0,0,0,10,10,40.881653,-73.87618,10467
370223,0,0,0,4,12,16,40.906257,-73.86208,10704
720012,0,0,0,4,12,16,41.09607,-73.779402,10595
260225,0,0,0,4,12,16,40.600776,-73.950437,11229
843538,0,0,0,4,12,16,41.810875,-74.743398,12754
828201,0,0,0,36,0,36,42.977114,-77.986742,14482
539709,0,0,0,4,12,16,40.841364,-73.891609,10457
878937,0,0,0,2,6,8,42.906889,-78.863613,14209
278042,0,0,0,100,0,100,43.067063,-73.800393,12866
634462,0,0,0,239,0,239,40.703701,-73.884122,11385
790908,0,0,0,4,12,16,41.061174,-73.95604,10913
142340,0,0,0,2,12,14,40.687159,-73.876631,11208
274693,0,0,0,2,6,8,40.918302,-73.840857,10550
489365,0,0,0,0,12,12,40.844503,-73.879105,10460
848101,0,0,0,4,12,16,43.215112,-77.551713,14622
877473,0,0,0,2,6,8,42.029961,-76.58457,14892
716399,5,9,18,4,0,36,43.032818,-76.012566,13066
339924,0,0,0,2,6,8,42.918181,-73.694288,12118
32092,0,0,0,2,6,8,41.326001,-73.782561,10598
705423,0,0,0,4,12,16,40.846887,-73.917983,10453
291856,26,24,90,28,0,168,42.509038,-78.676965,14141
266832,0,0,0,60,0,60,41.320891,-73.814974,10598
740771,0,0,0,4,12,16,40.613312,-73.94053,11234
44519,8,38,56,27,0,129,41.498014,-74.029116,12550
28097,0,0,0,2,6,8,43.074661,-77.689936,14586
39572,24,12,54,0,0,90,42.998678,-78.197437,14020
881677,8,19,45,0,0,72,43.091505,-74.275764,12078
871903,0,0,0,4,12,16,40.646835,-73.962972,11226
695,0,0,0,4,12,16,41.721243,-73.73386,12585
454038,0,0,0,2,12,14,40.694624,-73.835657,11418
740786,0,0,0,2,6,8,40.875775,-73.878129,10467
682181,0,0,0,193,0,193,40.680293,-73.98047,11217
774250,0,0,0,44,0,44,40.772007,-73.110025,11716
789926,0,0,0,2,6,8,40.81922,-73.93893,10030
42467,8,19,9,16,0,52,43.099935,-78.977003,14304
759561,0,0,0,4,12,16,40.843572,-73.882261,10460
862561,0,0,0,4,12,16,40.616911,-73.965473,11230
365538,0,0,18,0,0,18,44.684945,-73.460893,12901
571644,0,0,0,2,6,8,40.850939,-73.882572,10460
537164,0,0,0,2,12,14,40.716176,-73.75335,11428
867993,0,0,0,2,6,8,43.25121,-77.713197,14612
517903,8,9,14,13,0,44,43.159277,-77.63754,14611
699289,0,0,0,4,12,16,40.663039,-73.89587,11207
832411,0,0,0,4,12,16,40.901951,-73.838731,10550
809597,0,0,0,2,6,8,43.044119,-76.087087,13214
877784,0,0,0,4,12,16,40.635971,-73.720224,11598
323087,0,0,0,2,6,8,43.06842,-76.070387,13057
330747,0,0,0,2,6,8,43.450977,-76.502555,13126
405274,0,0,0,44,0,44,42.771511,-78.630587,14052
849814,0,0,0,2,6,8,40.868232,-73.892298,10458
324538,0,0,0,30,0,30,43.08787,-79.032714,14303
625561,0,0,0,4,12,16,41.613234,-73.902774,12590
16860,0,0,0,2,6,8,44.626062,-73.669594,12918
865921,0,0,0,4,12,16,43.187814,-77.563119,14609
882470,0,0,0,4,12,16,40.844643,-73.887546,10460
39850,0,20,43,20,0,83,40.662666,-73.648662,11570
684735,0,0,0,140,0,140,40.6188,-74.0163,11228
407313,0,0,0,4,12,16,40.663216,-73.758994,11413
616251,0,0,0,155,0,155,40.861666,-73.901632,10468
42567,0,0,38,95,0,133,41.198373,-73.724097,10549
39474,15,36,78,0,0,129,43.014227,-78.784751,14068
495753,0,0,0,4,12,16,40.691576,-73.404771,11726
419196,0,0,0,4,12,16,40.721336,-73.818444,11367
340884,16,24,35,85,0,160,43.018377,-74.347157,12095
259179,0,0,0,2,6,8,40.66719,-73.804214,11420
755282,0,0,0,4,12,16,40.642382,-74.000956,11220
828728,0,0,0,10,0,10,40.649846,-73.899294,11236
302254,0,0,0,4,12,16,40.660183,-73.950855,11225
858283,0,0,0,4,12,16,40.698146,-73.612884,11550
718284,0,0,0,2,6,8,40.66671,-73.92883,11213
796055,0,0,0,30,0,30,43.180871,-78.657321,14094
737105,0,9,39,7,0,55,40.721821,-73.458476,11735
302905,0,0,0,4,12,16,42.514136,-76.660713,14886
506564,0,0,0,4,12,16,41.011895,-73.665307,10573
475334,0,0,0,200,0,200,40.845664,-73.829742,10461
589014,0,0,0,0,12,12,40.843368,-73.889733,10457
775575,0,0,0,4,12,16,40.760216,-73.875013,11369
654630,0,0,0,4,12,16,40.609115,-74.008555,11214
451785,0,0,0,2,6,8,40.731537,-73.846077,11375
874091,0,0,0,0,10,10,40.810471,-73.904604,10455
795783,0,0,0,4,12,16,40.824311,-73.88082,10472
671824,0,0,0,4,12,16,40.963394,-73.87987,10703
40697,0,0,0,40,0,40,42.902673,-73.68685,12118
642236,0,0,0,4,12,16,40.840751,-73.911308,10457
429745,0,0,0,0,12,12,40.675147,-73.951803,11216
457526,0,0,0,2,12,14,40.877426,-73.909076,10463
874143,0,0,0,2,6,8,40.704669,-73.408594,11701
851453,0,0,0,2,6,8,42.680193,-76.823261,14521
218933,0,0,0,2,6,8,40.767255,-73.925549,11102
768448,0,0,0,2,6,8,40.837275,-73.939834,10032
613651,16,33,71,46,0,166,43.039087,-78.942787,14072
678097,0,0,0,2,6,8,40.823856,-73.903251,10456
875912,0,0,0,4,12,16,40.866393,-73.930146,10034
30596,0,0,0,2,12,14,42.806297,-73.944826,12307
821714,0,0,0,2,6,8,43.148168,-77.644948,14611
39973,0,10,0,20,0,30,43.03041,-76.002441,13066
339145,0,0,0,135,0,135,40.625827,-73.938709,11210
709901,0,0,0,443,0,443,40.812147,-73.947593,10027
863589,0,0,0,4,12,16,40.638846,-74.092001,10301
868198,0,0,0,4,12,16,40.865346,-73.896198,10468
101938,0,0,0,2,12,14,40.654736,-73.92278,11203
806749,0,0,0,38,0,38,40.758676,-73.824384,11355
780998,0,0,0,2,6,8,43.330245,-73.710612,12804
820786,0,0,0,4,12,16,40.713287,-73.589567,11553
733706,8,10,18,20,0,56,43.084179,-77.937402,14416
813364,0,0,0,0,8,8,40.656082,-73.869905,11239
229576,0,0,0,2,5,7,41.37383,-73.7711,10541
495159,0,0,0,4,12,16,40.841252,-73.890454,10460
71684,0,0,0,4,12,16,40.632253,-74.156639,10303
726858,0,0,0,4,12,16,40.664685,-73.575863,11520
621444,0,0,13,121,0,134,42.120616,-77.927761,14895
861728,15,27,79,0,0,121,40.710998,-73.627079,11550
777388,0,0,0,4,12,16,40.808905,-73.914743,10454
753224,0,0,0,111,0,111,40.60877,-73.964856,11223
352909,0,0,0,0,6,6,40.785473,-73.199108,11722
784834,0,0,0,4,12,16,42.792636,-73.697814,12188
572424,0,0,17,9,0,26,41.192306,-73.851652,10562
40618,0,0,44,0,0,44,42.547918,-74.819928,12155
40074,8,10,27,7,0,52,41.403232,-74.198287,10914
751979,0,0,0,91,0,91,40.74613,-73.906347,11377
697346,0,0,0,4,12,16,40.683165,-73.922579,11233
860314,0,0,0,4,12,16,40.70929,-73.442688,11735
769848,0,0,0,4,12,16,40.863565,-73.902806,10468
874735,0,0,0,318,0,318,40.643721,-74.008394,11220
857370,0,0,0,4,12,16,42.997847,-73.841349,12020
817908,0,0,0,0,6,6,40.792001,-73.950113,10029
777890,0,0,0,4,12,16,40.868807,-73.424129,11743
824248,0,0,0,4,12,16,40.694379,-73.743048,11411
41398,0,0,0,35,0,35,42.892191,-78.674215,14086
841293,0,0,0,4,12,16,40.640515,-73.990917,11219
381273,0,0,0,120,0,120,40.636731,-74.132574,10302
280739,14,20,35,0,0,69,42.127568,-76.026952,13760
663854,0,0,0,4,12,16,40.674636,-73.918898,11233
870850,0,0,0,4,12,16,40.84781,-73.934602,10033
438359,0,0,0,44,0,44,42.804654,-78.636805,14059
297831,0,0,0,88,0,88,40.608124,-73.960481,11229
815444,0,0,0,4,12,16,40.82909,-73.914375,10456
741975,0,0,0,4,12,16,40.874491,-73.850992,10469
880775,0,0,0,4,12,16,40.858611,-73.896126,10458
644650,0,0,0,4,12,16,40.880341,-73.905869,10463
235499,0,0,0,4,12,16,40.833968,-73.301932,11725
42498,24,42,56,0,0,122,41.021895,-73.718445,10604
855550,0,0,0,2,12,14,40.834631,-73.91524,10456
877737,0,0,0,2,12,14,40.831057,-73.921963,10452
364914,0,0,0,40,0,40,41.46269,-74.534622,10963
837616,0,0,0,4,12,16,42.919401,-73.817494,12019
757608,0,0,0,4,12,16,43.230029,-75.454101,13440
12220,0,0,0,2,6,8,43.071361,-77.613073,14623
845609,0,0,0,4,12,16,40.706169,-73.366667,11757
809794,16,36,39,0,0,91,41.033144,-73.755093,10604
45291,0,0,0,107,0,107,42.897368,-78.884622,14201
25451,0,0,0,4,12,16,40.778381,-72.841684,11951
445342,0,0,0,4,12,16,40.832138,-73.876992,10472
784217,0,0,0,4,12,16,40.766058,-73.888629,11370
709925,0,0,0,192,0,192,40.705631,-73.753041,11412
518682,0,0,0,0,10,10,40.81335,-73.910283,10455
334334,0,0,0,1,6,7,40.877977,-73.826471,10475
785120,0,0,0,2,12,14,40.890503,-73.862211,10466
44457,0,0,18,0,0,18,44.512533,-73.49226,12944
346190,0,0,0,2,6,8,41.532703,-74.079428,12550
872683,0,0,0,44,0,44,42.748028,-78.895341,14075
577150,0,0,0,4,12,16,40.634309,-73.894197,11236
694278,0,0,0,2,12,14,40.816391,-73.85006,10473
204192,24,43,39,39,0,145,42.856627,-78.823177,14220
166151,0,0,0,4,12,16,40.794987,-73.200501,11722
576411,0,0,0,4,12,16,43.303144,-73.582433,12839
44119,8,10,16,6,0,40,43.023402,-76.146719,13205
41123,0,0,0,44,0,44,42.753609,-73.74151,12110
651582,0,0,0,4,12,16,40.852077,-73.883653,10458
721332,0,0,0,4,12,16,40.668551,-73.887232,11207
608287,0,0,0,4,12,16,42.197022,-75.643459,13787
283141,0,0,0,4,12,16,40.695308,-73.928235,11221
869764,0,0,0,2,6,8,43.138708,-77.632233,14611
646325,0,0,0,4,12,16,40.876957,-73.863826,10467
538353,24,47,58,17,0,146,40.72939,-73.427535,11735
760196,0,0,0,0,12,12,40.6533,-73.923951,11203
645520,32,48,81,0,0,161,40.652466,-73.679227,11563
881128,0,0,0,4,12,16,43.049728,-76.110878,13224
158880,0,0,0,2,6,8,42.918612,-78.666573,14086
801061,0,0,0,170,0,170,40.735865,-73.86753,11368
686623,0,0,0,40,0,40,44.839555,-74.297799,12953
786952,0,0,0,4,12,16,40.883288,-73.879476,10467
636206,0,0,0,4,12,16,40.843368,-73.889733,10457
41551,0,0,0,60,0,60,43.185102,-76.241893,13090
761225,0,0,0,2,6,8,40.841201,-73.854431,10462
591378,0,0,0,4,12,16,40.760035,-73.884102,11370
524407,0,0,142,30,0,172,41.163363,-73.859478,10562
53279,0,0,0,2,6,8,40.827771,-73.921822,10451
847159,0,0,0,4,12,16,40.637978,-74.142448,10302
836582,0,0,0,4,12,16,40.852848,-73.886242,10458
802024,0,0,0,50,0,50,40.658948,-73.699582,11582
879158,0,0,0,4,12,16,40.879224,-73.86322,10467
534853,0,0,0,4,12,16,43.213941,-77.593527,14617
660450,0,0,0,2,6,8,40.786132,-73.209326,11722
763594,0,0,0,4,12,16,43.154668,-77.69064,14606
817434,0,0,0,0,12,12,40.854172,-73.900434,10458
785968,0,21,48,0,0,69,40.943952,-73.795485,10804
554277,0,0,0,4,12,16,40.829855,-73.906587,10456
520894,0,0,0,4,12,16,40.69931,-73.694877,11003
807890,0,0,0,40,0,40,41.547894,-73.865855,12524
829300,0,0,0,51,0,51,40.948539,-73.067138,11777
709893,0,0,0,40,0,40,40.792627,-73.941575,10029
794830,0,0,0,2,6,8,44.405565,-74.09358,12913
383601,0,0,0,40,0,40,41.60922,-73.968672,12542
874946,0,0,0,4,12,16,40.856267,-73.888379,10458
148149,0,0,0,2,6,8,42.478488,-76.674192,14886
593886,0,0,0,4,12,16,40.841817,-73.926261,10452
867707,0,0,0,41,0,41,41.3295,-73.829,10588
879306,0,0,0,4,12,16,43.190192,-77.602842,14621
531668,0,0,0,2,12,14,40.836089,-73.926146,10452
670531,0,0,0,249,0,249,40.761578,-73.995677,10036
810014,0,0,0,4,12,16,40.752351,-73.570101,11590
725429,0,0,0,4,12,16,40.68092,-73.887924,11207
72065,0,0,0,4,12,16,40.59986,-73.739963,11691
876645,0,0,0,4,12,16,40.613485,-73.952883,11210
739467,0,0,0,2,6,8,41.818949,-73.745668,12578
130232,0,0,0,4,12,16,40.737293,-73.847287,11375
103430,0,0,0,4,12,16,40.657718,-73.738662,11422
685435,0,0,0,66,0,66,40.586969,-74.101186,10306
858410,0,0,0,4,12,16,40.821686,-73.42136,11743
154696,0,0,0,270,0,270,40.691728,-73.835496,11419
734511,0,0,0,4,12,16,40.634895,-73.996712,11219
870675,0,0,20,0,0,20,44.439492,-73.677631,12912
746053,0,0,0,4,12,16,41.131792,-74.083561,10952
816255,0,0,0,80,0,80,40.863125,-73.06681,11720
583403,0,0,0,4,12,16,41.270689,-73.781518,10598
848481,0,0,0,10,0,10,40.718642,-73.994986,10013
706150,0,0,0,2,6,8,40.817963,-73.924227,10451
111044,0,0,0,4,12,16,40.856094,-73.903056,10453
866327,0,0,0,4,12,16,42.530378,-77.590072,14572
573029,0,0,62,20,0,82,42.894776,-73.918489,12302
867550,0,0,0,4,12,16,40.909032,-73.797442,10801
846420,0,0,0,4,12,16,40.920126,-73.822843,10552
393083,0,0,0,2,12,14,40.822207,-73.858489,10473
426730,0,0,0,4,12,16,40.624252,-74.165743,10303
244592,0,0,0,80,0,80,40.821363,-73.90431,10456
27012,0,0,0,2,6,8,42.7932,-73.921608,12304
37965,0,0,0,2,6,8,43.107065,-77.426135,14450
868094,0,0,0,4,12,16,43.176557,-77.578114,14609
45347,0,0,0,405,0,405,40.704342,-73.716794,11003
40010,8,20,25,0,0,53,42.982587,-76.339866,13108
709845,0,0,0,173,0,173,40.629057,-73.979958,11204
623895,0,0,0,160,0,160,40.774344,-73.817932,11354
356701,0,0,0,104,0,104,40.815522,-73.939483,10037
664649,0,0,0,4,12,16,40.781631,-73.98436,10023
177638,0,0,0,231,0,231,40.630634,-74.019029,11209
189894,0,0,0,4,12,16,42.566197,-77.692243,14437
819086,0,0,0,4,12,16,40.814409,-73.909533,10455
192440,0,0,0,2,12,14,41.576631,-73.914647,12590
270024,0,0,0,2,6,8,42.285746,-77.218327,14879
234954,0,0,0,2,6,8,40.593692,-73.787278,11692
499198,0,0,0,4,12,16,40.640036,-73.970197,11218
707746,0,0,0,30,0,30,40.673252,-73.928749,11213
795503,0,0,0,4,12,16,40.847081,-73.938407,10033
802785,0,0,0,220,0,220,40.848637,-73.888835,10457
587847,0,0,0,2,6,8,40.679388,-73.865616,11208
789826,0,0,0,2,6,8,40.93955,-73.887961,10701
859779,16,36,21,14,0,87,40.792901,-73.042961,11742
14842,0,0,0,2,6,8,42.953781,-77.596515,14472
698006,0,0,0,2,6,8,40.86803,-73.849236,10469
778181,0,0,0,4,12,16,41.121865,-73.935888,10989
712201,0,0,16,0,0,16,42.473048,-73.814836,12143
590509,0,0,0,4,12,16,40.672176,-73.930238,11213
152531,16,12,53,0,0,81,43.151167,-77.731296,14624
43478,0,0,0,80,0,80,42.485809,-76.488863,14850
387294,0,12,21,0,0,33,40.72366,-73.643159,11530
836189,0,0,0,91,0,91,40.930101,-73.752614,10543
106342,0,0,0,7,0,7,40.660333,-73.919609,11212
396268,0,0,0,4,12,16,40.820437,-73.818731,10465
221718,0,0,0,2,6,8,43.081901,-76.742289,13146
233174,0,12,160,0,0,172,43.042918,-76.098721,13224
417590,0,0,0,4,12,16,42.067789,-73.842461,12583
248553,0,0,0,4,12,16,40.609126,-73.951636,11229
832637,0,0,0,40,0,40,42.351368,-77.662319,14843
237479,0,0,0,2,6,8,40.743298,-73.235128,11706
390951,0,0,0,2,6,8,41.538955,-74.300401,12549
854822,0,0,0,4,12,16,40.757867,-73.775058,11361
109411,0,0,24,0,0,24,41.08179,-74.058392,10977
811338,0,0,0,2,6,8,43.082788,-75.255839,13501
258589,0,0,0,257,0,257,40.83147,-73.894655,10459
40883,0,0,0,40,0,40,42.779005,-78.794973,14127
561308,0,0,0,316,0,316,40.71521,-73.886188,11379
124208,12,32,67,0,0,111,40.704,-73.4827,11783
796471,0,0,0,2,6,8,44.534102,-75.654895,13669
811481,0,0,0,112,0,112,40.616559,-73.963133,11230
206796,0,0,0,140,0,140,41.066001,-73.955328,10913
674921,0,0,0,2,6,8,40.797197,-73.944043,10029
149915,0,0,0,4,12,16,43.176489,-77.611823,14621
338319,0,0,0,480,0,480,40.742355,-73.892976,11377
402002,0,0,0,4,12,16,40.899664,-73.000813,11727
877145,0,0,0,2,6,8,43.780868,-76.016936,13605
247094,0,0,0,0,12,12,43.036645,-76.177339,13204
766057,0,0,0,4,12,16,40.672752,-73.875519,11208
552530,0,0,0,4,12,16,40.629774,-73.923018,11234
514063,0,0,0,2,12,14,40.837306,-73.889556,10460
140822,0,0,0,2,6,8,44.959193,-74.52115,12937
73952,0,0,0,671,0,671,40.67713,-73.883617,11208
816456,0,0,0,2,6,8,43.189858,-77.593233,14621
676008,0,0,0,4,12,16,40.806468,-73.919137,10454
879508,0,0,0,0,10,10,40.834531,-73.925292,10452
873387,0,0,0,2,12,14,40.862599,-73.869183,10467
821310,0,0,0,2,12,14,40.848029,-73.92162,10453
532148,16,21,41,161,0,239,40.700655,-73.352925,11704
318423,32,40,81,11,0,164,40.808225,-73.484896,11797
822801,0,0,0,4,12,16,40.884116,-73.877805,10467
715017,0,0,0,150,0,150,43.955953,-75.910084,13601
876064,0,0,0,4,12,16,40.881225,-73.903846,10463
500469,0,0,0,4,12,16,40.675252,-73.789295,11434
866788,0,0,0,4,12,16,40.716547,-73.616342,11550
648405,0,0,0,2,6,8,40.842958,-73.914431,10452
876249,0,0,0,4,12,16,42.802996,-73.938162,12307
798128,0,0,0,4,12,16,40.873143,-73.885374,10458
713801,0,0,0,40,0,40,41.644972,-73.813755,12603
359210,0,0,170,0,0,170,42.827683,-78.813692,14218
43353,0,0,0,75,0,75,42.53124,-75.521935,13815
105332,0,0,0,4,12,16,43.015539,-75.046616,13357
838773,0,0,0,4,12,16,40.756338,-73.926485,11106
850887,0,0,0,0,12,12,40.762527,-73.875042,11369
41447,0,0,0,60,0,60,42.704843,-73.659791,12180
879462,0,0,0,4,12,16,40.821533,-73.87759,10473
752596,0,0,0,4,12,16,41.11439,-74.062215,10952
268863,0,0,0,4,12,16,40.706231,-73.914659,11385
874605,0,0,0,0,12,12,40.893571,-73.858565,10466
43439,0,0,0,44,0,44,42.972317,-78.83279,14223
349794,0,0,0,4,12,16,40.678094,-73.823441,11420
877697,0,0,0,4,12,16,40.838295,-73.837604,10461
827742,0,0,0,4,12,16,40.752417,-73.778489,11364
656209,0,0,0,4,12,16,40.704717,-73.705324,11003
44179,0,29,107,0,0,136,40.848711,-73.690572,11050
845433,0,0,0,2,6,8,43.076463,-77.389159,14450
811105,0,0,0,4,12,16,40.861242,-73.906088,10468
771628,0,0,0,80,0,80,41.030326,-73.682392,10573
791197,0,0,0,2,6,8,44.234299,-74.427029,12986
814054,0,0,0,2,6,8,42.635868,-73.572486,12018
45007,0,12,21,14,0,47,42.122695,-75.964119,13790
215005,0,0,20,0,0,20,42.339837,-78.45713,14737
543505,0,0,0,4,12,16,40.893256,-73.842607,10466
239562,24,42,35,12,0,113,42.984483,-78.879202,14217
752345,0,0,0,4,12,16,40.70865,-73.734147,11429
691257,0,0,0,4,12,16,40.586482,-73.925162,11229
735663,0,0,0,0,4,4,40.796035,-73.938278,10029
522837,0,0,0,80,0,80,40.63231,-73.884981,11236
230555,0,0,0,2,12,14,40.871569,-73.865357,10467
35401,0,0,0,2,12,14,40.670926,-73.657822,11570
354636,0,0,0,2,6,8,44.913373,-73.496202,12921
825780,0,0,0,4,12,16,40.759122,-73.875407,11369
827841,0,0,0,0,10,10,40.632305,-73.987999,11219
243071,0,0,0,4,12,16,43.047194,-76.29279,13031
499772,0,0,0,4,12,16,43.063722,-76.138726,13203
183642,0,0,0,2,12,14,40.843776,-73.869147,10460
783290,0,0,0,2,6,8,40.833636,-73.927999,10452
210123,0,0,0,228,0,228,40.723101,-73.85178,11375
64700,0,0,0,2,6,8,40.80637,-73.952647,10026
872251,0,0,0,2,6,8,40.797308,-73.947025,10029
834745,0,0,0,4,12,16,40.698898,-73.596256,11553
128269,0,0,0,4,12,16,40.825805,-73.926071,10451
104999,0,0,0,2,6,8,40.903861,-72.75345,11933
689616,0,0,0,48,0,48,40.788463,-73.939771,10029
833131,24,24,71,0,0,119,40.827929,-73.341339,11746
42414,24,36,70,0,0,130,41.553373,-74.00483,12550
877353,0,0,0,0,12,12,40.801948,-73.964382,10025
844435,0,0,0,4,12,16,40.626005,-73.974736,11230
869395,0,0,0,40,0,40,41.482478,-74.817643,12737
833601,0,0,0,4,12,16,40.711653,-73.754187,11423
42698,0,48,88,0,0,136,40.944479,-73.744351,10543
880321,0,0,0,2,6,8,42.864649,-78.281181,14011
44660,14,23,59,15,0,111,43.042199,-78.740603,14068
878055,0,0,0,130,0,130,40.818653,-73.937241,10037
467838,0,0,0,4,12,16,41.095972,-74.072575,10952
42275,0,0,0,60,0,60,43.329435,-73.687207,12804
667733,0,0,0,4,12,16,40.852216,-73.896352,10457
41065,0,0,0,80,0,80,40.729994,-73.501849,11756
650203,16,48,53,0,0,117,40.753663,-73.422456,11735
776201,0,0,0,4,12,16,40.875224,-73.870103,10467
875115,0,0,0,136,0,136,40.754658,-73.82629,11355
599414,0,0,0,4,12,16,40.81395,-73.949502,10027
820372,0,0,0,110,0,110,40.712331,-73.990589,10002
612137,0,0,0,4,12,16,40.853375,-73.92875,10040
43696,16,12,39,30,0,97,42.759962,-78.612337,14052
710051,0,0,0,4,12,16,40.55938,-74.154682,10308
800708,0,0,0,140,0,140,40.759807,-73.783791,11361
647229,0,0,0,4,12,16,40.634327,-73.927887,11234
778817,0,0,0,40,0,40,40.853685,-73.905341,10453
231324,0,0,0,4,12,16,40.88347,-73.851591,10466
362306,0,0,0,2,12,14,40.843151,-73.924597,10452
800515,0,0,0,4,12,16,40.752546,-73.876127,11372
650145,16,30,82,23,0,151,40.809199,-73.104673,11779
709322,0,0,0,2,6,8,43.100781,-75.355032,13492
880037,0,0,0,2,10,12,40.61726,-74.081551,10304
213081,0,0,0,4,12,16,40.886705,-73.850699,10466
827060,0,0,114,0,0,114,43.063133,-78.854565,14120
601461,0,0,0,2,6,8,43.018969,-76.138863,13210
351930,22,18,38,5,0,83,43.130442,-77.473898,14526
765774,0,0,0,2,6,8,43.285502,-73.649481,12803
244575,0,0,0,309,0,309,40.745423,-73.908843,11377
873944,0,0,0,4,12,16,40.715127,-73.814362,11435
41639,0,0,0,90,0,90,43.081164,-77.511888,14534
605668,0,0,0,4,12,16,40.705705,-73.595411,11553
774247,0,0,0,44,0,44,40.824533,-73.126481,11779
760622,0,0,0,19,0,19,40.755886,-73.879933,11372
53919,0,0,0,0,6,6,40.856687,-73.903672,10453
385801,0,0,0,2,6,8,42.636556,-76.185937,13077
228841,0,0,0,4,12,16,40.827921,-73.898859,10459
249999,0,0,0,4,12,16,42.10156274,-78.04095706,14880
666311,0,0,0,4,12,16,40.832767,-73.914561,10456
846569,0,0,0,0,10,10,40.668986,-73.888117,11207
379550,0,0,0,4,12,16,40.702493,-73.745796,11429
875802,32,48,67,0,0,147,41.196134,-73.718712,10549
683924,0,0,0,2,6,8,40.83341,-73.918328,10456
702820,0,0,0,4,12,16,43.211096,-73.630855,12831
180445,0,0,44,0,0,44,41.35165,-73.762194,10541
838023,0,0,0,4,12,16,40.883367,-73.838983,10466
660119,0,0,0,4,12,16,40.6603,-73.594582,11520
43128,8,20,48,12,0,88,41.719985,-73.910362,12601
342334,0,0,0,66,0,66,40.759026,-73.630288,11596
640504,0,0,0,4,12,16,40.754225,-73.574561,11590
41308,8,22,34,0,0,64,41.782812,-74.071713,12561
770394,24,48,41,36,0,149,43.067497,-78.890165,14120
688158,0,0,0,4,12,16,40.81872,-73.954265,10031
43325,0,0,0,30,0,30,42.428688,-76.463686,14850
42651,0,0,43,0,0,43,40.868875,-73.351064,11740
809281,0,0,0,2,6,8,40.962674,-73.844189,10710
227357,0,0,0,2,6,8,40.702429,-73.826729,11418
880515,0,0,0,40,0,40,42.086943,-75.919547,13903
72606,0,0,0,4,12,16,40.598317,-73.752634,11691
231031,0,0,0,2,6,8,42.430756,-79.330671,14063
366749,0,0,0,4,12,16,40.956068,-73.882452,10703
782524,0,0,0,2,6,8,43.185885,-77.613052,14621
812826,0,0,0,2,6,8,42.572307,-76.053833,13101
868632,0,0,0,4,12,16,40.6501,-73.595868,11520
880494,0,0,0,139,0,139,41.058165,-74.019191,10965
429330,0,0,0,4,12,16,40.950404,-73.894738,10701
823399,0,0,0,0,12,12,40.85354,-73.902287,10457
515372,0,0,0,4,12,16,40.785811,-73.948293,10029
789633,0,0,0,4,12,16,40.609105,-73.986641,11204
758423,0,0,0,0,12,12,40.644541,-74.016641,11220
731345,0,0,0,4,12,16,40.797216,-73.242859,11717
878421,0,0,0,4,12,16,40.578336,-73.95585,11235
500255,0,0,0,4,12,16,40.675367,-73.876469,11208
55663,0,0,0,2,6,8,40.867741,-73.88177,10458
73374,0,0,0,309,0,309,40.603011,-74.001506,11214
643616,0,0,0,0,11,11,43.058564,-74.334766,12078
753942,0,0,0,2,12,14,40.862085,-73.902622,10468
185686,0,0,31,0,0,31,41.486064,-74.392332,10941
661439,0,0,0,2,6,8,40.651306,-74.008205,11232
861842,0,0,0,4,12,16,40.950273,-73.875475,10701
44865,8,12,28,14,0,62,42.509194,-78.670732,14141
427158,0,0,0,2,6,8,43.157551,-77.635406,14611
617208,0,0,0,2,12,14,40.805361,-73.950013,10027
432388,0,0,0,4,12,16,40.700699,-73.787732,11433
847787,0,0,0,4,12,16,40.666067,-73.775806,11434
799558,8,22,35,40,0,105,42.979193,-74.150166,12086
32823,0,0,0,4,12,16,42.948274,-73.936088,12020
29918,0,0,0,2,6,8,44.154127,-76.10553,13622
43934,0,0,39,0,0,39,40.858154,-73.635317,11542
869896,0,0,0,4,12,16,40.694942,-73.912967,11221
837043,0,0,0,4,12,16,40.828422,-73.916581,10456
669657,0,0,0,0,12,12,40.844131,-73.905069,10457
868907,0,0,0,4,12,16,40.794658,-72.844104,11950
805005,0,0,0,89,0,89,40.834403,-73.855818,10462
494113,0,0,0,2,12,14,40.842789,-73.906474,10457
700134,0,0,0,2,6,8,43.202907,-77.344745,14519
596695,0,0,0,4,12,16,40.844964,-73.937825,10033
586659,0,0,0,2,6,8,43.021676,-76.149705,13205
840755,0,0,0,0,12,12,40.635457,-73.997651,11219
454289,0,0,0,4,12,16,40.847657,-73.911367,10453
73286,0,0,0,300,0,300,40.680132,-73.921957,11233
722469,0,0,0,4,12,16,40.8305,-73.87975,10472
866808,0,0,15,0,0,15,42.174519,-75.622185,13787
775502,0,0,0,4,12,16,42.209677,-73.866311,12414
522157,0,0,0,0,12,12,42.544023,-76.25311,13045
44231,32,42,60,1,0,135,40.880855,-73.39934,11743
5226,0,0,0,2,6,8,43.194007,-78.711815,14094
761064,0,0,0,4,12,16,43.193195,-75.435695,13440
765956,0,0,0,2,12,14,40.829853,-73.922667,10452
100929,0,0,0,4,12,16,40.717149,-73.609025,11550
879838,0,0,0,4,12,16,40.674491,-73.950793,11216
6368,0,0,0,2,6,8,43.124881,-75.294498,13492
795810,0,0,0,4,12,16,40.680874,-73.768108,11434
44582,0,0,0,35,0,35,41.70732,-74.091488,12561
40377,0,34,88,0,0,122,40.844752,-73.293135,11725
163181,0,0,0,2,5,7,40.757625,-73.239025,11706
21360,0,0,0,2,6,8,40.915442,-73.894961,10705
549942,0,0,0,4,12,16,40.836635,-73.91938,10452
793907,0,0,0,4,12,16,40.71162,-73.989382,10002
877018,32,48,126,20,0,226,40.841465,-73.170379,11787
878114,0,0,101,21,0,122,40.793843,-72.90521,11719
810745,0,0,0,4,12,16,40.67114,-73.580161,11520
873650,0,0,0,2,6,8,44.077702,-75.832059,13637
267474,0,0,0,0,12,12,40.834264,-73.915455,10456
579403,0,0,0,4,12,16,40.724884,-73.815298,11367
72451,0,0,0,2,12,14,40.665808,-73.987728,11215
411149,0,0,0,4,12,16,40.697308,-73.923565,11221
634320,0,0,0,2,6,8,43.32914,-76.424192,13069
107877,24,42,48,0,0,114,42.692362,-73.68548,12180
881860,0,0,0,4,12,16,40.839624,-73.914673,10452
41593,0,18,65,0,0,83,41.650435,-73.558752,12594
717094,0,0,0,4,12,16,40.798671,-73.258184,11717
619353,0,0,0,4,12,16,42.775571,-73.911309,12304
74220,0,0,0,98,0,98,40.647057,-73.88145,11239
758944,0,0,0,4,12,16,40.666833,-73.581973,11520
866618,0,0,0,2,6,8,41.922077,-73.992326,12401
830336,0,0,0,4,12,16,40.822469,-73.851798,10473
873559,32,47,43,0,0,122,42.688851,-73.77668,12205
709798,0,0,0,230,0,230,40.645573,-73.898156,11236
751001,0,0,0,388,0,388,40.865466,-73.921327,10034
610454,0,0,0,40,0,40,40.826702,-73.908849,10456
72329,0,0,0,0,10,10,40.644871,-73.889622,11236
853340,0,0,0,2,6,8,43.201638,-77.668244,14615
860493,0,0,0,4,12,16,40.634283,-73.967147,11230
343609,0,12,59,0,0,71,40.722943,-73.663958,11530
817404,0,0,0,2,6,8,42.076336,-76.812811,14904
32411,0,0,0,4,12,16,42.996229,-75.98823,13104
794560,0,0,0,0,12,12,40.828426,-73.916595,10456
354910,48,50,72,0,0,170,42.459484,-76.475909,14850
876843,0,0,0,4,12,16,40.761471,-73.935975,11106
685041,0,0,0,4,12,16,40.669388,-73.849434,11414
858807,0,0,0,4,12,16,40.830096,-73.906476,10456
263623,0,0,0,4,12,16,42.51278,-76.433337,13068
423050,14,48,83,0,0,145,41.322071,-73.852665,10547
395148,0,0,0,99,0,99,40.70346,-73.765627,11412
798549,0,0,0,4,12,16,40.87278,-73.883515,10458
565394,0,0,0,278,0,278,40.729537,-73.818096,11367
355474,0,0,0,4,12,16,40.961932,-73.732641,10543
806046,0,0,0,2,6,8,41.085808,-73.862154,10591
878589,0,0,0,4,12,16,40.86158,-73.904303,10468
852993,0,0,0,2,6,8,41.47659,-74.374611,10941
383059,0,0,0,4,12,16,40.832571,-73.885855,10460
398241,0,0,0,4,12,16,40.629181,-74.165648,10303
782860,0,0,0,2,6,8,40.718949,-73.981744,10002
39351,0,0,0,80,0,80,42.018766,-73.870381,12571
837845,0,0,0,4,12,16,43.047097,-76.160714,13204
293154,0,0,0,4,12,16,40.685297,-73.731325,11411
271500,0,0,0,4,12,16,42.911966,-78.810602,14211
292375,0,20,140,34,0,194,41.164566,-74.001922,10956
24645,0,0,0,2,6,8,43.090823,-77.087686,14513
792700,0,0,0,4,12,16,43.172674,-77.653818,14606
39242,0,24,60,0,0,84,42.095455,-75.910786,13901
712473,0,0,0,0,10,10,40.694212,-73.551053,11710
40758,0,0,0,57,0,57,42.162552,-77.082533,14870
841488,0,0,0,2,6,8,43.015526,-76.146769,13205
312141,0,0,0,2,6,8,41.933244,-73.996196,12401
406200,0,0,0,4,12,16,43.172994,-77.571705,14609
368833,0,0,0,4,12,16,40.671633,-73.724374,11580
581646,0,0,0,4,12,16,40.852939,-73.892786,10457
40523,0,0,0,163,0,163,41.017655,-73.84051,10502
814924,0,0,0,0,6,6,40.705126,-73.939581,11206
261140,0,0,0,4,12,16,42.590639,-78.942901,14111
735360,0,0,0,4,12,16,40.86987,-73.892627,10468
479609,0,0,0,80,0,80,40.715517,-73.872183,11379
709628,0,0,0,134,0,134,40.690628,-73.95013,11216
441033,0,0,0,2,6,8,42.752882,-73.717107,12189
231977,0,0,0,153,0,153,40.657949,-73.920274,11212
869163,0,0,0,70,0,70,42.09234,-79.253894,14701
844463,0,0,0,4,12,16,40.918883,-73.856034,10704
278383,0,0,0,4,12,16,40.803181,-73.247407,11717
871528,0,0,0,20,0,20,40.678855,-73.589597,11575
39403,0,20,54,32,0,106,42.987509,-78.676828,14221
745554,0,0,0,20,0,20,42.294846,-77.748843,14804
434674,0,0,0,4,12,16,40.676307,-73.876152,11208
769933,0,0,0,4,12,16,40.70334,-73.607958,11550
276316,0,0,0,2,6,8,43.073064,-78.873728,14120
440175,0,0,0,115,0,115,40.703446,-73.940545,11206
525915,0,0,0,2,12,14,40.877434,-73.909068,10463
116525,0,0,0,4,12,16,41.477447,-74.362079,10941
613772,0,0,0,4,12,16,40.664345,-73.913095,11212
844159,0,0,0,2,6,8,43.16915,-77.645345,14606
877906,0,0,0,100,0,100,41.210773,-73.875012,10520
41354,0,0,0,114,0,114,41.296809,-73.86918,10517
749622,0,0,0,120,0,120,40.615795,-73.979648,11204
3185,0,0,0,2,6,8,41.099239,-74.050503,10977
361068,0,0,0,2,6,8,40.76558,-73.204605,11722
73856,0,0,0,175,0,175,40.670881,-73.974341,11215
668669,0,0,0,4,12,16,40.82133,-73.93539,10039
163466,16,12,15,13,0,56,42.884982,-78.877896,14202
852498,0,0,0,2,12,14,40.853528,-73.903952,10453
765630,0,0,0,40,0,40,41.187922,-74.184344,10987
649189,0,0,0,4,12,16,41.131409,-74.045018,10977
61605,0,0,0,0,6,6,40.709198,-73.958277,11211
19102,0,0,0,2,6,8,41.095182,-73.923663,10960
834540,0,0,0,2,6,8,43.172555,-77.579383,14609
856957,0,0,0,4,12,16,40.851268,-73.90019,10457
145238,0,0,0,111,0,111,43.116543,-79.048844,14305
679460,0,0,0,144,0,144,40.582462,-74.088401,10305
627230,0,0,0,4,12,16,40.67703,-73.654479,11552
21732,0,0,0,2,6,8,42.832634,-73.971309,12302
585632,0,0,0,4,12,16,40.634927,-74.148846,10303
529632,0,0,0,2,6,8,40.737022,-73.863744,11368
484328,0,0,0,4,12,16,40.716844,-73.959386,11211
805516,0,0,0,2,6,8,40.75442,-73.571045,11590
360734,0,0,0,4,12,16,40.916459,-73.851387,10704
264976,0,0,0,4,12,16,43.216791,-78.391264,14103
41567,0,0,0,44,0,44,42.933162,-73.811477,12019
695018,0,0,0,4,12,16,40.681828,-73.798701,11436
882608,0,0,0,4,12,16,40.906845,-73.816726,10553
160591,0,0,0,4,12,16,43.565262,-76.125458,13142
257722,0,0,0,0,6,6,40.671264,-73.896437,11207
210730,0,8,40,0,0,48,42.51812,-78.649997,14141
295743,0,0,0,2,6,8,43.166646,-77.563754,14609
41010,0,0,0,40,0,40,43.317245,-73.664918,12801
853775,0,0,0,68,0,68,40.574492,-73.993918,11224
486592,0,0,0,4,12,16,43.147185,-77.647798,14611
873522,0,0,0,4,12,16,40.625752,-73.925898,11234
680344,0,0,0,4,12,16,40.70275,-73.629632,11550
761975,0,0,0,4,12,16,44.443853,-73.673371,12912
401036,0,0,0,4,12,16,43.02461,-76.161244,13207
225601,0,0,0,4,12,16,40.660613,-73.896705,11207
659005,0,0,0,4,12,16,40.85653,-73.866823,10462
348813,0,0,0,4,12,16,40.681272,-73.929468,11233
873171,0,0,0,2,6,8,43.219031,-77.645588,14616
804228,0,0,0,0,12,12,40.83991,-73.84617,10461
286489,0,0,0,4,12,16,40.673514,-73.880942,11208
5629,0,0,0,2,6,8,43.323536,-76.410831,13069
723415,0,0,0,2,6,8,42.133906,-77.035667,14830
875520,0,0,0,60,0,60,43.636102,-75.394833,13473
742479,0,0,0,2,6,8,43.16588,-77.655333,14606
848785,0,0,40,0,0,40,41.930171,-73.993331,12401
331798,0,0,0,155,0,155,40.594727,-74.126201,10314
870836,0,0,0,180,0,180,40.821532,-73.941284,10030
349873,0,0,0,4,12,16,41.484575,-74.497564,10963
386356,0,0,0,4,12,16,40.650772,-73.591936,11520
834059,0,0,0,4,12,16,43.169394,-76.569519,13033
733037,0,0,0,4,12,16,40.699099,-73.832226,11418
308533,0,0,0,0,12,12,40.871553,-73.884231,10458
878141,0,0,21,45,0,66,42.996476,-77.444831,14564
357596,0,0,0,44,0,44,40.852303,-73.38959,11746
44763,0,0,0,140,0,140,40.772475,-73.653142,11507
142743,0,0,0,140,0,140,40.686727,-73.946995,11216
790100,0,0,0,131,0,131,40.745814,-73.865429,11368
369290,0,0,0,2,12,14,41.083787,-73.865502,10591
326771,0,0,0,4,12,16,42.584687,-77.953254,14517
388587,0,0,0,4,12,16,40.678855,-73.918291,11233
629725,0,0,0,2,6,8,44.784707,-73.49468,12992
841818,0,0,0,4,12,16,40.817379,-73.863783,10473
300159,0,0,0,4,12,16,41.532192,-74.090481,12550
816248,0,0,0,140,0,140,40.866266,-73.018739,11784
622214,0,0,0,4,12,16,40.616671,-73.948436,11210
873002,0,0,0,4,12,16,40.721736,-73.810142,11367
689292,0,0,0,60,0,60,40.66347,-73.905599,11212
728352,0,0,0,280,0,280,40.802881,-73.965861,10025
686364,0,0,0,4,12,16,40.671835,-73.98513,11215
764609,0,0,0,4,12,16,43.166637,-77.578012,14609
125688,0,0,0,2,6,8,43.132304,-78.70343,14094
816574,0,0,0,4,12,16,40.811739,-73.950498,10027
799389,0,0,0,2,12,14,40.841839,-73.868797,10460
73177,0,0,0,8,0,8,40.590471,-73.971956,11223
795049,0,0,0,75,0,75,42.054311,-79.157839,14738
824843,0,0,0,2,12,14,40.848929,-73.921994,10453
299760,0,0,0,216,0,216,40.633035,-74.003627,11219
262809,0,0,0,57,0,57,43.153456,-76.342885,13027
71439,0,0,0,4,12,16,40.685493,-73.925566,11233
376473,0,0,0,65,0,65,40.841989,-73.935855,10032
819476,0,0,0,4,12,16,40.674491,-73.950793,11216
713309,0,0,134,0,0,134,42.945107,-78.764927,14225
797214,0,0,0,2,6,8,40.921549,-73.790986,10801
303285,0,0,0,4,12,16,40.841981,-73.869039,10460
42432,0,0,0,30,0,30,43.987057,-75.901849,13601
614936,0,0,0,0,12,12,40.890503,-73.862211,10466
862455,0,0,0,4,12,16,40.848111,-73.890418,10457
822622,0,0,0,4,12,16,43.177145,-77.636548,14613
298841,0,0,0,4,12,16,40.572456,-74.096868,10306
39662,42,60,61,88,0,251,43.119242,-77.591489,14618
280613,0,0,0,4,12,16,41.386338,-74.444502,10973
377759,0,0,0,2,10,12,40.622611,-73.922619,11234
215381,0,0,0,4,12,16,40.686968,-73.9363,11221
728912,0,0,0,2,6,8,40.679515,-73.930934,11233
415262,0,0,0,2,6,8,40.836271,-73.385702,11746
722963,0,0,0,2,6,8,42.765631,-73.988868,12306
747702,0,0,0,2,6,8,41.791079,-75.045162,12723
690318,0,0,92,0,0,92,42.714484,-73.803285,12205
848567,0,0,0,4,12,16,40.890066,-73.834075,10466
664116,16,24,39,49,0,128,43.265595,-77.750422,14468
814432,0,0,0,2,6,8,43.087478,-75.231539,13501
801623,0,0,0,4,12,16,40.8948,-73.847391,10466
620316,0,0,0,4,12,16,40.842962,-73.709545,11050
283873,0,0,0,4,12,16,40.664521,-73.925513,11212
862102,0,12,32,0,0,44,40.766268,-73.010508,11772
709654,0,0,0,102,0,102,40.589589,-73.805555,11693
873982,0,0,0,4,12,16,40.598406,-73.754383,11691
218172,0,0,0,217,0,217,40.720527,-73.985777,10002
133442,0,0,0,4,12,16,40.674225,-73.918228,11233
27777,0,0,0,2,6,8,41.90169,-73.983926,12466
41811,0,21,32,0,0,53,40.799868,-73.404119,11747
765470,0,0,0,4,12,16,43.085278,-75.660856,13421
413905,0,0,0,44,0,44,42.7469,-73.6779,12180
245923,0,0,0,145,0,145,40.676947,-73.960335,11238
569561,0,0,0,44,0,44,42.883606,-78.858935,14204
778450,0,0,0,117,0,117,40.760633,-73.941422,11101
807459,0,0,0,2,6,8,43.049244,-76.105564,13224
40187,0,0,21,0,0,21,44.596521,-75.167395,13617
39767,0,0,0,104,0,104,43.173889,-77.543847,14609
769061,0,0,0,4,12,16,40.607405,-73.758452,11691
625839,0,0,0,2,6,8,40.672624,-73.866155,11208
608492,0,0,0,2,12,14,40.841252,-73.890454,10460
730244,0,0,0,4,12,16,40.655169,-73.596641,11520
256005,0,0,0,4,12,16,40.711308,-73.698981,11003
43208,0,0,0,60,0,60,44.001244,-75.97611,13615
380662,0,0,0,4,12,16,40.895037,-73.8437,10466
29477,0,0,0,2,6,8,44.220347,-75.814808,13691
555934,0,0,114,0,0,114,40.667004,-73.511201,11793
850451,0,0,0,4,12,16,42.915257,-76.533829,13021
584138,0,0,0,4,12,16,40.834481,-73.87106,10472
828161,0,0,0,4,12,16,40.689487,-73.942904,11221
877945,0,0,0,41,0,41,40.588101,-73.628022,11561
859649,0,0,0,4,12,16,40.637137,-73.947314,11210
117722,0,0,0,4,12,16,42.907982,-78.812373,14211
631607,0,0,0,4,12,16,40.994594,-73.66437,10573
704742,0,0,0,206,0,206,40.974061,-73.78467,10804
298293,0,0,0,4,12,16,40.788864,-73.259458,11717
867928,0,0,0,75,0,75,40.65282,-73.671146,11563
73620,0,0,0,13,0,13,40.702266,-74.01089,10004
344146,0,0,0,4,12,16,40.642134,-74.078905,10301
802157,0,0,0,4,12,16,40.815124,-73.920334,10451
796576,0,0,0,4,12,16,40.819479,-73.938348,10030
806489,0,0,0,140,0,140,40.828665,-73.856861,10472
863976,0,0,0,4,12,16,43.09346,-75.130264,13502
689584,0,0,0,104,0,104,40.773257,-73.933727,11102
842837,0,0,0,4,12,16,40.868211,-73.91824,10034
673755,0,0,0,4,12,16,40.576171,-74.001113,11224
637483,0,0,0,464,0,464,40.850187,-73.915445,10453
603498,0,0,0,60,0,60,42.861664,-73.894715,12148
855462,0,0,0,4,12,16,43.172496,-77.644443,14606
399831,24,24,60,0,0,108,42.5983,-76.1807,13045
24962,0,0,0,2,6,8,43.167745,-77.55777,14609
817811,0,0,0,4,12,16,40.863441,-73.825152,10475
792081,0,0,0,4,12,16,40.656498,-73.95701,11225
800727,0,0,0,57,0,57,41.887925,-73.535952,12501
489075,0,0,0,2,12,14,40.824398,-73.925926,10451
37580,0,0,0,2,6,8,42.52762,-75.521763,13815
58505,0,0,0,0,5,5,40.825457,-73.904485,10456
768530,0,0,0,2,6,8,42.167732,-78.402542,14743
233441,0,20,24,0,0,44,42.811025,-73.892939,12309
404504,0,0,0,4,12,16,42.982801,-76.34198,13108
9396,0,0,0,2,6,8,42.075424,-76.116197,13760
784626,0,22,57,0,0,79,40.756999,-73.4898,11714
239424,0,24,65,0,0,89,40.95659,-72.24508,11975
360491,0,0,0,2,12,14,40.642341,-74.022781,11220
759390,0,0,0,4,12,16,40.669194,-73.597357,11520
741992,0,0,0,120,0,120,40.780585,-73.976682,10024
580788,0,0,0,4,12,16,40.690423,-73.908595,11207
454252,0,0,0,4,12,16,40.613465,-74.078781,10304
826751,0,0,0,2,6,8,42.369606,-74.512129,12434
742505,0,0,0,165,0,165,40.621696,-73.950245,11210
855108,0,0,0,2,6,8,40.850097,-73.939929,10033
131154,0,0,0,4,12,16,41.608376,-74.1767,12589
816907,0,0,0,55,0,55,42.751389,-73.68267,12180
652941,0,0,0,4,12,16,40.947529,-73.890614,10703
767406,0,0,0,4,12,16,40.618127,-73.909184,11234
797865,0,0,0,4,12,16,41.801833,-73.908741,12538
389989,0,0,0,2,6,8,40.75189,-73.937264,11101
40512,0,24,42,9,0,75,41.022395,-73.800492,10530
451385,0,0,0,2,12,14,40.695168,-73.910781,11237
779050,0,0,0,1,6,7,40.84781,-73.934602,10033
770054,0,0,84,0,0,84,40.592473,-73.663944,11561
213851,0,0,0,4,12,16,40.910828,-73.846004,10550
718893,0,0,0,304,0,304,40.61364,-73.930109,11234
811966,0,0,0,2,6,8,43.164049,-77.595003,14605
219616,0,0,0,4,12,16,40.923991,-73.827962,10552
866268,5,12,149,8,0,174,41.032908,-73.771527,10601
316558,0,0,17,0,0,17,43.239321,-78.18479,14411
865782,0,0,0,4,12,16,42.490729,-77.336935,14873
831677,0,0,0,70,0,70,40.660073,-73.913604,11212
469740,0,22,117,34,0,173,42.696103,-73.884979,12203
137587,24,41,72,14,0,151,42.586829,-73.698831,12061
854367,0,0,0,2,12,14,40.863827,-73.868544,10467
273422,8,24,32,12,0,76,42.945075,-78.795135,14215
711312,0,0,0,80,0,80,40.727803,-73.975886,10009
795972,0,0,0,60,0,60,40.674034,-73.936575,11213
704429,0,0,0,4,12,16,40.877547,-73.047931,11784
229122,0,0,0,4,12,16,40.685813,-73.401898,11726
773085,0,0,0,40,0,40,41.6001,-73.8372,12590
284389,0,20,71,0,0,91,40.802744,-73.65676,11576
785222,0,0,0,4,12,16,40.759148,-73.91681,11103
42210,15,20,70,0,0,105,41.161043,-74.039069,10970
807241,0,0,0,4,12,16,40.672138,-73.586826,11520
673329,0,0,0,4,12,16,40.882537,-73.90374,10463
41889,16,20,39,31,0,106,43.059478,-76.138155,13203
237950,0,0,0,2,6,8,40.831652,-73.857805,10472
73121,0,0,0,293,0,293,40.606261,-73.989607,11214
754099,0,0,0,127,0,127,40.704764,-73.939004,11206
199121,0,0,0,4,12,16,41.650964,-73.974577,12547
881044,0,0,0,4,12,16,40.690767,-73.812615,11419
831877,0,0,0,2,6,8,41.122935,-74.031053,10977
251771,0,0,0,260,0,260,40.886035,-73.840575,10466
644278,0,0,0,89,0,89,42.118393,-77.948539,14895
400777,0,0,0,2,12,14,40.871938,-73.842455,10469
39459,16,72,106,0,0,194,42.903433,-78.872889,14209
736212,0,0,0,2,6,8,43.9305,-75.8028,13601
304328,0,0,0,4,12,16,40.728521,-73.779022,11423
251082,0,0,0,4,12,16,40.860535,-73.906726,10468
675079,0,0,0,4,12,16,40.585004,-73.817069,11693
729375,0,0,0,4,12,16,40.692192,-73.968901,11205
836344,0,0,0,83,0,83,40.943251,-73.762471,10538
512939,0,0,0,4,12,16,40.727248,-73.80679,11366
735567,0,0,0,4,12,16,40.664265,-73.899982,11207
301735,0,0,0,4,12,16,40.904761,-73.846211,10470
475398,16,20,25,25,0,86,43.186158,-77.61582,14621
872368,0,0,0,4,12,16,42.916247,-78.801915,14211
503594,0,0,0,4,12,16,40.687192,-73.911225,11207
276568,0,0,0,4,12,16,40.697205,-73.930417,11221
330244,0,0,0,2,5,7,40.864007,-73.924383,10034
355331,0,0,0,4,12,16,40.672603,-73.886682,11207
829061,0,0,0,2,12,14,40.860513,-73.870445,10467
539828,0,0,0,101,0,101,43.121652,-77.311488,14568
309250,0,0,0,2,12,14,40.687793,-73.810533,11419
339025,0,0,0,4,12,16,40.857319,-73.901051,10453
607764,0,0,0,110,0,110,40.642506,-73.908114,11236
819576,0,0,0,2,6,8,43.172948,-77.630206,14608
14268,0,0,0,2,6,8,42.951779,-77.329827,14425
684304,0,0,0,80,0,80,40.85026,-73.892479,10457
851610,0,0,0,4,12,16,40.709849,-73.639848,11550
339614,0,0,0,247,0,247,40.822887,-73.818,10465
35035,0,0,0,2,6,8,40.772725,-73.221863,11717
44242,0,0,0,44,0,44,42.515078,-73.612522,12123
255987,0,0,0,81,0,81,40.678302,-73.506643,11793
799008,0,0,0,2,6,8,42.990168,-76.146519,13205
731838,0,0,0,2,6,8,42.845835,-73.959041,12302
427969,0,0,0,4,12,16,40.643171,-74.084129,10301
844917,0,0,0,4,12,16,40.712817,-73.583019,11553
135006,0,0,0,2,6,8,41.142407,-74.029838,10977
519182,0,0,0,4,12,16,40.757303,-73.585787,11590
580381,0,0,0,4,12,16,40.75496,-73.801165,11358
126482,0,0,0,2,12,14,41.14947,-74.013598,10956
738651,0,0,21,9,0,30,43.113377,-78.773994,14094
695722,0,0,0,4,12,16,40.599097,-73.750102,11691
848189,0,0,0,4,12,16,42.082301,-75.947897,13850
803185,15,14,32,9,0,70,42.74053,-78.796756,14127
45203,0,0,0,150,0,150,42.442083,-76.502223,14850
663498,0,0,0,0,12,12,40.83217,-73.921307,10452
352779,24,48,45,20,0,137,40.945903,-72.94232,11778
874053,0,0,0,2,6,8,40.852425,-73.90239,10457
858049,23,54,65,0,0,142,41.003639,-73.857402,10522
40652,0,0,32,0,0,32,42.657373,-73.756005,12210
834857,0,0,0,4,12,16,40.830606,-73.874684,10472
767191,0,0,0,4,12,16,40.637018,-74.139771,10302
367933,0,0,0,2,6,8,43.147975,-77.756861,14624
447897,0,0,0,4,12,16,40.925711,-72.667889,11901
761917,0,0,0,0,12,12,40.899168,-73.843376,10466
877081,0,0,0,4,12,16,40.726198,-73.784206,11432
827653,0,0,20,0,0,20,42.136862,-77.063282,14830
478093,0,0,0,182,0,182,41.506007,-74.011145,12550
589404,0,0,0,4,12,16,40.703728,-73.782404,11433
744773,0,0,0,60,0,60,40.86932,-73.870274,10467
342045,0,0,0,183,0,183,40.712537,-73.96217,11211
101512,0,0,0,188,0,188,40.718498,-73.984215,10002
864295,0,0,0,2,6,8,43.069901,-76.135223,13203
71937,0,0,0,4,12,16,40.651643,-73.928242,11203
709759,0,0,0,144,0,144,40.545902,-74.145897,10308
878518,0,0,0,0,4,4,40.805616,-73.937896,10035
638006,0,0,0,4,12,16,40.692957,-73.860417,11421
875645,0,0,0,4,12,16,40.774378,-73.540968,11801
369744,0,0,0,4,12,16,41.058055,-73.780938,10603
877507,0,0,0,4,12,16,40.661695,-73.986789,11215
150542,0,0,0,2,6,8,40.869946,-73.903451,10468
615752,0,0,0,4,12,16,40.682661,-73.999134,11231
830653,0,0,0,196,0,196,40.75406,-73.887183,11372
115371,0,0,0,2,6,8,44.684277,-73.454376,12901
419844,0,0,0,4,12,16,40.741727,-73.079217,11782
73877,0,0,0,18,0,18,40.715509,-73.817203,11435
822837,0,0,0,0,10,10,40.705618,-73.948361,11206
791883,0,0,0,2,6,8,43.144812,-75.438643,13440
651697,0,0,0,4,12,16,40.836575,-73.947109,10032
40309,0,0,0,120,0,120,40.786701,-72.856074,11950
172629,0,0,0,2,6,8,43.342149,-73.592636,12839
232148,12,22,18,5,0,57,42.99465,-78.216304,14020
756324,0,0,0,35,0,35,40.650991,-73.932425,11203
39935,0,0,0,100,0,100,43.149913,-75.325197,13424
41691,0,0,0,45,0,45,41.102996,-73.917705,10960
741670,0,0,0,4,12,16,40.873101,-73.885436,10458
403751,0,0,0,4,12,16,40.586465,-73.95576,11235
42250,0,0,60,0,0,60,42.940263,-78.754042,14225
562345,0,0,0,4,12,16,40.868836,-72.97128,11763
820524,0,0,0,4,12,16,43.00649,-75.261869,13456
774426,0,0,0,219,0,219,40.672553,-73.884924,11207
168846,15,17,16,0,0,48,42.733596,-78.918675,14085
592077,0,0,0,4,12,16,40.659913,-73.992263,11215
876603,0,0,0,4,12,16,40.665804,-73.894106,11207
337538,0,0,0,15,0,15,40.683294,-73.78224,11434
521309,0,0,0,4,12,16,40.674672,-73.91415,11233
865560,0,10,46,0,0,56,40.692514,-73.543065,11710
277300,0,0,0,4,12,16,40.732934,-73.79604,11365
843618,0,0,0,324,0,324,40.739241,-73.882521,11373
44161,8,24,42,41,0,115,42.825015,-73.966158,12302
703561,0,0,0,2,12,14,40.837265,-73.916529,10452
39611,20,16,94,41,0,171,43.156594,-77.558417,14609
474013,0,0,0,4,12,16,40.871486,-73.904283,10463
429490,0,0,0,4,12,16,40.728529,-73.826642,11367
335510,0,0,0,4,12,16,40.740359,-73.549483,11590
117659,0,0,0,2,6,8,42.214514,-73.862273,12414
111611,0,0,0,4,12,16,40.738087,-73.361371,11704
879273,0,0,0,4,12,16,40.671917,-73.766448,11434
531160,0,0,0,4,12,16,40.659817,-73.890691,11207
823746,0,0,0,4,12,16,40.86526,-73.867851,10467
169111,0,0,0,4,12,16,40.676164,-73.403645,11726
851595,0,0,0,0,12,12,40.824122,-73.893707,10459
738568,0,0,0,4,12,16,40.661613,-73.914065,11212
815289,0,0,0,4,12,16,40.849379,-73.898743,10457
648611,0,0,0,4,12,16,40.880519,-73.876967,10467
842123,0,0,0,4,12,16,40.907838,-73.818943,10553
502882,0,0,0,2,6,8,43.136872,-77.63947,14619
670739,0,0,0,4,12,16,40.828083,-73.861889,10472
807944,0,0,0,160,0,160,40.660073,-73.913604,11212
509964,0,0,0,4,12,16,40.757416,-73.289599,11706
543192,0,0,0,4,12,16,40.841502,-73.923589,10452
39791,0,12,39,0,0,51,40.773446,-73.572636,11590
751100,28,36,78,0,0,142,43.217106,-77.427904,14580
743050,0,0,0,4,12,16,40.665607,-73.940745,11213
44542,0,0,35,20,0,55,44.323307,-74.12198,12983
74148,0,0,0,535,0,535,40.734388,-73.896968,11377
878770,0,0,0,80,0,80,41.43955,-74.03436,12518
594817,24,30,91,30,0,175,43.000177,-77.437829,14564
43578,16,20,32,0,0,68,41.418129,-73.951405,10516
763316,0,0,0,4,12,16,40.916238,-73.790718,10801
43181,16,32,51,0,0,99,42.969928,-73.791168,12020
197439,16,10,14,0,0,40,42.121721,-75.980006,13790
174792,0,0,20,104,0,124,40.84667,-73.640862,11579
879126,0,0,0,2,6,8,43.083239,-75.233005,13501
803001,14,26,22,0,0,62,44.701472,-73.500068,12901
431042,0,0,0,4,12,16,40.620366,-74.02149,11228
842775,0,0,0,4,12,16,40.75774,-73.875522,11369
473231,0,0,0,4,12,16,42.945246,-78.814573,14215
653584,0,0,0,4,12,16,40.678475,-73.963016,11238
41119,0,0,0,44,0,44,42.741271,-73.753061,12110
268281,0,0,0,4,12,16,40.862584,-73.844252,10469
269498,0,76,72,0,0,148,40.808034,-73.748005,11024
201974,0,0,216,0,0,216,42.849795,-78.804562,14210
868280,0,0,0,34,0,34,42.699842,-74.026907,12009
374042,0,0,0,460,0,460,40.691099,-73.711132,11003
40709,0,0,105,0,0,105,40.710304,-73.407326,11701
671308,0,0,0,4,12,16,40.756749,-73.880684,11369
44430,0,0,0,40,0,40,43.173658,-78.70686,14094
174512,0,0,0,4,12,16,40.686768,-73.751821,11413
70680,0,0,0,2,6,8,40.68288,-73.775663,11434
847878,0,0,0,4,12,16,40.83229,-73.917995,10456
661697,0,0,0,4,12,16,40.748911,-74.001546,10001
227967,0,0,0,2,12,14,40.752448,-73.739565,11362
201752,0,0,0,4,12,16,40.776717,-73.114385,11716
869989,0,0,0,4,12,16,40.929041,-73.884854,10701
193547,0,0,0,0,6,6,40.624234,-73.998908,11219
623330,0,0,0,56,0,56,40.899936,-73.834374,10550
744230,0,11,58,0,0,69,41.257619,-73.685798,10536
356187,0,0,0,75,0,75,42.7964,-73.866265,12309
874509,16,30,103,0,0,149,41.02304,-73.758241,10605
820122,0,0,0,0,8,8,40.837625,-73.918668,10452
40111,24,46,71,0,0,141,42.464601,-75.060662,13820
43979,16,44,49,34,0,143,42.957949,-78.836394,14223
761380,0,0,0,4,12,16,40.899921,-73.856906,10470
221456,0,0,0,2,12,14,43.021892,-76.155871,13207
396538,0,0,0,2,6,8,43.000111,-75.965446,13104
759700,0,0,0,4,12,16,40.687778,-73.97458,11217
353759,0,0,0,2,6,8,42.6619,-73.771035,12206
858878,0,0,0,25,0,25,40.831422,-73.892071,10459
45069,0,12,36,0,0,48,44.847703,-74.297833,12953
867454,0,0,0,2,6,8,44.900371,-73.436137,12921
692843,0,0,0,2,6,8,43.166429,-77.639097,14606
245019,0,0,0,288,0,288,40.621651,-73.92567,11234
878488,0,0,0,4,12,16,41.229531,-74.013065,10980
611247,0,0,0,150,0,150,40.674613,-73.942479,11213
813122,0,0,0,2,6,8,43.191135,-77.625497,14613
830171,0,0,0,71,0,71,42.909297,-76.851133,13165
780073,0,0,0,4,12,16,40.76421,-73.864038,11369
838880,0,0,15,34,0,49,40.674613,-73.942479,11213
73950,0,0,0,40,0,40,40.689187,-73.923725,11221
856744,0,0,0,0,12,12,40.847889,-73.934993,10033
879479,0,7,22,22,0,51,43.021573,-76.150055,13205
838081,0,0,0,2,6,8,42.758537,-73.747588,12110
65097,0,0,0,2,6,8,40.822013,-73.950168,10031
348922,0,0,0,2,12,14,40.81925,-73.866498,10473
471244,0,0,21,0,0,21,42.082037,-78.414806,14760
631513,0,0,0,4,12,16,40.613322,-74.086182,10304
878243,0,0,0,4,12,16,40.867413,-73.924974,10034
177220,0,0,0,12,0,12,40.760343,-73.980317,10020
854629,0,0,0,4,12,16,40.834353,-73.856406,10462
347012,0,0,0,4,12,16,40.80549,-72.849253,11950
871499,0,0,0,4,12,16,43.197123,-77.623533,14615
867774,32,45,92,0,0,169,42.665122,-73.701763,12144
158137,0,0,0,4,12,16,40.760717,-73.213309,11717
771043,0,0,0,40,0,40,43.258193,-75.460205,13440
45137,0,0,0,226,0,226,40.684937,-73.46596,11758
876211,0,0,46,0,0,46,42.835214,-73.917006,12308
393898,0,0,0,4,12,16,40.678566,-73.964692,11238
638640,0,0,0,260,0,260,40.59558,-73.975036,11223
754458,0,0,0,4,12,16,40.846495,-73.9082,10457
40873,0,0,0,150,0,150,43.150094,-76.213501,13090
772935,0,0,0,4,12,16,40.68232,-73.760953,11434
39593,0,0,29,0,0,29,43.789406,-75.494856,13367
793595,0,0,0,0,10,10,40.833628,-73.928808,10452
374765,16,12,104,24,0,156,43.128804,-77.697199,14624
317342,0,0,0,1,6,7,40.886269,-73.844871,10466
837421,0,0,0,4,12,16,40.629945,-73.9785,11204
106698,0,0,0,0,10,10,40.644871,-73.889622,11236
873481,0,0,0,4,12,16,40.80801,-73.923455,10454
41794,0,0,73,0,0,73,41.021342,-73.74016,10605
463264,0,0,0,4,12,16,40.91529,-73.858689,10704
786366,0,0,0,0,12,12,40.83033,-73.901184,10456
73297,0,0,0,52,0,52,40.685299,-73.910381,11207
560792,0,0,0,4,12,16,40.948454,-73.875818,10701
831310,0,0,0,2,6,8,43.134551,-77.691289,14624
791329,0,0,0,4,12,16,40.828257,-73.94144,10031
857888,0,0,0,60,0,60,40.837712,-73.88671,10460
587406,0,0,0,4,12,16,41.139135,-74.024008,10977
359629,0,0,0,4,12,16,40.845999,-73.911481,10453
42835,0,0,0,40,0,40,41.333972,-74.122308,10917
341325,0,0,0,4,12,16,40.652988,-73.910669,11236
246818,0,0,0,4,12,16,40.915088,-73.880398,10705
783949,0,0,0,4,12,16,40.887455,-73.905157,10463
877212,0,0,0,64,0,64,40.71587,-73.950449,11211
322396,0,0,0,4,12,16,40.703165,-73.700626,11003
43077,0,0,0,48,0,48,43.132009,-76.156469,13212
386867,0,0,0,4,12,16,40.826166,-73.946692,10031
418054,0,0,0,4,12,16,40.735186,-73.775136,11366
713111,0,0,0,4,12,16,40.7577,-73.875459,11369
553634,0,0,0,4,12,16,40.639604,-73.913835,11236
769655,0,0,0,4,12,16,40.850402,-73.905758,10453
523937,0,0,0,4,12,16,40.605131,-73.992681,11214
773648,0,0,0,2,6,8,43.192498,-77.605141,14621
648133,0,0,0,4,12,16,40.636216,-74.087323,10301
708000,0,0,0,300,0,300,40.669111,-73.867112,11208
391374,0,0,0,4,12,16,40.656787,-74.00066,11232
236718,36,33,57,102,0,228,43.096396,-77.573627,14623
31450,0,0,0,2,6,8,42.798363,-73.952806,12303
27143,0,0,0,4,12,16,43.265444,-77.702402,14612
695751,0,0,0,60,0,60,42.660282,-73.781914,12208
43809,8,11,32,0,0,51,42.882453,-78.872874,14203
867201,0,0,0,40,0,40,41.633561,-73.909352,12601
69398,0,0,0,2,5,7,40.60662,-73.749144,11691
762702,0,0,0,4,12,16,40.846713,-73.909483,10453
873875,0,0,0,4,12,16,40.667497,-73.91621,11212
777635,0,0,0,4,12,16,40.877149,-73.909284,10463
845346,8,10,16,10,0,44,42.810086,-73.989957,12306
697228,0,0,0,2,6,8,43.070656,-77.603407,14623
657489,0,0,0,4,12,16,40.842738,-73.919395,10452
354257,0,0,0,2,6,8,42.322261,-75.96542,13862
741448,0,0,0,4,12,16,43.140068,-77.63273,14611
379361,24,22,55,0,0,101,42.890025,-73.923018,12302
483172,0,0,0,4,12,16,43.06776,-75.604962,13461
557251,0,0,0,4,12,16,40.919657,-73.792063,10801
397430,0,0,0,4,12,16,40.819874,-73.954164,10031
56481,0,0,0,1,6,7,40.845047,-73.880675,10460
701219,0,0,155,0,0,155,40.744233,-73.252842,11706
783683,0,0,0,4,12,16,40.664344,-73.990105,11215
179896,0,0,0,4,12,16,41.725552,-73.854858,12603
805262,0,0,0,4,12,16,40.700765,-73.623239,11550
862283,0,0,0,20,0,20,40.837965,-73.906601,10456
54672,0,0,0,0,6,6,40.81122,-73.906285,10455
623069,0,0,0,4,12,16,40.684768,-73.768527,11434
730984,0,0,0,4,12,16,40.648633,-73.88307,11239
788859,0,0,0,2,6,8,40.67131,-73.886368,11207
691613,0,0,0,4,12,16,40.67289,-73.777196,11434
836920,0,10,72,0,0,82,40.927278,-73.794194,10801
541231,0,0,0,4,12,16,40.610025,-73.952549,11229
797588,8,24,0,0,0,32,42.447823,-76.502324,14850
39878,11,20,45,12,0,88,40.716502,-73.599466,11550
275294,0,0,0,4,12,16,40.828231,-73.940678,10031
325788,0,0,0,4,12,16,41.28897,-73.90945,10566
601208,0,12,16,0,0,28,43.074567,-76.017754,13116
350933,0,0,0,2,6,8,42.827275,-74.138905,12137
880135,0,0,0,4,12,16,40.662506,-73.990508,11215
73528,0,0,0,134,0,134,40.802381,-73.946854,10026
41051,0,0,0,100,0,100,40.719378,-73.560173,11554
190904,0,0,0,128,0,128,40.628286,-74.117064,10310
791661,0,0,0,4,12,16,40.835175,-73.924796,10452
698378,0,0,34,0,0,34,41.434226,-74.159814,10992
358265,0,0,0,4,12,16,43.167996,-76.576799,13033
40280,8,24,36,0,0,68,40.924839,-72.667623,11901
40783,16,22,35,21,0,94,42.739818,-78.878955,14075
868357,0,0,0,4,12,16,40.830097,-73.921286,10452
43657,0,20,137,0,0,157,40.985319,-73.765911,10583
221993,0,0,0,2,6,8,43.170251,-76.22376,13090
371840,0,0,0,4,12,16,43.22191383,-75.28919432,13469
825982,0,0,0,4,12,16,40.572338,-74.099215,10306
672473,0,0,0,2,12,14,40.854294,-73.917505,10453
357819,0,0,0,4,12,16,40.75495,-73.881292,11372
628258,0,0,0,4,12,16,40.858006,-73.897499,10458
756812,8,23,18,0,0,49,40.856544,-73.194598,11787
875339,0,0,0,2,6,8,42.692324,-73.576726,12140
343855,0,0,0,4,12,16,40.76969,-73.551029,11801
817044,0,0,0,4,12,16,40.788976,-73.074914,11741
44739,0,0,0,25,0,25,40.795489,-73.68608,11030
667242,0,0,0,4,12,16,40.826573,-73.880861,10472
866664,0,0,0,2,6,8,42.789543,-73.915119,12304
880120,0,0,0,2,10,12,40.824433,-73.911875,10451
72848,0,0,0,110,0,110,40.832785,-73.904721,10456
730404,0,0,0,50,0,50,44.577342,-75.109698,13617
139198,0,0,0,206,0,206,40.810223,-73.917872,10454
788389,0,0,0,4,12,16,40.850197,-73.91391,10453
755042,0,0,0,4,12,16,40.675717,-74.007816,11231
833938,0,0,0,2,12,14,40.856929,-73.902502,10453
610117,0,0,0,0,12,12,40.859913,-73.907287,10468
504681,0,0,0,4,12,16,43.207174,-77.608927,14617
769487,0,0,0,60,0,60,43.050027,-77.493148,14534
693761,0,0,0,2,6,8,43.339532,-75.998913,13044
781686,0,0,0,4,12,16,40.803193,-73.243584,11717
715922,0,0,0,4,12,16,40.663034,-73.98789,11215
362644,0,0,0,4,12,16,40.69677,-73.830499,11418
42180,0,0,17,0,0,17,44.010321,-76.03819,13634
164272,0,0,0,4,12,16,40.854144,-73.929308,10040
252756,0,0,0,2,12,14,40.830935,-73.922774,10452
44063,0,0,18,0,0,18,40.994483,-73.879009,10706
872107,0,0,0,0,10,10,43.172226,-77.614988,14605
599285,0,0,0,4,12,16,40.836006,-73.915806,10456
158689,0,0,0,2,6,8,40.796121,-73.961849,10025
328258,0,0,0,2,6,8,40.858932,-73.895991,10458
523234,0,0,0,4,12,16,40.667183,-73.984849,11215
535398,0,0,0,2,6,8,43.948946,-76.013321,13601
734970,0,0,0,60,0,60,40.676259,-73.754847,11413
545580,0,0,0,4,12,16,40.865541,-73.920224,10034
108994,0,0,0,2,5,7,42.193372,-76.814511,14845
792443,0,0,0,4,12,16,40.720704,-73.714894,11001
223515,0,0,0,135,0,135,40.810471,-73.948185,10027
296383,0,0,0,2,6,8,42.539251,-78.931685,14091
863671,0,0,0,4,12,16,41.063727,-73.808914,10523
155792,0,0,0,2,12,14,40.840878,-73.914067,10452
648835,0,0,0,2,6,8,43.178612,-78.694869,14094
318106,0,0,0,4,12,16,40.866555,-73.886905,10458
44973,16,55,50,0,0,121,40.817597,-72.682811,11977
856474,0,0,0,4,12,16,41.031216,-73.780421,10606
120320,0,0,0,4,12,16,41.135292,-74.044823,10977
815724,0,0,0,4,12,16,43.196981,-77.648557,14615
109718,0,12,30,0,0,42,41.738331,-74.090662,12561
529354,0,0,0,4,12,16,40.638958,-73.951392,11226
44896,24,42,48,28,0,142,43.007743,-78.69765,14051
796910,0,0,0,44,0,44,40.785379,-73.542691,11753
275921,0,0,0,0,8,8,40.692723,-73.583665,11553
261936,0,0,0,4,12,16,43.085459,-77.467277,14450
265249,0,0,0,2,6,8,43.079271,-75.270698,13501
867029,21,42,53,0,0,116,41.053285,-73.82315,10523
701683,0,0,0,75,0,75,40.753809,-73.67328,11040
205735,0,0,0,2,12,14,40.805396,-73.957315,10026
709678,0,0,0,84,0,84,40.694691,-73.937537,11206
40587,0,0,137,0,0,137,40.946974,-73.79688,10804
42625,0,10,46,0,0,56,40.983216,-73.807424,10583
877043,0,0,0,4,12,16,40.722592,-73.812826,11367
836702,0,0,0,0,12,12,40.85055,-73.919557,10453
551131,8,12,66,0,0,86,41.210778,-73.985415,10993
461585,0,0,0,4,12,16,40.703076,-73.602598,11550
249508,0,0,0,4,12,16,40.68598,-73.817828,11419
720387,0,0,0,4,12,16,40.624577,-74.081784,10304
547344,0,0,0,2,12,14,40.843171,-73.883786,10460
72818,0,0,0,38,0,38,40.842515,-73.941947,10032
112137,0,0,0,201,0,201,40.62181,-73.987247,11204
849148,0,0,0,4,12,16,41.115571,-74.065654,10952
666695,12,0,31,16,0,59,42.839941,-78.781918,14224
43098,16,12,55,122,0,205,43.122258,-77.801136,14514
709806,0,0,0,214,0,214,40.880834,-73.860653,10467
764691,0,0,0,4,12,16,40.702971,-73.605877,11550
605875,0,0,0,4,12,16,40.690526,-73.855393,11421
652232,0,0,0,2,6,8,42.335063,-77.288863,14810
723858,0,0,0,4,12,16,40.868219,-73.924345,10034
443215,0,0,0,4,12,16,43.146773,-75.270451,13403
241073,0,0,0,4,12,16,40.628722,-73.934898,11210
517416,0,0,0,2,12,14,40.870041,-73.898766,10468
810198,8,12,25,0,0,45,40.703194,-73.322324,11702
573770,0,0,0,4,12,16,40.89332,-73.856672,10466
711402,0,0,0,4,12,16,42.782001,-77.651084,14487
508593,0,0,0,4,12,16,40.668867,-73.88704,11207
822028,0,0,0,60,0,60,40.832363,-73.885297,10460
868787,0,0,0,0,5,5,40.834025,-73.884284,10460
114298,0,0,0,87,0,87,41.089458,-73.919262,10960
40464,0,0,0,25,0,25,43.410852,-73.700555,12845
366082,0,0,0,0,6,6,40.583502,-73.956966,11235
766596,0,0,0,15,0,15,40.671162,-73.882389,11208
845251,0,0,0,4,12,16,40.868525,-73.863547,10467
762430,0,0,0,4,12,16,40.823515,-73.897583,10459
793149,0,0,0,2,6,8,40.81841,-73.922468,10451
870259,0,0,0,0,11,11,40.864318,-73.902239,10468
562844,0,0,0,4,12,16,40.693702,-73.590321,11553
694582,0,0,0,4,12,16,40.842785,-73.912425,10452
257942,0,0,0,2,6,8,40.697521,-73.60622,11550
879797,0,0,0,4,12,16,40.665499,-73.957119,11225
410829,0,0,0,4,12,16,40.9608,-72.2725,11962
599829,0,0,0,2,12,14,40.84077,-73.914144,10452
853090,0,0,0,4,12,16,43.07401,-76.159873,13208
252770,0,0,0,2,6,8,43.137389,-76.30965,13027
776862,0,18,39,0,0,57,40.664216,-73.609507,11510
669976,0,0,0,4,12,16,40.866938,-73.920484,10034
846058,0,0,0,4,12,16,41.138489,-74.057448,10977
865485,0,0,0,4,12,16,40.789853,-73.807341,11357
643272,0,0,0,4,12,16,40.640241,-73.990507,11219
51742,0,0,0,2,5,7,40.800784,-73.959716,10025
882277,0,0,0,2,6,8,41.16947,-73.849106,10562
779661,0,0,0,4,12,16,40.951243,-73.870437,10701
744771,0,0,0,40,0,40,40.718193,-73.97541,10002
396803,0,0,0,2,6,8,41.704234,-73.915881,12601
840661,0,0,0,2,6,8,43.195032,-77.612025,14621
204071,0,0,0,2,6,8,43.120108,-77.780631,14624
62634,0,0,0,2,6,8,40.663381,-73.868146,11208
677504,0,0,0,4,12,16,40.671835,-73.98513,11215
880444,0,0,0,2,6,8,41.133976,-74.019128,10956
848896,0,0,0,2,6,8,43.071749,-76.082477,13057
783152,0,0,0,4,12,16,40.873999,-73.845987,10469
863038,0,0,0,4,12,16,42.940556,-78.783717,14225
263822,0,0,0,2,6,8,40.900165,-73.835494,10550
709712,0,0,0,119,0,119,40.758373,-73.8747,11369
43929,0,8,44,0,0,52,42.963372,-78.780944,14226
439115,0,0,0,4,12,16,40.802202,-73.256141,11717
786931,0,0,0,4,12,16,40.79596,-73.247696,11717
818742,0,0,0,4,12,16,40.666613,-73.878468,11208
871411,0,0,0,4,12,16,40.813082,-73.856021,10473
839053,0,9,26,0,0,35,40.705002,-73.564451,11554
688023,0,0,0,4,12,16,40.756493,-73.8262,11355
229725,0,0,0,4,12,16,42.854696,-78.655233,14059
718040,0,0,0,4,12,16,40.852003,-73.912131,10453
821346,0,0,0,0,6,6,40.671085,-73.925935,11213
601986,0,0,0,2,12,14,40.838474,-73.914341,10452
675832,0,0,0,4,12,16,40.959434,-73.883944,10703
651055,0,0,0,2,6,8,40.719966,-73.613904,11550
43464,0,12,0,0,0,12,44.719957,-73.389812,12901
835712,0,0,0,4,12,16,42.972366,-74.172866,12010
794282,0,0,0,2,6,8,43.087799,-75.237521,13501
43877,8,36,71,0,0,115,40.930542,-73.073943,11777
243204,0,0,0,301,0,301,40.610667,-74.013297,11228
596488,16,11,12,7,0,46,42.149374,-76.927,14814
585496,0,0,0,2,6,8,40.876132,-73.832283,10475
737529,0,0,0,4,12,16,40.721589,-73.851951,11375
617459,0,0,0,4,12,16,40.840228,-73.922587,10452
137865,0,0,0,75,0,75,40.749672,-73.108303,11716
830041,0,0,0,2,6,8,40.851819,-73.914369,10453
44693,0,0,0,100,0,100,42.465923,-76.488642,14850
857402,0,0,0,4,12,16,40.607195,-74.13507,10314
288814,0,0,0,4,12,16,40.853408,-73.929102,10040
480288,8,20,10,6,0,44,41.74925,-74.086722,12561
388926,0,0,0,4,12,16,40.700846,-73.783545,11433
446483,0,0,0,4,12,16,40.776691,-73.840993,11356
781848,0,12,82,0,0,94,40.733521,-73.210257,11751
121445,0,0,0,4,12,16,40.662558,-73.985373,11215
869218,0,0,0,60,0,60,43.33231,-76.428939,13069
873615,0,0,0,4,12,16,40.867927,-73.923884,10034
432062,0,0,0,2,12,14,40.679039,-73.799551,11436
40959,0,41,128,50,0,219,40.730922,-73.449993,11735
824324,0,0,18,26,0,44,42.72542,-78.816758,14075
42849,0,0,0,262,0,262,43.107378,-77.491429,14445
39206,0,0,54,0,0,54,42.642517,-73.758634,12202
458373,0,0,0,206,0,206,40.697622,-73.629183,11550
848645,0,0,0,112,0,112,40.765473,-73.828457,11354
769224,8,12,46,30,0,96,43.178587,-77.681268,14606
241726,0,0,16,0,0,16,43.322091,-78.03699,14476
72419,0,0,0,4,12,16,40.668697,-73.953539,11225
860107,0,0,0,4,12,16,40.71323,-73.855833,11375
1128,0,0,0,2,6,8,43.933904,-75.592856,13619
787764,16,24,38,0,0,78,40.778169,-73.105615,11716
73506,0,0,0,218,0,218,40.71873,-73.998443,10013
818721,0,0,0,4,12,16,40.670281,-73.911577,11212
759184,0,0,0,29,0,29,40.740884,-73.880045,11373
241912,0,0,0,4,12,16,41.522694,-74.030667,12550
860160,0,0,0,4,12,16,40.79239,-73.968103,10025
806827,0,0,0,4,12,16,40.869619,-73.83634,10469
445027,0,0,0,4,12,16,40.674358,-74.00341,11231
808996,0,0,0,40,0,40,41.615693,-74.075631,12589
71508,0,0,0,0,12,12,40.704367,-73.728874,11429
465087,0,0,0,4,12,16,40.728456,-73.509304,11756
659280,0,0,0,4,12,16,43.168014,-77.566302,14609
488860,0,0,0,4,12,16,40.842602,-73.888631,10460
794959,0,0,0,4,12,16,40.774718,-73.215856,11717
766958,0,0,0,4,12,16,40.840291,-73.925018,10452
43726,8,12,371,0,0,391,40.816762,-72.948947,11980
24254,0,0,0,4,12,16,43.047736,-76.10609,13224
870295,0,0,0,52,0,52,40.748594,-73.86023,11368
223043,0,0,0,4,12,16,40.716983,-73.356785,11704
274911,0,0,0,1,6,7,40.819795,-73.90332,10459
574971,0,0,0,4,12,16,40.652371,-73.734002,11422
766850,0,0,0,4,12,16,40.667147,-73.699627,11580
409108,0,0,0,2,10,12,40.660226,-73.934441,11203
840493,0,0,0,2,6,8,40.621673,-74.084295,10304
744316,0,0,0,4,12,16,44.707393,-73.471472,12901
100047,0,0,0,2,12,14,40.835352,-73.913497,10456
830623,0,0,0,60,0,60,43.135442,-78.693432,14094
351453,0,27,90,0,0,117,41.19961,-73.728254,10549
850611,0,0,0,0,12,12,40.711531,-73.814573,11435
565134,0,0,0,4,12,16,40.834435,-73.920722,10452
788466,8,20,30,30,0,88,43.254838,-73.663328,12828
72841,0,0,0,240,0,240,40.856695,-73.859834,10461
828831,0,0,0,4,12,16,40.650306,-73.978246,11218
43051,8,23,28,28,0,87,42.991208,-77.638258,14543
332255,0,0,0,4,12,16,40.6748,-73.602823,11510
596935,0,0,0,4,12,16,40.694098,-73.901369,11385
378468,0,0,0,4,12,16,40.886343,-73.863252,10467
804643,0,0,0,4,12,16,40.616833,-74.082139,10304
39045,0,0,0,2,6,8,42.174396,-76.849511,14845
125310,0,0,19,0,0,19,42.337955,-77.328685,14810
314276,0,0,0,4,12,16,41.661565,-73.90983,12603
244213,0,0,0,366,0,366,40.85324,-73.933932,10033
876385,0,0,0,4,12,16,40.689033,-73.853389,11421
841468,0,0,0,70,0,70,40.822783,-73.079409,11741
233597,0,0,0,2,12,14,40.682113,-73.80714,11420
827096,0,0,0,40,0,40,42.53032,-78.473842,14173
8364,0,0,0,2,6,8,42.764867,-73.780109,12110
846018,0,0,0,4,12,16,40.665379,-73.903594,11212
44022,8,12,58,58,0,136,44.991478,-73.367325,12979
743069,8,12,64,17,0,101,41.517145,-73.689386,12531
244133,0,0,0,134,0,134,40.641065,-73.965579,11226
500783,0,0,0,2,6,8,40.849647,-73.904739,10457
860572,0,0,0,4,12,16,43.18295,-75.159357,13502
104441,0,0,0,4,12,16,40.644093,-74.09953,10301
872048,0,0,0,4,12,16,43.162059,-77.658424,14606
629325,0,0,0,2,12,14,40.862344,-73.907711,10468
408670,0,0,0,4,12,16,40.684238,-73.961137,11238
850068,0,0,0,303,0,303,44.630793,-74.812103,13672
37296,0,0,0,4,12,16,44.623079,-73.534996,12901
853989,0,0,0,4,12,16,40.864216,-73.920566,10034
637104,16,24,51,40,0,131,42.28648,-73.737583,12172
849172,0,0,0,4,12,16,43.18268,-77.581564,14621
254186,0,0,0,4,12,16,40.674098,-73.8185,11420
226793,0,0,0,4,12,16,40.760364,-73.864961,11369
345909,0,0,0,4,12,16,40.827568,-73.875925,10472
22084,0,0,0,4,12,16,43.229095,-77.702591,14626
709680,0,0,0,150,0,150,40.8291,-73.856909,10472
853563,0,0,0,2,6,8,40.609613,-73.758344,11691
795608,0,0,0,2,6,8,40.848736,-73.912899,10453
750376,0,0,0,4,12,16,40.647988,-73.588347,11520
627018,0,9,50,0,0,59,40.883705,-73.388104,11721
812071,0,0,0,120,0,120,40.838123,-73.853405,10462
739341,0,0,0,0,10,10,40.876167,-73.902771,10463
853455,0,0,0,4,12,16,40.66368,-73.913321,11212
395857,0,0,0,4,12,16,40.827643,-73.888104,10459
275819,0,0,0,62,0,62,40.508957,-74.243822,10307
881587,0,0,0,120,0,120,42.161861,-78.39444,14743
566332,0,0,0,4,12,16,40.87619,-73.911527,10463
618954,0,0,0,4,12,16,43.029148,-76.149681,13205
354999,0,0,0,4,12,16,40.760287,-73.931662,11106
852576,0,0,0,40,0,40,41.717956,-74.389947,12428
668933,0,0,0,2,6,8,42.064391,-79.202991,14701
487209,0,0,0,2,6,8,40.830677,-73.874701,10472
882841,0,0,0,4,12,16,40.846989,-73.857396,10462
649418,0,0,0,4,12,16,40.637984,-73.997303,11219
272455,0,0,0,4,12,16,40.882407,-73.859516,10467
842333,0,0,0,60,0,60,42.394608,-77.690093,14807
494600,0,0,0,0,12,12,40.836821,-73.915875,10452
875966,0,0,0,92,0,92,40.842601,-73.916238,10452
864525,0,0,0,0,12,12,40.836084,-73.914562,10456
846879,0,0,0,4,12,16,40.845386,-73.091705,11720
773193,0,0,0,2,12,14,40.869096,-73.892464,10468
709728,0,0,0,145,0,145,40.691171,-73.933512,11221
787551,23,17,127,0,0,167,40.656248,-73.675111,11563
871170,0,0,0,4,12,16,43.18637,-77.643718,14613
525459,0,0,0,0,12,12,40.676015,-73.763239,11434
40350,0,0,0,60,0,60,40.830145,-73.246765,11787
822565,0,0,0,4,12,16,40.684015,-73.868357,11208
709638,0,0,0,226,0,226,40.703718,-73.953214,11206
873138,0,0,0,4,12,16,40.831614,-73.921635,10452
689572,0,0,0,38,0,38,40.798143,-73.932154,10035
622414,0,0,0,4,12,16,40.864275,-73.896943,10468
347339,0,0,0,4,12,16,40.676789,-73.821634,11420
801181,0,0,0,4,12,16,41.00549,-73.681797,10573
19615,0,0,0,2,6,8,42.0864,-79.223202,14701
42094,8,24,92,0,0,124,40.672847,-73.484622,11783
793241,0,0,0,4,12,16,40.710574,-73.586917,11553
385421,0,0,0,4,12,16,40.604844,-73.913091,11234
720367,0,0,0,2,6,8,42.137509,-79.118033,14747
372817,0,0,0,120,0,120,40.850017,-73.892038,10457
292924,0,0,0,4,12,16,40.681111,-73.596682,11575
700471,0,0,0,4,12,16,40.849079,-73.886325,10457
793459,0,0,0,4,12,16,40.711291,-73.613922,11550
40437,22,58,105,80,0,265,42.477902,-76.466197,14850
821494,0,0,0,4,12,16,40.834519,-73.912482,10456
796215,0,0,63,0,0,63,41.03619,-73.759097,10601
867001,0,0,0,56,0,56,42.124865,-77.961838,14895
108215,0,0,0,4,12,16,40.628526,-73.898975,11236
375599,0,0,0,2,12,14,40.830935,-73.922774,10452
839564,0,0,0,4,12,16,41.734052,-73.566242,12522
650568,0,0,0,4,12,16,40.757335,-73.857486,11368
41330,16,58,72,0,0,146,40.801416,-73.111181,11779
866974,0,0,0,4,12,16,40.654546,-73.974001,11218
829694,0,0,0,4,12,16,42.888592,-73.87663,12019
721599,0,0,0,2,6,8,43.074943,-75.755997,13032
396824,0,0,0,4,12,16,40.858832,-73.901322,10468
737000,0,0,0,2,6,8,44.63656,-73.488832,12901
39330,0,0,20,0,0,20,42.470214,-74.84698,13740
546897,0,0,0,4,12,16,40.826069,-73.904813,10456
757349,0,0,0,95,0,95,40.916119,-73.903872,10705
607682,0,0,0,300,0,300,40.691699,-73.848603,11421
43923,0,0,0,140,0,140,41.005037,-73.753571,10605
878365,0,0,0,160,0,160,40.792005,-73.95131,10029
876815,0,0,0,4,12,16,40.754671,-73.779517,11361
806271,0,0,0,2,6,8,40.813894,-73.958848,10027
184006,0,0,0,4,12,16,41.154903,-73.945872,10920
321757,8,12,35,17,0,72,42.110012,-75.904408,13901
864107,0,0,0,4,12,16,40.845008,-73.859378,10462
801831,0,0,0,4,12,16,40.831049,-73.921684,10452
874726,0,0,0,4,12,16,40.713997,-73.616281,11550
286168,0,0,0,2,5,7,40.685957,-73.876603,11208
39825,0,0,0,157,0,157,40.685325,-73.566458,11566
861204,0,0,0,2,6,8,41.226462,-74.284759,10925
714239,0,0,0,4,12,16,40.638469,-73.986958,11219
861135,0,0,0,2,6,8,40.651889,-73.88496,11239
652023,0,0,0,4,12,16,40.674026,-73.609204,11510
772950,0,0,0,40,0,40,41.49482,-73.971254,12508
874464,0,0,0,4,12,16,40.664825,-73.606129,11510
737749,0,0,0,4,12,16,40.822727,-73.914406,10451
843250,0,0,0,4,12,16,40.64796,-73.579459,11520
584553,0,0,0,2,6,8,40.666438,-73.870066,11208
582649,0,0,0,66,0,66,40.826771,-73.274655,11725
266149,0,0,36,0,0,36,44.701583,-73.454666,12901
633506,0,0,105,24,0,129,40.88527,-73.386543,11721
42935,0,24,152,101,0,277,40.718469,-73.252859,11706
270554,0,0,0,2,6,8,44.541758,-75.132353,13617
771745,0,0,0,0,10,10,40.635,-74.155177,10303
281508,0,0,0,2,5,7,42.088423,-76.820661,14905
835652,0,0,0,2,6,8,40.717367,-73.988462,10002
657626,0,0,0,0,10,10,40.874426,-73.90276,10463
882082,0,0,0,4,12,16,40.881534,-73.884302,10467
273207,0,0,0,4,12,16,40.682846,-74.00067,11231
267238,8,36,57,0,0,101,42.656675,-73.731416,12144
869596,0,0,0,0,12,12,40.84837,-73.918812,10453
847314,0,0,0,56,0,56,42.103628,-77.242715,14801
882823,0,0,0,2,6,8,43.221129,-77.637314,14616
483857,0,0,0,4,12,16,40.661779,-73.907538,11212
496871,0,0,0,2,6,8,40.815031,-73.935729,10037
41923,0,0,0,50,0,50,42.988912,-76.341265,13108
66956,0,0,0,2,6,8,40.861817,-73.929833,10040
412198,0,12,123,112,0,247,40.918669,-73.828152,10552
16226,0,0,0,4,12,16,42.941126,-78.815903,14215
35013,0,0,0,2,5,7,42.146614,-76.761034,14845
827299,0,0,0,177,0,177,40.665223,-73.811415,11420
73238,0,0,0,124,0,124,40.70074,-73.917659,11237
800846,0,0,0,4,12,16,40.854134,-73.905994,10453
462627,0,0,0,2,12,14,40.880094,-73.88348,10467
39697,0,0,72,25,0,97,43.15152,-77.619276,14608
414938,0,0,0,150,0,150,40.697792,-73.919534,11237
871150,0,0,0,2,12,14,40.857993,-73.896817,10458
880913,0,0,0,0,10,10,40.86226,-73.929093,10040
664001,0,0,0,4,12,16,40.6054,-73.75888,11691
828525,0,0,0,2,6,8,40.956409,-73.883621,10703
217639,0,0,0,87,0,87,40.715952,-74.011284,10007
774310,0,0,0,4,12,16,40.906694,-73.817553,10553
72395,0,0,0,4,12,16,40.633533,-73.958147,11230
418406,16,46,82,6,0,150,41.208418,-73.88349,10520
249410,0,0,0,180,0,180,40.63257,-74.009529,11220
101462,0,0,0,329,0,329,40.72417,-73.981253,10009
377105,0,0,0,0,6,6,40.823997,-73.913711,10451
877538,0,0,0,4,12,16,42.767822,-73.67492,12182
389215,0,24,62,0,0,86,40.763341,-73.602292,11568
705826,0,0,0,4,12,16,42.935913,-78.83697,14214
42237,0,0,0,44,0,44,42.884613,-78.849293,14206
631784,0,0,0,2,6,8,43.433425,-76.365413,13126
785121,0,0,0,30,0,30,40.634905,-74.111479,10310
814565,0,0,0,4,12,16,40.831205,-73.863213,10472
460266,0,0,0,4,12,16,40.881513,-73.898039,10463
620784,0,0,0,180,0,180,40.818653,-73.868439,10473
52235,0,0,0,2,6,8,40.765608,-73.990905,10019
761583,0,0,0,4,12,16,40.708378,-73.734206,11429
44162,8,12,0,0,0,20,42.476472,-76.482126,14850
357324,0,0,0,2,12,14,40.654079,-73.940498,11203
838290,0,0,0,4,12,16,40.824791,-73.881393,10472
277150,0,0,0,2,6,8,40.954644,-73.869483,10701
376889,0,0,0,250,0,250,40.858741,-73.895014,10458
504157,0,0,0,2,12,14,40.83423,-73.927444,10452
712944,0,0,0,0,7,7,40.855378,-73.930369,10040
816789,0,0,0,4,12,16,40.836803,-73.942058,10032
792434,0,0,0,4,12,16,40.759335,-73.586235,11590
735589,0,0,23,0,0,23,41.720714,-74.388522,12428
303863,0,0,0,4,12,16,40.712023,-73.673201,11010
844620,0,0,0,4,12,16,43.141374,-77.642123,14619
256306,0,0,0,4,12,16,40.667456,-73.891616,11207
43188,0,0,0,20,0,20,42.438796,-75.604763,13830
444082,0,0,0,2,12,14,40.74171,-73.900576,11377
797978,0,0,0,2,6,8,43.106535,-79.038933,14305
43597,0,0,124,0,0,124,40.916839,-73.905249,10705
880660,0,0,0,37,0,37,40.703709,-73.76874,11412
415990,0,0,0,2,6,8,40.815268,-73.924222,10451
795526,0,0,0,0,12,12,40.81879,-73.906632,10456
802310,0,0,0,4,12,16,42.930725,-78.799236,14215
719140,0,0,0,4,12,16,40.826528,-73.914782,10451
872465,0,0,0,4,12,16,44.01323,-75.882356,13616
143846,0,0,0,40,0,40,41.414419,-74.325244,10924
306259,14,22,35,40,0,111,42.934941,-78.81384,14215
538221,8,29,14,20,0,71,43.2346,-78.202494,14411
520753,0,0,0,4,12,16,44.080496,-75.826834,13637
732221,0,0,0,40,0,40,40.946673,-73.84132,10708
868029,0,0,0,4,12,16,40.633773,-73.638572,11572
39781,0,12,28,0,0,40,43.018587,-74.190726,12010
654066,0,0,0,44,0,44,42.96183,-78.718146,14221
681311,15,12,36,22,0,85,43.036729,-78.860806,14120
862020,0,0,0,220,0,220,40.830296,-73.906384,10456
881809,0,0,0,4,12,16,41.151956,-74.049004,10977
754980,0,0,0,4,12,16,40.666718,-73.733083,11422
771136,0,0,0,4,12,16,40.673338,-73.934922,11213
831273,0,0,0,4,12,16,40.652865,-73.706041,11581
56512,0,0,0,2,6,8,40.878775,-73.902099,10463
524933,0,0,0,2,6,8,42.65054,-75.005609,13807
491652,0,0,0,4,12,16,40.905459,-73.850329,10470
709749,0,0,0,149,0,149,40.6726,-73.928257,11213
866326,0,0,0,4,12,16,40.818659,-73.815548,10465
742058,0,0,0,4,12,16,42.831003,-73.919984,12308
619965,0,0,0,2,6,8,40.8139,-73.922088,10451
17615,0,0,0,2,6,8,43.22438,-77.545898,14622
137421,0,0,0,4,12,16,40.727539,-73.827143,11367
134087,0,0,0,4,12,16,40.88651,-72.991005,11727
673361,0,0,0,186,0,186,40.676172,-73.880223,11208
413194,0,0,0,4,12,16,40.634304,-73.969278,11218
74167,0,0,0,157,0,157,40.724227,-73.986279,10009
373706,0,0,0,4,12,16,42.681913,-78.870784,14057
607931,0,0,0,120,0,120,40.800028,-73.937359,10035
266092,0,0,0,20,0,20,43.552886,-73.656924,12814
451060,0,0,0,4,12,16,40.690405,-73.855659,11421
803769,0,0,0,4,12,16,41.742205,-73.562728,12522
839709,0,0,0,4,12,16,40.75788,-73.581825,11590
767021,24,60,72,0,0,156,40.860623,-73.31924,11731
792948,0,0,0,4,12,16,40.653516,-73.592167,11520
282054,0,0,0,2,6,8,43.030338,-76.11146,13210
744960,0,0,0,0,10,10,40.826111,-73.868422,10472
35664,0,0,0,4,12,16,41.154505,-74.073869,10952
510811,0,0,0,4,12,16,40.847081,-73.938407,10033
846895,0,0,0,133,0,133,40.769581,-73.78387,11361
826532,0,0,0,4,12,16,43.062064,-76.09816,13206
629029,0,0,0,65,0,65,40.800877,-73.939368,10035
364348,0,0,0,4,12,16,40.841421,-73.92363,10452
844994,0,0,0,2,12,14,40.879705,-73.905235,10463
822915,0,0,0,60,0,60,40.697432,-73.36517,11757
809062,0,0,11,20,0,31,42.144185,-77.064298,14830
807095,0,0,0,4,12,16,40.670735,-73.876566,11208
540312,0,0,0,4,12,16,40.693305,-73.995298,11201
525415,0,0,0,22,0,22,40.651138,-73.940223,11226
45155,24,53,61,0,0,138,43.176929,-76.250819,13090
584466,0,0,0,4,12,16,42.107545,-79.229275,14701
875431,0,0,0,4,12,16,40.913856,-73.841196,10550
831827,0,0,0,4,12,16,40.917471,-73.895289,10705
42528,0,0,0,50,0,50,40.858276,-73.176908,11787
11312,0,0,0,2,6,8,40.702994,-73.609441,11550
736322,0,0,0,4,12,16,40.72006,-73.99546,10013
344447,0,0,0,0,10,10,40.701473,-73.761174,11412
831725,0,0,0,2,6,8,40.805833,-73.727471,11023
317318,0,0,0,4,12,16,40.863019,-73.898841,10468
608863,0,0,44,0,0,44,42.461786,-75.015663,13820
704224,0,0,0,4,12,16,40.690942,-73.791641,11433
751513,0,0,0,4,12,16,40.814331,-73.908838,10455
40119,0,0,0,80,0,80,41.354112,-73.870427,10579
603396,0,0,0,4,12,16,40.94797,-73.86618,10701
266764,0,0,0,50,0,50,44.663072,-73.732329,12981
41095,0,60,111,0,0,171,40.857102,-73.713228,11050
778182,0,0,0,4,12,16,40.819277,-73.903443,10459
744832,8,24,32,29,0,93,43.164764,-77.637411,14606
228977,0,0,0,2,12,14,40.842789,-73.906474,10457
477467,26,36,54,0,0,116,40.71869,-73.583285,11556
687064,0,0,0,2,6,8,40.632883,-73.64782,11572
287295,0,0,0,2,12,14,40.814957,-73.865146,10473
649627,0,0,0,4,12,16,40.647157,-73.973232,11218
713891,0,0,0,2,6,8,41.698385,-73.923959,12601
878489,0,0,0,4,12,16,40.850216,-73.885999,10457
530321,0,0,0,55,0,55,42.805611,-73.893929,12309
842280,0,0,0,0,12,12,40.842739,-73.893927,10457
696478,0,0,0,4,12,16,40.845382,-73.920288,10452
252044,0,0,0,4,12,16,40.677473,-73.997181,11231
822810,0,0,0,0,12,12,40.846935,-73.917858,10453
44269,15,21,35,35,0,106,41.394979,-74.713246,12771
759522,0,0,0,48,0,48,40.667689,-73.908999,11212
274506,0,0,0,4,12,16,40.879676,-73.868162,10467
875994,0,0,0,4,12,16,40.755344,-73.882307,11372
469187,0,0,0,4,12,16,40.843356,-73.941919,10032
765562,0,0,0,4,12,16,43.047141,-76.076011,13214
877119,0,0,0,4,12,16,40.712073,-73.741835,11429
855344,0,0,0,100,0,100,43.971736,-75.883325,13601
401574,0,0,0,2,10,12,40.670538,-73.863876,11208
852385,0,0,0,70,0,70,40.784563,-73.003317,11772
881927,0,0,0,2,6,8,42.806193,-73.906738,12309
24810,0,0,0,2,6,8,42.940831,-78.834338,14214
72004,0,0,0,0,10,10,40.853095,-73.861309,10462
40023,16,16,160,0,0,192,43.034121,-76.159895,13204
431888,0,0,0,4,12,16,43.190723,-77.643266,14613
864124,0,0,0,4,12,16,42.123603,-75.677718,13865
638469,0,0,0,4,12,16,40.847918,-73.910151,10453
616887,0,0,0,4,12,16,40.692257,-73.945154,11221
856473,0,0,0,4,12,16,40.690441,-73.938669,11221
352597,0,0,0,2,6,8,43.184886,-77.594426,14621
690043,0,0,0,4,12,16,40.856535,-73.905818,10453
40679,16,24,22,0,0,62,42.250628,-73.763833,12534
692088,0,0,0,0,10,10,40.812238,-73.920944,10454
669075,0,0,0,4,12,16,40.814409,-73.909533,10455
353845,16,20,71,20,0,127,43.045408,-77.657626,14467
852136,0,0,0,4,12,16,40.807031,-73.926218,10454
833345,0,0,0,4,12,16,42.666495,-74.748242,12197
255449,0,0,0,120,0,120,40.613709,-73.938692,11234
729724,0,0,0,51,0,51,40.879967,-73.451693,11724
880368,0,0,0,2,6,8,43.186964,-77.613438,14621
854276,0,0,0,18,0,18,40.723002,-73.953556,11222
799253,0,0,0,4,12,16,43.068526,-75.233277,13413
823844,0,0,0,4,12,16,40.839387,-73.912974,10456
600741,0,0,0,4,12,16,40.849636,-73.88399,10460
341383,0,0,0,4,12,16,40.626254,-74.024625,11209
797422,0,0,0,0,10,10,40.852138,-73.889216,10457
766040,0,59,148,0,0,207,40.619026,-73.727235,11559
664421,0,0,0,4,12,16,40.841634,-73.926391,10452
42303,0,0,0,25,0,25,43.050919,-76.558351,13166
40741,0,28,69,0,0,97,40.640683,-73.675612,11518
774315,0,0,0,124,0,124,40.667014,-73.907986,11212
612789,0,0,0,4,12,16,40.606922,-73.964865,11223
766593,0,0,0,4,12,16,40.687918,-73.727092,11411
867626,0,0,0,4,12,16,40.820713,-73.893996,10459
211235,16,36,60,0,0,112,40.93485,-73.036046,11766
823507,0,0,0,151,0,151,40.805165,-72.764545,11940
43564,8,22,35,0,0,65,42.966147,-78.721294,14221
39713,8,24,25,18,0,75,43.148166,-77.454958,14526
778662,0,0,0,4,12,16,40.662395,-73.99335,11232
841052,0,0,0,4,12,16,40.702596,-73.910128,11385
431647,0,0,0,4,12,16,40.858923,-73.901548,10468
418031,8,12,17,12,0,49,42.919765,-78.731347,14043
71453,0,0,0,4,12,16,40.656142,-73.727822,11422
322239,0,0,0,0,10,10,40.871058,-73.900508,10468
193426,0,0,0,4,12,16,40.657779,-73.922726,11212
864729,16,36,39,40,0,131,42.722421,-73.826073,12205
216799,0,0,0,4,12,16,40.882529,-73.26187,11754
580786,0,0,0,4,12,16,40.854684,-73.861258,10462
474607,0,0,0,4,12,16,40.680565,-73.993092,11231
446675,0,0,0,236,0,236,40.851575,-73.914618,10453
151915,0,0,0,4,12,16,40.636875,-73.947285,11210
548617,0,0,0,4,12,16,41.640086,-73.922333,12601
861054,0,0,0,4,12,16,40.759823,-73.878361,11369
561478,0,0,0,221,0,221,40.72814,-73.863265,11374
616718,0,0,0,2,12,14,40.814054,-73.914259,10455
794132,0,0,0,4,12,16,44.715453,-73.406286,12901
502439,0,0,0,4,12,16,43.02748,-78.870265,14120
858972,0,0,0,2,6,8,42.068724,-76.8105,14904
549472,0,0,0,2,6,8,42.075855,-78.440106,14760
744093,0,0,0,4,12,16,40.849203,-73.260882,11725
40565,0,12,35,0,0,47,40.930366,-73.78461,10804
830047,24,36,54,33,0,147,41.294499,-73.8965,10566
873786,0,0,0,2,6,8,42.903646,-77.749546,14414
865639,0,0,0,4,12,16,40.878376,-73.873474,10467
71299,0,0,0,4,12,16,40.64505,-73.94337,11203
149356,0,0,0,2,6,8,41.82293,-74.713795,12754
171674,0,0,0,40,0,40,43.029019,-74.989633,13350
878697,0,0,0,80,0,80,40.648141,-73.951784,11226
873981,0,0,0,0,12,12,40.879198,-73.875951,10467
178649,0,0,0,4,12,16,43.069379,-76.144815,13208
39950,16,10,26,15,0,67,43.089048,-75.189531,13501
118709,16,40,36,0,0,92,42.679432,-74.48255,12043
838658,0,0,0,4,12,16,42.775354,-73.78709,12110
825431,0,0,0,112,0,112,40.714738,-73.945992,11211
867906,0,0,0,22,0,22,40.688258,-73.795531,11435
429742,0,0,0,2,12,14,40.833706,-73.931006,10452
40545,16,21,169,27,0,233,41.04434,-73.797631,10607
404356,0,0,0,4,12,16,40.707525,-73.834449,11415
786493,0,0,0,4,12,16,40.834262,-73.901218,10456
759389,0,0,0,4,12,16,40.83765,-73.940201,10032
73474,0,0,0,58,0,58,40.83357,-73.940223,10032
443272,0,0,0,2,12,14,43.0345,-76.179353,13204
597113,0,0,0,2,6,8,40.814758,-73.900835,10455
591944,0,0,0,4,12,16,40.767567,-73.562069,11590
473941,0,0,0,4,12,16,40.629554,-73.944885,11210
768789,8,12,0,0,0,20,41.548357,-73.861781,12524
772736,0,0,0,4,12,16,42.726071,-73.704313,12189
102793,0,0,0,2,6,8,40.63905,-73.95767,11226
653248,0,0,0,4,12,16,42.969116,-76.444742,13152
870057,0,0,0,4,12,16,40.721012,-73.814385,11367
39782,0,0,147,0,0,147,42.927318,-74.149178,12010
779279,0,0,0,61,0,61,40.737946,-73.997851,10011
544454,0,0,0,4,12,16,43.168259,-77.644809,14606
232605,0,0,0,4,12,16,40.869793,-73.891889,10468
268633,0,0,0,2,6,8,42.666935,-73.770912,12206
790360,0,0,0,4,12,16,40.812469,-73.956273,10027
689591,0,0,0,65,0,65,40.825508,-73.867466,10472
133408,0,0,0,2,10,12,40.812726,-73.936109,10037
699542,0,0,0,4,12,16,40.680301,-73.781912,11434
685437,0,0,0,69,0,69,40.594808,-74.078995,10305
813716,0,0,0,2,6,8,42.910721,-78.808532,14211
866239,0,0,40,0,0,40,44.185619,-73.444361,12993
660922,0,0,0,4,12,16,40.805743,-73.925538,10454
114697,8,10,13,15,0,46,42.815628,-73.949445,12305
111929,0,0,0,2,6,8,40.914036,-73.844141,10550
491851,0,0,0,4,12,16,40.855583,-73.889776,10458
762929,16,20,43,20,0,99,43.029122,-78.969657,14072
167560,0,0,0,113,0,113,42.919055,-78.845504,14208
459749,0,0,0,2,6,8,40.699711,-73.428598,11701
847071,0,0,0,185,0,185,40.745225,-73.829164,11355
879058,0,0,0,0,10,10,40.838566,-73.915733,10452
390002,0,0,0,0,5,5,40.755724,-73.281026,11706
319345,0,0,0,4,12,16,40.823954,-73.850618,10473
808145,0,0,0,2,6,8,43.122667,-77.78488,14624
820021,0,0,0,57,0,57,40.785226,-73.843372,11356
44558,0,0,0,130,0,130,42.771864,-73.6761,12182
604185,0,0,0,4,12,16,40.678006,-73.889003,11207
703771,0,0,0,4,12,16,41.521729,-74.080187,12550
876451,0,0,0,4,12,16,42.026582,-73.873674,12571
284132,0,22,401,42,0,465,40.78508,-73.095064,11779
861530,24,48,30,18,0,120,40.835637,-73.620357,11545
202546,0,0,0,4,12,16,40.695052,-73.914052,11221
709772,0,0,0,100,0,100,40.854769,-73.896749,10457
737524,0,0,0,2,6,8,43.231157,-77.637337,14616
813240,0,0,0,4,12,16,40.69344,-73.753753,11412
670879,0,0,0,4,12,16,40.861154,-73.912344,10468
871413,0,0,0,4,12,16,40.816838,-73.343447,11746
679690,0,0,0,2,6,8,43.189556,-77.593279,14621
157362,0,0,0,120,0,120,40.842243,-73.914945,10452
880587,0,0,0,4,12,16,40.790374,-73.486322,11803
783414,0,0,0,4,12,16,40.852285,-73.886023,10458
71802,0,0,0,2,12,14,40.579981,-74.002536,11224
869683,15,22,41,20,0,98,42.098591,-75.88331,13903
228372,0,0,0,480,0,480,40.834685,-73.940903,10032
856665,0,0,0,4,12,16,43.095795,-77.769436,14624
711154,0,7,37,0,0,44,41.938819,-74.035469,12401
880869,0,0,0,4,12,16,40.83477,-73.916996,10456
734771,0,0,0,4,12,16,40.696379,-73.918967,11221
43094,0,24,34,0,0,58,40.739607,-73.493518,11714
757244,0,0,0,4,12,16,40.869747,-73.889736,10458
44529,0,0,0,43,0,43,40.660409,-73.645812,11570
742538,0,0,0,2,6,8,42.745268,-73.743145,12110
40337,0,0,0,79,0,79,40.898098,-73.352244,11768
682927,0,0,0,4,12,16,40.68031,-73.885564,11208
349212,0,0,0,2,12,14,40.662296,-73.986673,11215
785475,0,0,0,0,12,12,40.853526,-73.868905,10462
152662,0,0,0,4,12,16,40.628188,-73.920324,11234
352987,0,0,195,0,0,195,42.795395,-73.924041,12304
846279,0,0,0,0,10,10,40.82869,-73.9187,10456
346743,0,0,0,4,12,16,40.632537,-73.892053,11236
709687,0,0,0,144,0,144,40.664622,-73.759123,11413
877989,0,0,0,0,12,12,42.355455,-76.60721,14867
492844,0,0,0,98,0,98,40.637188,-73.931064,11203
734190,0,0,0,4,12,16,40.857847,-73.931818,10040
848052,0,0,0,100,0,100,43.322091,-78.03699,14476
433597,0,0,0,110,0,110,40.857872,-73.60721,11542
238709,0,0,0,4,12,16,40.69213,-73.980397,11201
689574,0,0,0,80,0,80,40.596458,-73.772282,11691
628268,0,0,0,426,0,426,40.693357,-73.796426,11433
683111,0,0,0,4,12,16,40.859111,-73.927843,10040
126572,0,0,0,4,12,16,40.815288,-73.91059,10455
338968,0,0,0,2,6,8,40.769589,-73.925543,11102
435523,0,0,0,2,12,14,40.832198,-73.877005,10472
742498,0,0,0,209,0,209,40.841366,-73.939053,10032
74046,0,0,0,120,0,120,40.710192,-73.812333,11435
729369,0,0,0,2,6,8,43.052215,-77.492487,14534
863736,0,0,0,4,12,16,40.836477,-73.918109,10452
662508,0,0,0,4,12,16,40.640564,-73.907877,11236
878851,0,0,0,4,12,16,40.691675,-73.414043,11701
761504,0,0,0,4,12,16,40.853859,-73.929375,10040
483561,0,0,0,4,12,16,40.72601,-73.858861,11374
73761,0,0,0,325,0,325,40.739927,-73.926135,11104
264254,0,0,0,4,12,16,40.710965,-73.587042,11553
218930,8,20,18,0,0,46,43.112773,-78.773845,14094
822872,0,0,0,4,12,16,41.092043,-73.942699,10960
709669,0,0,0,163,0,163,40.68934,-73.763274,11412
235855,0,0,0,2,12,14,40.983133,-73.779429,10583
40700,16,24,66,10,0,116,42.786805,-73.902733,12304
403076,0,0,0,189,0,189,40.597142,-73.934014,11229
43281,0,0,0,70,0,70,41.159542,-73.929895,10920
42798,0,36,80,15,0,131,40.831105,-73.695855,11050
789421,0,0,0,4,12,16,40.834855,-73.919445,10452
823914,0,0,0,4,12,16,42.195943,-74.989433,13782
662117,0,0,0,2,6,8,40.860309,-73.899568,10468
739765,0,0,0,4,12,16,40.822807,-73.92437,10451
844384,0,0,0,2,12,14,40.874911,-73.910443,10463
748895,0,0,0,4,12,16,40.712181,-73.586017,11553
855096,0,0,0,0,12,12,40.860764,-73.913295,10468
196023,0,0,0,4,12,16,40.679485,-73.808836,11420
301435,0,0,0,0,10,10,40.821231,-73.892973,10459
44137,0,0,0,111,0,111,42.080716,-78.449508,14760
758132,16,10,32,0,0,58,42.995949,-78.829731,14150
826823,0,0,0,170,0,170,40.804647,-73.952939,10026
569053,0,0,0,4,12,16,40.649947,-73.91526,11236
807545,0,0,0,2,12,14,40.844611,-73.911004,10457
40076,0,0,75,0,0,75,41.456416,-74.413936,10940
773936,0,0,0,73,0,73,40.766196,-73.930338,11106
777203,16,40,46,10,0,112,43.00229,-78.697719,14051
871782,0,0,0,4,12,16,40.705281,-73.910155,11385
727576,0,0,0,4,12,16,40.827381,-73.875883,10472
736166,0,0,0,2,6,8,41.97694,-73.996966,12449
339171,0,0,0,194,0,194,40.594338,-73.795059,11692
831429,16,20,82,20,0,138,42.881488,-78.754052,14227
770720,0,0,0,280,0,280,40.813774,-73.920611,10454
801925,0,0,0,140,0,140,40.729316,-74.006309,10014
26302,0,0,0,4,12,16,40.649262,-73.58444,11520
40850,0,16,57,0,0,73,43.222577,-78.377617,14103
247815,0,0,0,4,12,16,40.7448,-73.865076,11368
445216,0,0,0,186,0,186,40.817862,-73.90212,10455
874039,0,12,116,65,0,193,42.084568,-76.05321,13850
375278,0,0,0,146,0,146,40.732139,-73.853595,11374
646361,0,0,0,4,12,16,40.828823,-73.937341,10039
14174,0,0,0,2,6,8,44.850421,-74.282338,12953
71374,0,0,0,4,12,16,40.694421,-73.75809,11412
697085,0,0,0,4,12,16,40.639585,-73.590575,11520
819426,0,0,0,4,12,16,40.609151,-74.014634,11228
837329,0,0,0,17,0,17,40.752093,-74.002588,10001
482644,0,0,0,2,12,14,40.87666,-73.874681,10467
40501,8,10,47,0,0,65,40.90834,-73.840197,10550
41789,0,0,0,74,0,74,42.77252,-73.839733,12309
862452,0,0,0,2,6,8,42.092542,-79.258873,14701
294333,0,0,0,4,12,16,40.625236,-73.925771,11234
731195,0,0,0,4,12,16,40.662487,-73.885188,11207
867690,0,12,24,0,0,36,42.745715,-73.57597,12180
817260,0,0,0,2,6,8,40.841664,-73.915008,10452
748081,0,0,0,4,12,16,40.882724,-73.880189,10467
857702,24,42,71,0,0,137,43.087081,-73.808247,12866
668038,0,0,20,0,0,20,42.941018,-76.5818,13021
880236,0,0,0,4,12,16,40.701177,-73.953582,11206
351375,0,0,0,2,6,8,43.282491,-75.458888,13440
116757,0,0,0,2,12,14,40.65977,-73.890656,11207
876335,0,0,0,4,12,16,40.902372,-73.898737,10471
847691,0,0,0,100,0,100,40.796785,-73.94244,10029
263617,0,28,61,0,0,89,41.295766,-73.896687,10566
523807,0,0,0,100,0,100,42.991315,-78.731387,14221
51566,0,0,0,2,6,8,40.837458,-73.940904,10032
187628,0,0,0,4,12,16,40.718127,-73.475399,11714
222428,0,0,0,4,12,16,40.760367,-73.872202,11369
868496,0,0,0,40,0,40,42.884629,-77.27267,14424
39181,0,0,48,20,0,68,42.738687,-73.826344,12205
43908,17,24,39,0,0,80,42.932272,-78.877159,14222
698763,0,0,0,4,12,16,40.870787,-73.853246,10469
632899,0,0,0,4,12,16,40.693504,-73.564208,11566
557764,0,0,0,2,6,8,40.854678,-73.898215,10457
40579,0,13,38,0,0,51,41.15904,-73.763231,10514
110068,0,0,0,2,6,8,42.961279,-73.840757,12019
551408,0,0,0,2,12,14,40.867312,-73.885066,10458
44927,8,21,79,44,0,152,43.212402,-77.585444,14617
878274,0,0,0,4,12,16,43.117071,-77.829974,14428
869661,0,0,0,4,12,16,42.951616,-78.905909,14207
488888,0,0,0,4,12,16,40.843522,-73.868127,10460
42976,8,10,16,10,0,44,42.583083,-73.830799,12158
622521,0,0,0,4,12,16,40.893883,-73.847691,10466
872067,0,0,0,4,12,16,40.899316,-73.846392,10466
788764,0,0,0,4,12,16,40.820267,-73.887867,10474
343634,0,0,0,2,6,8,43.172173,-77.5667,14609
796765,0,34,48,0,0,82,40.795901,-73.734418,11024
347973,0,0,0,4,12,16,40.639557,-73.897939,11236
651193,0,0,0,2,12,14,40.839875,-73.888474,10460
764252,0,0,0,2,12,14,40.840125,-73.911877,10457
216502,0,0,0,214,0,214,40.858749,-73.890091,10458
822233,0,0,0,4,12,16,40.883608,-73.897533,10463
260901,0,0,0,4,12,16,40.704281,-73.911093,11385
744266,0,0,24,0,0,24,42.281047,-74.905621,13753
329011,0,0,0,4,12,16,40.731898,-73.853806,11374
159770,0,0,0,2,12,14,43.015651,-76.157739,13207
347661,0,0,98,0,0,98,41.598442,-73.881341,12590
762829,0,0,0,4,12,16,40.713108,-73.684272,11010
776665,0,0,0,4,12,16,40.867457,-73.853026,10469
73508,0,0,0,134,0,134,40.721901,-73.975859,10009
822137,0,0,0,2,12,14,40.872651,-73.885312,10458
43734,0,0,0,40,0,40,42.612425,-76.191037,13045
766747,0,0,0,4,12,16,40.872566,-73.879298,10467
741621,0,36,49,42,0,127,40.837126,-73.706333,11050
42907,5,10,41,0,0,56,43.08364,-73.776968,12866
40813,0,0,0,90,0,90,42.177705,-76.846699,14845
881205,0,0,0,4,12,16,40.742807,-73.314905,11703
874301,0,0,0,4,12,16,41.617225,-74.071919,12589
821866,0,0,0,4,12,16,40.891764,-73.844957,10466
730651,0,0,0,4,12,16,40.898492,-73.846023,10466
810133,24,34,61,21,0,140,40.827038,-73.021002,11738
788046,0,0,0,0,12,12,40.763453,-73.665865,11576
39862,16,24,42,0,0,82,40.729492,-73.598618,11530
44100,0,0,0,154,0,154,40.865426,-73.532177,11771
853316,0,0,0,0,6,6,40.701282,-73.936307,11206
746953,0,0,0,94,0,94,40.90169,-73.85402,10470
72180,0,0,0,4,12,16,40.667255,-73.93852,11213
761005,0,0,0,4,12,16,40.846043,-73.910429,10453
611174,0,0,0,20,0,20,40.91015,-73.878876,10705
44844,8,12,30,12,0,62,42.738142,-78.844412,14075
223785,0,0,0,2,6,8,43.343813,-76.459252,13069
583100,0,0,0,4,12,16,40.683227,-73.996545,11231
703189,0,0,0,4,12,16,40.831921,-73.863377,10472
427911,0,0,20,0,0,20,43.858443,-73.428757,12883
648625,0,0,0,4,12,16,40.670783,-73.984032,11215
226524,0,0,0,2,12,14,40.692135,-73.981274,11201
805041,0,0,0,2,6,8,43.180277,-77.624153,14621
45207,16,20,50,22,0,108,42.995786,-76.202611,13215
276047,8,22,15,12,0,57,42.695639,-78.992193,14047
796160,0,0,0,163,0,163,40.785348,-73.94215,10029
860934,0,0,0,233,0,233,40.70579,-73.962033,11211
240714,0,0,0,48,0,48,40.735887,-73.859607,11368
336463,0,0,0,146,0,146,40.682009,-73.753132,11413
866393,0,0,0,2,6,8,42.707816,-76.42132,13118
71831,0,0,0,4,12,16,40.864226,-73.901625,10468
566667,0,0,0,18,0,18,40.577806,-73.935559,11235
41040,0,24,89,0,0,113,40.797626,-73.646207,11576
536050,0,0,0,0,12,12,40.840169,-73.866013,10460
191798,8,22,30,44,0,104,40.708293,-73.717858,11003
782403,0,0,12,0,0,12,43.077545,-73.792405,12866
857315,16,44,81,42,0,183,40.807253,-72.956645,11763
643622,0,0,0,4,12,16,40.831253,-73.916203,10456
783584,0,0,0,4,12,16,40.763022,-73.880252,11369
358621,0,0,0,4,12,16,40.67733,-73.980512,11217
72792,0,0,0,4,12,16,40.63237,-74.152429,10303
815885,0,0,0,4,12,16,40.687503,-73.873856,11208
870165,0,0,0,4,12,16,40.825624,-73.952323,10031
72837,0,0,0,33,0,33,40.853693,-73.885414,10458
736839,0,0,0,2,6,8,42.956051,-78.829566,14214
252563,0,0,0,105,0,105,43.008055,-78.884051,14150
71927,0,0,0,2,12,14,40.714573,-73.823257,11435
442553,0,0,0,4,12,16,40.756043,-73.227737,11717
872221,0,0,0,66,0,66,40.6475,-73.894359,11236
64274,0,0,0,2,6,8,40.729743,-73.982491,10009
701890,0,0,0,4,12,16,40.676926,-73.427146,11758
220994,0,0,0,2,6,8,42.747679,-73.658887,12180
709861,0,0,0,108,0,108,40.593983,-73.985747,11214
253104,0,0,0,4,12,16,40.600044,-73.746889,11691
231068,0,0,0,44,0,44,42.978148,-78.748065,14221
865348,0,0,0,4,12,16,43.174208,-76.142499,13041
270525,0,0,0,4,12,16,40.658505,-73.921562,11212
820985,0,0,0,44,0,44,43.134484,-73.850032,12866
44937,16,30,30,10,0,86,43.121673,-76.161304,13088
715597,0,0,0,4,12,16,42.907448,-78.865369,14209
309829,0,0,0,4,12,16,40.711221,-73.62265,11550
666338,0,0,0,4,12,16,40.81459,-73.899158,10455
709831,0,0,0,175,0,175,40.665656,-73.897655,11207
764890,0,0,0,26,0,26,40.667355,-73.898992,11207
392232,0,0,0,4,12,16,40.854652,-73.907898,10453
163686,12,20,36,10,0,78,43.13231,-78.676317,14094
258374,0,0,0,230,0,230,40.79301,-73.942489,10029
567684,0,0,60,0,0,60,44.683209,-73.44647,12903
207259,0,0,0,4,12,16,41.483821,-74.368941,10941
799875,0,0,0,2,12,14,40.840169,-73.866013,10460
117270,0,0,0,4,12,16,40.624298,-74.159675,10303
44705,0,24,60,0,0,84,40.716791,-73.461406,11758
507433,0,0,0,4,12,16,42.889492,-78.859084,14204
739067,0,0,0,4,12,16,40.889024,-73.915743,10463
602661,0,0,0,4,12,16,40.828083,-73.861889,10472
533150,0,0,0,4,12,16,40.845008,-73.859378,10462
43987,24,30,58,14,0,126,40.811313,-73.25558,11788
826184,0,0,0,4,12,16,42.798551,-73.659595,12182
40596,40,34,56,22,0,152,41.107126,-73.860086,10591
700669,0,0,0,4,12,16,40.976171,-73.869907,10703
354961,0,0,0,93,0,93,40.598619,-73.990283,11214
546973,0,0,0,2,6,8,43.134963,-77.625595,14608
721592,0,0,0,4,12,16,40.76768,-73.513693,11801
863223,0,0,0,4,12,16,40.663836,-73.99631,11232
842456,0,0,0,2,6,8,40.692988,-73.910214,11221
627760,0,0,0,4,12,16,40.607351,-73.764669,11691
875388,0,0,0,4,12,16,40.837441,-73.90197,10457
356773,0,0,0,4,12,16,43.149357,-73.642314,12831
786717,0,12,31,0,0,43,41.075281,-73.859419,10591
768002,0,0,0,2,6,8,43.180714,-77.642548,14613
74233,0,0,0,440,0,440,40.737355,-73.794157,11365
138449,0,0,0,4,12,16,40.638735,-73.909544,11236
839144,0,12,19,22,0,53,43.221061,-77.936801,14420
673804,0,0,0,4,12,16,40.819187,-73.917147,10455
73096,0,0,0,56,0,56,40.7271,-73.953128,11222
656445,0,0,0,40,0,40,42.09722,-76.806165,14901
717826,0,0,0,4,12,16,40.848317,-73.83396,10461
858507,0,0,0,4,12,16,40.927276,-73.850056,10704
650676,0,0,0,263,0,263,40.769705,-73.771121,11361
742775,0,0,0,225,0,225,40.818967,-73.91931,10451
253737,0,0,0,0,6,6,40.651325,-74.008238,11232
867393,0,0,0,4,12,16,40.760486,-73.278171,11706
179263,0,0,0,163,0,163,40.760401,-73.818013,11355
835033,0,0,0,4,12,16,40.865971,-73.904187,10468
676800,0,0,0,4,12,16,42.904464,-73.802587,12019
636717,8,22,84,0,0,114,40.924144,-73.142954,11790
834355,0,0,0,4,12,16,40.701367,-73.744335,11411
203576,0,0,0,75,0,75,42.999813,-73.867831,12020
584627,0,0,0,2,6,8,44.409657,-74.088797,12913
737735,0,0,0,4,12,16,42.913097,-78.886874,14213
876855,0,0,0,100,0,100,41.2042,-73.8835,10520
780596,0,0,0,2,12,14,40.818518,-73.91852,10451
438425,0,0,0,145,0,145,41.80691,-74.756054,12754
44403,16,30,47,18,0,111,43.1832,-77.503826,14580
828956,0,0,0,4,12,16,40.727073,-73.486908,11714
132495,0,0,0,44,0,44,43.232613,-75.463177,13440
772949,0,0,0,40,0,40,41.504858,-73.956892,12508
707090,0,0,0,36,0,36,40.634631,-73.972958,11218
817322,0,0,0,4,12,16,40.837051,-73.924441,10452
410573,0,0,0,2,6,8,43.066905,-76.07943,13057
229887,32,36,102,44,0,214,40.828361,-73.246392,11787
218416,0,0,0,4,12,16,44.673079,-74.987905,13676
711910,0,0,0,115,0,115,40.876488,-73.908009,10463
797480,0,0,0,95,0,95,43.88082,-75.437063,13620
846186,0,0,0,0,12,12,40.877455,-73.900143,10463
43453,0,0,0,44,0,44,42.834407,-73.965602,12302
882293,0,0,0,2,6,8,40.639767,-73.949652,11226
43382,0,16,136,0,0,152,42.932016,-76.587822,13021
656879,0,0,0,4,12,16,40.845781,-73.889163,10457
39595,8,20,21,18,0,67,42.829013,-77.665124,14487
42896,0,19,31,19,0,69,40.658164,-73.671672,11563
824512,0,0,0,2,12,14,40.835022,-73.913237,10456
22441,0,0,0,2,6,8,41.639942,-74.994376,12764
848987,0,0,0,4,12,16,40.680334,-73.622373,11550
42416,0,0,0,50,0,50,41.109628,-73.994747,10954
222473,0,0,0,2,12,14,40.870861,-73.904691,10463
361328,0,21,40,0,0,61,42.165744,-76.836436,14845
409550,24,48,0,0,0,72,41.141452,-74.033077,10977
840381,0,0,0,4,12,16,40.709808,-73.743537,11429
830835,0,0,0,100,0,100,40.884866,-73.843675,10466
314651,0,0,0,2,10,12,42.919031,-78.746888,14225
738396,0,0,0,160,0,160,40.883154,-73.830669,10475
486008,0,0,0,2,6,8,44.637545,-73.5197,12901
290802,0,0,0,2,12,14,40.864578,-73.927924,10040
845884,0,0,0,61,0,61,43.095428,-77.526274,14534
502067,0,0,0,2,12,14,40.831057,-73.917686,10456
446105,0,0,0,4,12,16,40.851479,-73.88564,10457
336398,0,0,0,2,12,14,40.832243,-73.92706,10452
141746,0,0,0,2,6,8,42.104161,-76.8183,14901
221754,0,0,0,2,5,7,40.796258,-73.934274,10035
868300,0,0,0,4,12,16,40.692464,-73.841962,11418
659483,0,0,0,4,12,16,40.857422,-73.896297,10458
854109,0,0,0,4,12,16,40.766705,-73.518369,11801
753415,0,0,0,2,6,8,43.047985,-74.870092,13365
40938,0,0,0,120,0,120,43.13417,-77.482586,14526
229185,0,0,0,220,0,220,40.626575,-74.015024,11228
855946,0,0,0,4,12,16,40.65209,-73.980187,11218
523728,0,0,0,4,12,16,40.751063,-73.623102,11501
847334,0,0,0,4,12,16,41.138294,-74.068506,10952
112959,0,0,0,4,12,16,42.654704,-79.034877,14006
811913,0,0,0,4,12,16,40.836021,-73.941396,10032
2291,0,0,0,4,12,16,40.80652,-73.508476,11791
375364,0,0,0,4,12,16,40.689024,-73.796353,11435
787890,0,0,0,160,0,160,40.829372,-73.904294,10456
614527,0,0,0,4,12,16,41.609322,-73.830522,12590
468327,0,0,0,2,12,14,40.818482,-73.889338,10474
755952,0,0,0,2,6,8,40.816035,-73.907376,10455
852672,0,0,0,4,12,16,40.6654,-73.985126,11215
743382,0,0,0,2,6,8,42.153487,-78.708252,14779
872981,0,0,0,4,12,16,40.699544,-73.552332,11710
667845,0,0,0,4,12,16,40.586471,-73.955761,11235
849400,0,0,0,60,0,60,40.714323,-73.995529,10002
810267,0,0,0,4,12,16,43.179157,-77.633205,14613
615455,0,0,0,115,0,115,43.028095,-78.856351,14120
798935,0,0,0,4,12,16,40.684042,-73.948931,11216
825045,0,0,0,4,12,16,40.837602,-73.901847,10457
134552,0,0,0,0,6,6,40.837035,-73.90582,10456
18086,0,0,0,4,12,16,41.508185,-74.036398,12550
397219,0,0,0,39,0,39,40.70756,-74.009867,10005
805387,0,0,0,4,12,16,40.629029,-74.022203,11209
709906,0,0,0,80,0,80,40.821532,-73.941284,10030
607291,16,20,26,0,0,62,43.1176,-77.592,14618
733353,0,0,0,0,12,12,40.846394,-73.911205,10453
845094,0,0,0,0,12,12,40.829142,-73.905201,10456
853708,0,0,0,2,6,8,40.714775,-73.616594,11550
750482,8,0,32,5,0,45,42.789548,-73.980258,12306
874822,0,0,0,4,12,16,40.666545,-73.978764,11215
139244,0,0,0,2,6,8,40.824255,-73.90714,10456
866967,0,0,0,2,6,8,43.179312,-77.578938,14609
841719,0,0,0,4,12,16,40.84905,-73.64571,11579
875228,0,0,0,4,12,16,40.700121,-73.596228,11553
830414,0,0,0,2,6,8,42.256261,-73.887485,12451
408997,0,0,0,4,12,16,40.910819,-73.788124,10801
43002,0,12,36,0,0,48,42.09082,-76.792505,14901
120599,0,0,0,4,12,16,43.148959,-77.648975,14611
774884,0,0,0,2,12,14,40.84222,-73.910656,10457
423387,0,0,51,0,0,51,44.930514,-74.894953,13662
712542,0,0,0,80,0,80,40.846262,-73.921809,10453
744762,0,0,0,41,0,41,40.716882,-73.988856,10002
815712,0,0,0,2,12,14,43.06672,-76.122601,13206
762287,0,0,0,135,0,135,40.658636,-73.928569,11203
345849,0,0,0,4,12,16,40.691477,-73.847949,11421
856532,0,0,0,80,0,80,40.701676,-73.912249,11237
124446,0,0,282,0,0,282,40.757659,-73.694403,11042
793963,0,0,0,4,12,16,40.65736,-73.596758,11520
744481,0,0,0,4,12,16,40.870994,-73.899207,10468
675299,0,0,0,4,12,16,40.84755,-73.937206,10033
641156,0,0,0,4,12,16,40.87676,-73.87357,10467
620151,0,0,0,4,12,16,40.633077,-73.90703,11236
875110,0,0,0,4,12,16,40.826157,-73.906786,10456
275781,0,0,0,120,0,120,40.542011,-74.213835,10309
724798,0,0,0,4,12,16,40.872871,-73.901821,10468
556646,0,0,0,2,6,8,40.879437,-73.886068,10468
355886,0,0,0,2,12,14,40.864378,-73.901152,10468
709606,0,0,0,4,12,16,40.884645,-73.901886,10463
788613,0,0,0,2,6,8,42.080234,-75.951528,13850
40212,0,0,0,44,0,44,42.773762,-73.93542,12303
71562,0,0,0,0,10,10,40.703811,-73.74482,11429
676045,0,0,0,4,12,16,40.85701,-73.902735,10453
545259,0,21,67,21,0,109,40.835734,-73.401888,11746
800473,0,0,0,44,0,44,43.092048,-78.881837,14120
378703,0,0,0,4,12,16,40.670287,-73.81725,11420
849237,0,0,0,4,12,16,40.82294,-73.919476,10451
295000,0,0,0,4,12,16,40.786977,-73.052781,11741
317405,0,0,0,30,0,30,42.111445,-75.938439,13905
254571,0,0,0,4,12,16,40.818084,-73.899574,10459
399551,0,0,57,0,0,57,43.045045,-75.380279,13323
881304,0,0,0,2,6,8,40.653673,-73.866994,11239
246712,12,11,14,14,0,51,43.076307,-78.889238,14120
350411,0,0,0,4,12,16,41.282009,-73.88225,10567
793563,0,0,0,2,6,8,40.870427,-73.887652,10458
809441,0,0,0,177,0,177,40.734183,-73.860691,11374
149101,8,21,45,11,0,85,41.6282,-73.7714,12540
837733,0,0,0,4,12,16,42.640059,-73.762207,12202
874643,0,0,0,4,12,16,40.65432,-73.59469,11520
220221,0,0,0,4,12,16,41.563444,-73.707413,12582
73566,0,0,0,100,0,100,40.766436,-73.992425,10019
859389,0,0,0,4,12,16,40.863905,-73.823002,10475
787302,0,0,0,4,12,16,40.870161,-73.879784,10467
497740,0,0,0,2,12,14,40.84349,-73.94138,10032
242540,0,0,0,61,0,61,40.805753,-73.938212,10035
44809,0,0,0,44,0,44,42.651275,-73.76846,12210
672916,0,0,0,0,12,12,40.69873,-73.951359,11206
103801,0,0,0,90,0,90,40.674308,-73.531816,11710
829613,0,0,0,4,12,16,42.802827,-73.93648,12307
770254,0,0,0,4,12,16,41.658734,-73.842703,12603
858144,0,0,0,4,12,16,40.730044,-73.9,11378
829944,0,0,0,1,6,7,40.862974,-73.899615,10468
617729,0,0,0,4,12,16,40.87449,-73.868487,10467
307344,0,0,0,4,12,16,41.327327,-73.694026,10589
874218,0,0,0,4,12,16,40.812052,-73.905235,10455
856965,0,0,0,4,12,16,40.841347,-73.884309,10460
504386,0,0,0,4,12,16,40.667954,-73.777619,11434
781274,0,0,0,4,12,16,43.058897,-77.504028,14534
270970,0,0,0,2,6,8,43.032794,-77.702346,14586
878278,0,0,0,117,0,117,40.939069,-72.740423,11933
870481,0,0,0,2,6,8,40.756322,-73.347672,11729
855801,16,35,36,0,0,87,41.202318,-73.983934,10993
400709,0,0,0,4,12,16,40.834435,-73.920722,10452
104498,0,0,0,100,0,100,40.767622,-73.249247,11717
598434,0,0,0,4,12,16,43.077627,-76.016285,13116
773070,16,40,61,33,0,150,40.831646,-72.9957,11763
566037,0,0,17,0,0,17,44.817965,-74.740534,13613
411493,0,0,0,4,12,16,40.595002,-73.761715,11691
839404,0,0,0,0,12,12,40.854694,-73.901046,10457
275365,0,0,0,4,12,16,41.76425,-73.873325,12538
138951,0,0,0,4,12,16,40.643002,-73.910619,11236
41309,4,12,9,6,0,31,42.015324,-73.987689,12477
758331,0,0,0,4,12,16,40.872558,-73.88562,10458
652222,0,0,0,4,12,16,40.83827,-73.922293,10452
773049,0,0,0,2,6,8,40.823468,-73.901689,10459
843796,0,0,0,0,5,5,40.60506,-73.996172,11214
272159,0,0,0,4,12,16,40.711476,-73.66621,11010
464846,0,0,0,98,0,98,40.903162,-73.775219,10801
520567,0,0,0,4,12,16,40.847859,-73.906098,10457
392278,0,0,0,4,12,16,40.680486,-73.851792,11417
266400,0,0,0,2,6,8,42.849248,-73.744692,12065
373101,24,36,46,28,0,134,41.321257,-73.749207,10598
184554,0,0,0,4,12,16,40.623345,-73.928005,11234
430998,0,0,0,4,12,16,40.662708,-73.892666,11207
848672,0,0,0,4,12,16,40.704617,-73.596196,11553
744772,0,0,0,88,0,88,40.879838,-73.900398,10463
882838,0,0,0,100,0,100,42.984708,-78.893702,14150
866851,0,0,0,480,0,480,40.744303,-73.972296,10016
832785,0,0,0,4,12,16,40.917843,-73.855678,10704
654743,0,0,0,4,12,16,40.820792,-73.852229,10473
871335,0,0,0,4,12,16,40.643529,-73.595857,11520
311383,0,0,0,4,12,16,42.998671,-77.343506,14425
882759,0,0,0,4,12,16,43.153987,-75.3334,13424
162038,0,0,0,2,6,8,40.7765,-73.224698,11717
730546,0,0,0,152,0,152,40.742466,-73.909848,11377
394476,0,0,0,160,0,160,42.206563,-73.872699,12414
808642,0,0,0,4,12,16,43.151576,-77.64306,14611
874399,16,24,30,20,0,90,42.978889,-78.762545,14221
38218,0,0,0,2,6,8,43.113951,-77.741186,14624
658034,0,0,0,4,12,16,40.83239,-73.904419,10456
709794,0,0,0,119,0,119,40.676096,-73.969847,11238
245880,24,26,180,0,0,230,42.109671,-75.955629,13790
840593,0,0,0,4,12,16,40.63002,-73.633928,11572
869081,0,0,0,80,0,80,40.8217,-73.937506,10039
801271,0,0,14,80,0,94,42.372312,-76.866513,14891
882011,0,0,0,0,12,12,40.876161,-73.886193,10468
272824,0,0,0,2,6,8,43.184357,-77.554082,14609
279564,0,0,0,4,12,16,43.197139,-78.420508,14103
718115,0,0,0,2,6,8,43.173247,-77.645926,14606
285123,0,0,0,290,0,290,40.835143,-73.923036,10452
39832,0,0,0,150,0,150,40.652555,-73.55219,11566
40398,8,10,16,0,0,34,40.804168,-73.286772,11717
407757,0,0,0,4,12,16,40.762679,-73.56977,11590
848308,0,0,0,127,0,127,40.765963,-73.989358,10019
108807,0,0,0,2,10,12,43.055827,-78.881281,14120
822471,0,0,0,4,12,16,40.742374,-73.330357,11703
867116,8,12,12,9,0,41,41.623907,-74.600044,12775
65104,0,0,0,2,6,8,40.821636,-73.955074,10031
73910,0,0,0,180,0,180,40.574351,-73.992094,11224
204705,0,0,0,4,12,16,40.67707,-73.874063,11208
806992,0,0,0,247,0,247,40.637381,-73.98585,11219
882864,0,0,0,0,10,10,40.852465,-73.910913,10453
812218,0,0,0,4,12,16,42.092214,-78.25543,14727
425843,0,0,0,4,12,16,40.609126,-73.951636,11229
582991,0,0,0,4,12,16,40.754463,-73.792835,11358
72711,0,0,0,4,12,16,40.640231,-73.975106,11218
547918,0,0,114,40,0,154,42.906732,-78.669787,14086
539178,0,0,0,2,6,8,40.811215,-73.937142,10037
851052,0,0,0,30,0,30,40.845816,-73.831649,10461
277639,0,0,0,0,12,12,40.730032,-73.215053,11751
845724,0,0,0,2,12,14,40.867741,-73.88177,10458
323413,0,0,0,4,12,16,40.882537,-73.90374,10463
653802,0,0,0,0,12,12,40.689303,-73.920135,11221
747475,0,0,0,0,12,12,40.712107,-73.992011,10002
327582,0,0,0,4,12,16,40.931122,-73.794039,10804
18804,0,0,0,2,6,8,41.393809,-73.7434,10541
772297,0,0,0,127,0,127,40.755416,-73.910196,11377
852867,0,0,0,130,0,130,40.684898,-73.960609,11238
52675,0,0,0,0,6,6,40.868523,-73.895296,10468
719568,0,0,0,2,6,8,41.508897,-73.971559,12508
843335,0,0,0,2,12,14,40.845687,-73.880991,10460
855755,0,0,0,4,12,16,42.477202,-76.346325,13068
869762,0,0,0,4,12,16,40.6955,-73.616072,11550
680696,0,0,0,4,12,16,40.870853,-73.893453,10468
355639,0,0,0,4,12,16,41.692629,-73.91394,12603
445461,8,8,0,0,0,16,42.116342,-75.887845,13904
808445,0,0,0,92,0,92,40.772953,-73.990105,10023
774302,0,0,0,4,12,16,40.824648,-73.878978,10472
860257,0,0,0,0,12,12,40.757043,-73.863726,11368
827423,0,0,0,4,12,16,43.107461,-75.25703,13502
361997,0,0,0,15,0,15,40.770007,-73.73565,11362
400346,0,0,0,4,12,16,40.676304,-73.871027,11208
802887,0,0,120,0,0,120,42.982467,-78.808435,14226
801066,0,0,0,250,0,250,40.645027,-73.971138,11218
233974,0,0,0,2,12,14,40.85456,-73.899279,10457
531100,0,0,0,2,6,8,43.011016,-75.042076,13357
245312,0,0,0,2,6,8,42.469884,-73.804602,12143
71620,0,0,0,4,12,16,40.635319,-73.961561,11226
879160,0,0,0,4,12,16,40.94981,-73.886548,10703
371248,0,9,23,0,0,32,40.820327,-72.804169,11934
10766,0,0,0,2,6,8,41.154194,-74.043413,10977
121446,0,0,0,77,0,77,41.436991,-74.15896,10992
716518,0,0,0,4,12,16,41.029344,-73.811897,10530
593022,0,0,0,4,12,16,40.710564,-73.787371,11432
613219,0,0,0,0,12,12,40.833984,-73.913847,10456
403471,0,0,0,4,12,16,41.111084,-74.05566,10977
18047,0,0,0,4,12,16,42.409172,-77.224325,14840
36388,0,0,0,2,6,8,43.06618,-78.922352,14304
28372,0,0,0,4,12,16,43.117387,-78.971891,14304
709894,0,0,0,80,0,80,40.800271,-73.937934,10035
139849,0,0,0,80,0,80,41.1458,-73.685309,10504
248489,0,0,0,4,12,16,40.927539,-73.816426,10552
363015,0,0,0,0,12,12,40.805396,-73.957315,10026
878155,0,0,0,4,12,16,40.863616,-73.822204,10475
865681,0,0,0,2,6,8,43.185122,-77.640368,14613
873558,0,0,0,44,0,44,42.748013,-78.13523,14569
51199,0,0,0,2,6,8,40.821873,-73.951755,10031
359823,0,0,0,260,0,260,40.871572,-73.912612,10034
813127,0,0,0,2,6,8,42.670949,-73.773496,12206
28933,0,0,0,2,6,8,43.05179,-77.580566,14467
556959,0,0,0,2,6,8,40.648672,-73.96176,11226
791633,0,0,0,2,6,8,40.839231,-73.921677,10452
536918,0,0,0,4,12,16,40.660278,-73.934447,11203
879961,0,0,0,4,12,16,40.734186,-73.483325,11714
851586,0,0,0,4,12,16,40.757677,-73.226299,11717
260455,0,0,0,2,6,8,43.977746,-75.904311,13601
44479,0,0,0,80,0,80,42.107519,-74.013782,12477
424485,0,0,18,0,0,18,42.099196,-75.930314,13905
794832,0,0,0,4,12,16,42.832771,-73.760008,12065
858375,0,0,0,4,12,16,40.640142,-74.020625,11220
41386,0,24,108,15,0,147,41.119751,-73.717797,10504
143,0,0,0,2,6,8,42.768268,-73.779596,12110
173268,0,0,0,4,12,16,40.729311,-73.87651,11379
748591,0,0,0,4,12,16,42.643948,-76.158828,13077
866017,0,0,0,44,0,44,43.021845,-73.376707,12816
832546,0,0,0,120,0,120,40.656944,-73.983417,11215
867782,0,0,0,4,12,16,40.654772,-73.724636,11581
754736,0,0,0,2,6,8,43.092467,-79.054583,14301
825207,0,0,0,80,0,80,40.727351,-73.665,11530
115003,0,0,0,60,0,60,43.075168,-75.651225,13421
43638,0,0,85,0,0,85,40.76025,-73.56664,11590
42537,0,0,0,124,0,124,43.218678,-75.457282,13440
802511,0,0,0,4,12,16,41.530632,-74.079462,12550
839838,0,0,0,2,6,8,43.490274,-76.337823,13126
873289,0,0,0,4,12,16,40.682661,-73.617165,11550
871036,0,0,0,2,6,8,43.172463,-76.240399,13090
459472,0,0,0,2,6,8,43.128477,-77.636858,14611
709742,0,0,0,113,0,113,40.648391,-73.952967,11226
291158,0,0,0,4,12,16,40.672907,-73.740401,11413
872396,0,0,0,40,0,40,43.125601,-75.317625,13492
799147,0,0,0,4,12,16,40.836821,-73.915875,10452
414647,0,0,0,4,12,16,40.638245,-73.913384,11236
881774,0,12,17,0,0,29,41.951996,-73.507785,12546
44778,15,12,18,18,0,63,41.458676,-74.05314,12553
30525,0,0,0,2,6,8,43.147401,-77.727805,14624
243024,0,0,0,44,0,44,42.98565,-78.643992,14031
609628,0,0,128,0,0,128,43.132293,-76.164692,13212
227933,0,0,0,156,0,156,40.658636,-73.928569,11203
339136,0,0,0,245,0,245,40.703791,-73.912113,11385
850722,0,0,0,4,12,16,42.899575,-78.859492,14204
246233,0,0,0,4,12,16,41.126048,-73.939847,10989
404726,0,0,0,4,12,16,40.834966,-73.885819,10460
778027,0,0,0,4,12,16,41.258069,-73.940344,10511
40531,0,0,0,69,0,69,41.039969,-73.864807,10533
789883,12,24,41,0,0,77,40.866724,-73.470271,11724
813573,0,0,0,4,12,16,40.826727,-73.879545,10472
345639,8,8,12,6,0,34,42.922915,-78.807719,14215
875464,0,0,0,4,12,16,40.756995,-73.590508,11590
37524,0,0,0,2,6,8,41.200556,-73.988504,10923
571556,0,0,0,2,6,8,40.830548,-73.944949,10031
456841,0,0,0,2,6,8,41.447705,-74.432261,10940
652845,0,0,0,4,12,16,40.940797,-73.794611,10804
710472,0,0,0,2,6,8,40.788998,-73.950072,10029
527793,0,0,0,4,12,16,40.87603,-73.903146,10463
734421,0,0,0,2,6,8,44.204778,-76.070224,13624
450214,0,0,0,4,12,16,40.59273,-74.077938,10305
751818,0,0,0,2,6,8,40.841058,-73.879934,10460
174046,0,0,0,70,0,70,42.109518,-79.225853,14701
871938,0,0,40,0,0,40,41.894164,-73.707942,12581
791167,0,0,0,4,12,16,40.679178,-73.981151,11217
479327,0,0,0,500,0,500,40.839174,-73.880279,10460
809228,0,0,0,4,12,16,44.300125,-73.569249,12950
41506,0,0,0,44,0,44,43.151096,-78.681332,14094
393974,0,0,0,2,12,14,40.837155,-73.844785,10461
841143,0,0,0,4,12,16,40.824398,-73.925926,10451
147284,0,0,0,45,0,45,42.092351,-79.215949,14701
39839,8,20,140,60,0,228,40.854093,-73.623594,11542
406598,0,0,0,4,12,16,40.646168,-74.01481,11220
842148,0,0,0,2,6,8,40.800448,-73.948459,10026
495295,0,0,0,4,12,16,43.130528,-77.528179,14610
858873,0,0,0,20,0,20,40.674242,-74.006837,11231
282569,0,0,0,2,12,14,40.824014,-73.952974,10031
832659,0,0,0,164,0,164,40.639723,-74.079301,10301
678481,0,0,0,4,12,16,40.674221,-73.825385,11420
863359,0,0,0,79,0,79,40.826279,-73.947062,10031
835987,0,0,0,4,12,16,40.683416,-73.989078,11217
816477,8,10,14,0,0,32,42.901012,-78.869867,14202
33454,0,0,0,4,12,16,40.684556,-73.703627,11580
506845,0,0,0,4,12,16,42.390264,-78.171994,14717
102363,0,0,0,2,6,8,42.729168,-73.707653,12189
824153,0,0,0,2,6,8,43.332229,-73.559872,12839
769926,0,0,0,4,12,16,40.86471,-73.896557,10468
476249,0,0,0,4,12,16,43.00854,-76.228133,13215
256887,0,0,0,4,12,16,40.679079,-73.74542,11413
281308,0,0,0,4,12,16,40.678201,-73.811342,11420
877459,0,0,0,4,12,16,40.876061,-73.909282,10463
705749,0,0,0,0,10,10,40.81694,-73.906192,10455
856133,0,0,0,4,12,16,40.86892,-73.865417,10467
819506,0,0,0,4,12,16,40.696836,-73.74043,11411
437691,0,0,0,4,12,16,41.38608,-74.684641,12771
811545,0,0,0,2,6,8,40.636562,-74.165745,10303
833437,0,0,0,4,12,16,40.663657,-73.58783,11520
880718,0,0,0,2,6,8,42.838318,-78.795576,14220
861575,24,36,60,40,0,160,40.868859,-73.347351,11740
851919,0,0,25,0,0,25,42.530419,-75.523523,13815
42469,0,72,151,40,0,263,40.806613,-73.63368,11548
877698,0,0,0,4,12,16,40.862136,-73.928157,10040
876051,12,24,0,0,0,36,43.081716,-77.581001,14623
365413,0,0,0,0,6,6,40.848736,-73.912899,10453
860393,0,0,0,4,12,16,40.628183,-73.977508,11204
787283,0,0,0,0,12,12,40.823557,-73.92739,10451
809967,0,0,0,137,0,137,40.7667,-73.923051,11102
806665,0,0,0,0,12,12,43.033173,-76.162574,13204
40038,0,5,16,10,0,31,42.745302,-77.401511,14424
749139,0,0,0,4,12,16,40.853519,-73.92902,10040
733890,0,0,0,0,12,12,40.682683,-73.611142,11510
621100,0,0,0,4,12,16,40.855144,-73.903958,10453
73214,0,0,0,20,0,20,40.651141,-73.940155,11203
804031,0,0,0,2,6,8,40.706586,-73.83498,11415
854593,0,0,0,2,6,8,43.166286,-77.576756,14609
572768,0,0,0,4,12,16,40.703766,-73.985069,11201
40603,0,42,114,0,0,156,41.003828,-73.766894,10606
792984,0,0,0,4,12,16,40.663087,-73.942931,11225
843651,0,0,0,4,12,16,40.856307,-73.917036,10453
149599,0,0,0,52,0,52,40.668358,-73.6612,11565
41127,0,0,0,44,0,44,42.710509,-73.78079,12205
768543,0,0,0,2,6,8,40.71171,-73.981341,10002
595381,0,21,41,0,0,62,40.761484,-73.703675,11020
103638,0,0,0,2,6,8,43.188358,-77.807034,14559
303259,0,0,0,2,6,8,40.691345,-73.417149,11701
779514,0,0,0,4,12,16,40.682197,-73.919093,11233
734640,0,0,0,4,12,16,40.826529,-73.94897,10031
341110,0,0,0,120,0,120,40.799429,-73.1918,11722
702525,0,0,0,4,12,16,40.842716,-73.892266,10457
119857,0,0,0,68,0,68,42.358691,-73.603473,12037
882938,0,0,0,4,12,16,40.629612,-74.136971,10302
43401,7,17,45,22,0,91,41.54023,-74.097939,12550
866082,0,0,0,4,12,16,42.16219,-78.696676,14779
151122,0,0,0,2,6,8,42.773485,-73.943413,12303
641670,0,0,0,4,12,16,40.865052,-73.90326,10468
245276,0,0,0,140,0,140,40.631613,-74.156755,10303
44218,0,0,0,140,0,140,40.690713,-73.449028,11762
687035,0,0,0,2,6,8,40.664777,-73.907391,11212
575518,0,0,0,4,12,16,40.829993,-73.889152,10459
785581,0,0,0,4,12,16,40.650102,-73.5837,11520
635040,0,0,0,0,12,12,40.879528,-73.897211,10463
661155,0,0,17,420,0,437,40.602857,-74.091587,10304
646769,0,0,0,4,12,16,40.632888,-74.121165,10310
662802,0,0,0,2,12,14,40.850663,-73.918013,10453
384059,0,0,0,4,12,16,40.822214,-73.90193,10459
690349,0,0,0,2,6,8,40.699205,-73.952044,11206
263075,0,0,0,2,6,8,41.948703,-73.995157,12401
45087,16,30,106,30,0,182,40.734648,-73.676678,11040
305372,8,16,18,0,0,42,42.917378,-76.615933,13021
578176,0,0,0,4,12,16,40.680868,-73.855606,11416
39188,0,0,64,0,0,64,42.77584,-73.702477,12047
881172,0,0,0,240,0,240,40.822816,-73.920989,10451
612301,0,0,0,90,0,90,40.662797,-73.61508,11510
43229,0,0,0,89,0,89,41.038218,-73.746705,10604
859682,0,0,0,2,6,8,43.09183,-75.217962,13501
204661,0,0,0,4,12,16,40.766514,-73.534785,11801
834673,0,0,0,2,6,8,43.438353,-76.50772,13126
72040,0,0,0,4,12,16,40.626348,-73.975275,11230
817683,0,0,0,120,0,120,40.8041,-73.962576,10025
807591,0,0,0,172,0,172,40.59393,-73.761566,11691
816317,0,0,0,45,0,45,40.606916,-74.119208,10314
43526,15,42,74,0,0,131,40.641063,-73.641095,11572
670030,0,0,0,4,12,16,40.867594,-73.92193,10034
209121,0,0,0,4,12,16,40.701137,-73.897225,11385
855534,0,0,0,4,12,16,42.37851,-79.467209,14769
816327,0,0,0,80,0,80,40.825827,-73.948637,10031
873275,0,0,0,120,0,120,40.678612,-73.946748,11216
44330,0,0,0,47,0,47,41.035244,-73.759475,10601
814012,0,0,0,4,12,16,40.684505,-73.852338,11416
882514,0,0,0,2,6,8,40.747791,-73.236907,11706
766294,11,18,25,10,0,64,42.755543,-78.825173,14075
498653,0,0,0,4,12,16,40.659019,-73.737923,11422
40691,0,0,0,44,0,44,42.905893,-73.581183,12154
259757,0,0,0,4,12,16,40.846326,-73.908219,10457
214991,0,0,0,60,0,60,42.661952,-73.766754,12206
434402,16,31,61,40,0,148,43.188448,-77.787399,14559
694477,0,0,0,2,6,8,40.756533,-73.889155,11370
708342,0,0,0,0,12,12,40.698847,-73.928778,11221
880602,0,0,170,0,0,170,43.097504,-79.032971,14301
778703,0,0,0,4,12,16,43.198129,-78.573191,14067
209756,0,0,17,0,0,17,43.859187,-76.006031,13606
868172,0,0,0,2,6,8,40.699798,-73.75078,11412
699053,0,0,0,4,12,16,40.657857,-73.757463,11413
248988,0,0,0,4,12,16,40.672895,-73.943433,11213
543852,0,0,0,40,0,40,43.063133,-78.854565,14120
819746,0,0,0,4,12,16,40.836926,-73.908572,10456
74209,0,0,0,265,0,265,40.751645,-73.81783,11355
877814,0,0,0,4,12,16,40.832242,-73.872476,10472
630780,0,0,0,4,12,16,40.548113,-74.188242,10312
807337,0,0,0,4,12,16,40.850842,-73.933344,10033
153758,0,0,0,60,0,60,42.72293,-73.936175,12303
870547,0,0,0,14,0,14,40.702339,-73.798298,11453
283562,0,20,24,0,0,44,41.000841,-73.731214,10605
794603,0,0,0,63,0,63,42.961339,-77.096181,14432
737403,0,0,55,38,0,93,42.076915,-73.948736,12477
709781,0,0,0,261,0,261,40.672571,-73.937257,11213
874969,0,0,0,4,12,16,40.632542,-73.929164,11234
688394,0,0,0,4,12,16,40.893256,-73.842607,10466
72557,0,0,0,4,12,16,40.751225,-73.901668,11377
880542,0,0,0,4,12,16,40.775933,-72.953461,11713
784998,8,12,30,28,0,78,40.680293,-73.591105,11575
836455,0,0,0,70,0,70,40.906407,-72.89829,11961
760306,5,11,6,0,0,22,43.457313,-76.473566,13126
573120,0,0,0,4,12,16,40.612028,-73.767643,11691
175926,0,0,20,0,0,20,42.789836,-74.624144,13459
747161,0,0,0,2,6,8,43.156788,-76.322764,13027
763751,0,0,0,0,5,5,40.750653,-73.270937,11706
387859,0,0,0,4,12,16,40.713691,-73.896847,11379
43160,0,12,32,0,0,44,41.639501,-73.96281,12547
840075,0,0,0,4,12,16,43.1873,-77.637035,14613
844299,0,0,0,2,6,8,43.179339,-77.604123,14621
626919,0,0,0,58,0,58,40.665269,-73.92206,11212
331116,0,0,0,4,12,16,40.854458,-73.900307,10457
128005,32,40,48,20,0,140,42.882426,-78.752679,14227
878884,0,0,0,4,12,16,40.885896,-73.856586,10466
44196,0,0,0,60,0,60,40.789559,-73.314997,11746
170784,0,0,0,4,12,16,40.630384,-73.940786,11210
73829,0,0,0,40,0,40,40.608699,-74.153184,10314
851237,0,0,0,4,12,16,40.813127,-73.907287,10455
318605,0,0,0,1,6,7,40.702417,-73.939528,11206
816293,0,0,0,20,0,20,40.639251,-73.907168,11236
586689,0,0,0,4,12,16,40.615597,-73.960827,11230
643641,0,0,0,4,12,16,40.853981,-73.90406,10453
727208,0,0,0,4,12,16,40.687476,-73.871857,11208
709660,0,0,0,133,0,133,40.813783,-73.920633,10454
542320,0,0,0,2,6,8,40.839581,-73.912138,10457
801953,0,0,0,4,12,16,40.832395,-73.943232,10032
834490,0,0,0,4,12,16,40.844471,-73.910185,10457
866723,0,60,63,0,0,123,40.767138,-73.601934,11568
265401,0,0,0,4,12,16,42.907651,-78.800007,14211
877994,0,0,0,20,0,20,42.066155,-78.160046,14715
628411,0,0,0,4,12,16,40.635261,-73.906968,11236
877569,0,0,0,2,6,8,43.176525,-77.60578,14621
364076,0,0,0,45,0,45,43.082576,-75.749856,13032
39985,0,0,0,30,0,30,42.982588,-76.339866,13108
555408,0,0,0,4,12,16,40.67936,-73.911216,11233
664815,0,0,0,232,0,232,41.80291,-74.746003,12754
764999,0,0,108,0,0,108,40.745065,-73.264131,11706
757063,0,0,0,191,0,191,40.680448,-73.91037,11233
844749,0,0,0,4,12,16,40.636707,-73.908093,11236
815451,0,0,0,2,6,8,40.864963,-73.892372,10458
232876,0,0,0,0,12,12,40.838772,-73.864841,10460
847014,0,0,0,4,12,16,40.829589,-73.941671,10032
548210,0,0,0,4,12,16,44.395511,-74.159637,12983
532324,0,10,55,0,0,65,40.719371,-73.679946,11530
706339,0,0,0,4,12,16,40.865936,-73.888453,10458
621454,0,0,0,160,0,160,40.809389,-73.919899,10454
709693,0,0,0,208,0,208,40.667675,-73.757443,11413
42662,6,2,18,18,0,44,42.015256,-73.984413,12477
237847,0,0,0,4,12,16,40.838591,-73.854981,10462
44327,0,0,17,0,0,17,44.697209,-75.476343,13669
713786,0,0,0,4,12,16,40.811014,-73.905541,10455
859210,0,0,0,4,12,16,41.010736,-73.662116,10573
41266,0,30,67,0,0,97,40.820638,-73.687664,11050
815516,0,0,57,73,0,130,42.96873,-78.760617,14221
41405,0,0,0,50,0,50,41.129953,-73.92653,10989
864938,7,12,18,9,0,46,43.197946,-77.583216,14621
384582,0,0,0,4,12,16,43.196995,-77.654129,14615
40332,0,0,0,81,0,81,40.717484,-73.430441,11735
200823,0,0,0,70,0,70,42.089844,-79.290457,14701
140175,32,47,60,27,0,166,43.082673,-77.660411,14623
624986,0,0,0,4,12,16,40.709763,-73.964871,11249
349527,0,0,0,4,12,16,40.696663,-73.847033,11418
416914,0,0,0,4,12,16,40.998097,-73.679872,10573
211995,0,0,0,4,12,16,40.840878,-73.914067,10452
225645,12,12,20,16,0,60,40.666208,-73.708058,11580
795323,0,0,0,4,12,16,40.692338,-73.64551,11552
40622,0,0,70,0,0,70,42.892549,-73.901723,12302
876124,0,0,0,4,12,16,42.92612,-78.896423,14213
841565,0,0,0,4,12,16,43.294785,-73.583762,12839
715262,0,0,0,4,12,16,42.964919,-74.172818,12010
828415,0,0,0,4,12,16,40.579363,-73.954157,11235
40928,14,12,0,0,0,26,40.77926,-73.702842,11030
798009,0,0,0,0,6,6,40.827865,-73.941726,10031
42249,0,0,0,70,0,70,43.103943,-79.028545,14305
818045,0,0,0,2,6,8,40.679847,-73.412229,11701
712081,0,0,17,264,0,281,40.732584,-74.006293,10014
740305,0,0,71,0,0,71,42.646048,-73.776741,12208
874612,0,0,46,0,0,46,40.79067,-72.851461,11950
105862,0,0,0,4,12,16,40.684764,-73.804207,11435
868744,0,0,0,99,0,99,43.044044,-77.487599,14534
757958,0,0,0,0,5,5,40.813889,-73.916854,10455
450338,0,0,0,60,0,60,40.792512,-73.74597,11023
819208,0,0,0,0,12,12,40.853565,-73.916,10453
679503,0,0,0,4,12,16,41.086443,-73.863287,10591
871852,0,0,0,4,12,16,40.68958,-73.935613,11221
746524,0,0,0,4,12,16,41.039683,-73.747904,10604
736005,0,0,0,4,12,16,40.629774,-73.923018,11234
42502,0,0,0,21,0,21,42.567622,-77.591526,14572
259015,0,0,0,2,6,8,42.799894,-73.931327,12307
777504,0,0,0,4,12,16,40.599471,-74.129219,10314
447366,0,0,0,2,12,14,40.84978,-73.885271,10457
360006,16,36,50,0,0,102,42.804806,-78.661233,14059
717084,0,0,0,4,12,16,41.285367,-73.927039,10566
159169,0,0,0,2,6,8,40.805897,-73.252406,11717
178078,0,0,0,0,10,10,40.68472,-73.883288,11208
868673,8,22,53,0,0,83,40.754531,-73.651305,11596
162491,0,0,0,2,6,8,40.820908,-73.845561,10473
681689,0,0,0,111,0,111,40.705263,-73.862004,11385
877328,0,0,0,4,12,16,40.864888,-73.924265,10034
42367,0,0,0,172,0,172,43.124398,-76.234151,13090
827746,0,0,0,4,12,16,40.611238,-73.958934,11230
872614,0,0,0,4,12,16,40.786997,-73.943348,10029
500292,0,0,0,4,12,16,40.733785,-73.51917,11756
866820,5,22,21,0,0,48,41.03316,-73.678346,10573
45052,7,10,12,0,0,29,40.954017,-73.738663,10543
878012,0,0,0,4,12,16,40.623723,-73.988221,11204
709532,0,0,0,2,12,14,40.819401,-73.885983,10474
128896,0,0,0,4,12,16,40.629976,-74.14838,10303
776349,0,0,0,4,12,16,40.838193,-73.416079,11746
606653,0,0,0,55,0,55,41.216234,-74.029461,10984
669444,0,0,0,180,0,180,40.784031,-73.204544,11722
261107,0,0,0,2,10,12,40.62866,-73.932266,11234
44002,14,48,73,0,0,135,43.174812,-77.602423,14621
244507,0,0,0,4,12,16,40.700056,-73.760765,11412
74089,0,0,0,136,0,136,40.745018,-73.932277,11101
814145,0,0,0,4,12,16,40.817808,-73.864827,10473
39266,16,24,54,0,0,94,42.443668,-79.324665,14063
825694,0,0,0,2,6,8,40.836936,-73.859887,10462
782815,0,0,0,2,6,8,40.812272,-73.955521,10027
348495,32,40,62,30,0,164,43.127397,-77.439657,14450
709649,0,0,0,180,0,180,40.660143,-73.987729,11215
818479,0,0,0,4,12,16,41.448368,-74.068142,12553
141064,24,24,28,13,0,89,43.228199,-78.680906,14094
689795,0,0,0,4,12,16,40.653,-73.698331,11581
42787,0,0,78,60,0,138,43.120505,-75.291978,13492
41082,0,0,18,0,0,18,40.906094,-73.829431,10550
351739,0,0,0,4,12,16,40.788137,-73.641047,11577
105208,0,0,0,4,12,16,40.737287,-73.350546,11704
858239,0,0,0,4,12,16,40.685822,-73.589853,11575
604871,0,0,0,0,12,12,40.863403,-73.859881,10469
861316,0,0,0,2,6,8,43.073407,-75.196991,13340
774063,0,0,0,4,12,16,40.702825,-73.951113,11206
665082,0,0,0,4,12,16,40.843077,-73.921773,10452
861870,0,0,0,4,12,16,40.754721,-73.630803,11501
559622,0,0,0,4,12,16,40.930614,-73.834023,10552
781974,0,0,0,2,6,8,40.860729,-73.893541,10458
857191,0,0,0,44,0,44,40.814817,-73.468119,11797
72516,0,0,0,4,12,16,40.902561,-73.841091,10466
811272,0,0,0,4,12,16,42.672041,-73.784699,12206
44849,0,0,65,0,0,65,40.807908,-73.580159,11545
833846,0,0,0,4,12,16,40.721935,-73.705077,11001
40478,10,8,35,18,0,71,43.226465,-77.333911,14519
109178,0,0,0,4,12,16,43.17314,-77.600591,14605
583130,0,0,0,2,6,8,43.191585,-77.62547,14613
877238,0,0,0,4,12,16,40.812777,-73.916456,10455
500220,0,0,0,2,6,8,43.205525,-77.413495,14580
866584,0,0,0,2,6,8,43.064584,-76.090213,13206
210351,0,0,0,2,6,8,40.695831,-73.792685,11433
276176,0,0,0,2,12,14,40.857422,-73.896297,10458
639622,0,0,0,4,12,16,40.834244,-73.913301,10456
645148,0,0,0,4,12,16,40.87278,-73.883515,10458
610747,0,0,0,4,12,16,40.848848,-73.905008,10457
879352,0,0,0,4,12,16,41.012778,-73.680949,10573
710183,0,0,0,4,12,16,41.282122,-73.708613,10536
399220,0,0,0,2,12,14,40.67691,-73.91073,11233
588365,0,0,0,65,0,65,40.755886,-73.924032,11106
881404,0,0,0,4,12,16,40.85423,-73.904766,10453
871615,0,0,0,4,12,16,40.851238,-73.928395,10033
39366,0,15,29,0,0,44,41.949038,-73.918246,12572
680295,0,0,0,2,6,8,42.734558,-78.80489,14075
880281,0,0,0,4,12,16,40.865586,-73.902889,10468
823471,0,0,0,0,12,12,40.834496,-73.919661,10452
872898,0,0,0,2,6,8,42.554032,-77.689357,14437
821951,0,0,16,0,0,16,41.270983,-73.781231,10598
805683,0,0,0,175,0,175,40.670676,-73.874445,11208
168613,0,0,0,2,5,7,40.836635,-73.91938,10452
467372,0,0,0,0,12,12,40.854794,-73.866555,10462
857526,0,0,0,4,12,16,40.768337,-73.573698,11590
39852,0,20,34,16,0,70,40.619925,-73.744375,11096
869775,0,0,0,0,12,12,40.85845,-73.904869,10453
795791,0,0,0,240,0,240,40.631386,-74.144774,10303
674207,0,0,0,0,12,12,40.799548,-73.944164,10029
464067,0,0,0,4,12,16,40.749412,-73.87844,11372
858626,0,0,21,0,0,21,40.652669,-73.695048,11581
44082,0,0,38,0,0,38,44.217764,-74.456831,12986
108210,16,36,44,0,0,96,41.161894,-73.825428,10510
879671,0,0,0,2,12,14,40.827845,-73.918951,10451
844455,24,35,73,0,0,132,42.93523,-76.579627,13021
188840,0,0,0,0,12,12,40.854172,-73.900434,10457
846660,0,0,0,4,12,16,40.805113,-73.241641,11717
39407,15,20,57,10,0,102,43.002599,-78.738836,14221
835414,0,0,0,2,6,8,43.132998,-77.651902,14619
427402,0,0,0,4,12,16,40.734897,-73.895804,11377
742730,0,0,0,2,6,8,42.083131,-76.791025,14904
642799,0,0,0,4,12,16,40.843676,-73.917725,10452
879513,0,0,0,4,12,16,40.831427,-73.887596,10460
493557,0,0,0,4,12,16,40.729595,-73.820618,11367
868580,0,0,0,4,12,16,40.863695,-73.892808,10458
207541,0,0,0,4,12,16,40.678855,-73.918291,11233
258532,0,0,0,2,12,14,40.761665,-73.880644,11369
799688,0,0,0,4,12,16,40.834687,-73.926222,10452
818285,0,0,0,4,12,16,40.848892,-73.907836,10453
770501,0,0,0,4,12,16,40.672406,-73.77758,11434
832206,8,0,0,0,0,8,41.577136,-73.909459,12590
878624,0,0,0,2,6,8,43.109492,-79.021183,14305
760413,0,0,0,147,0,147,40.875121,-73.910305,10463
618414,0,0,0,4,12,16,40.698634,-73.911752,11237
102596,8,12,14,0,0,34,42.410818,-73.691151,12184
136519,0,0,0,4,12,16,40.728555,-73.826558,11367
228617,0,0,0,4,12,16,42.920975,-78.805173,14215
397008,0,0,0,4,12,16,40.848872,-73.864393,10462
424991,0,0,0,60,0,60,41.886373,-73.535852,12501
43787,0,0,0,93,0,93,40.695915,-73.55125,11710
310646,0,0,0,124,0,124,43.986829,-75.932128,13601
455011,0,0,0,2,12,14,40.850584,-73.937661,10033
703114,0,0,0,4,12,16,42.241073,-77.792002,14803
181287,0,0,0,4,12,16,40.659918,-73.95173,11225
367199,0,0,0,2,12,14,40.663251,-73.740053,11422
185103,0,0,0,4,12,16,40.648152,-73.962059,11226
145243,0,0,0,50,0,50,43.094208,-79.014883,14301
533963,0,0,0,2,6,8,40.67946,-73.860307,11416
714999,0,0,0,4,12,16,40.7111,-73.613792,11550
688976,0,0,0,0,12,12,40.851593,-73.905709,10453
163462,23,20,15,0,0,58,42.874741,-78.849655,14210
614094,0,0,0,4,12,16,40.818219,-73.8998,10459
872155,0,0,0,4,12,16,40.613526,-73.952681,11210
847716,0,0,0,20,0,20,40.886809,-73.860794,10466
269128,0,0,0,4,12,16,40.855836,-73.868766,10462
564579,0,0,0,4,12,16,40.829327,-73.919654,10456
230185,0,0,0,2,6,8,40.819334,-73.894583,10459
739340,0,0,0,4,12,16,40.83796,-73.943762,10032
826352,0,0,0,61,0,61,40.658824,-73.882407,11207
847276,0,0,0,2,6,8,40.878102,-73.856444,10469
821151,0,0,0,4,12,16,40.694407,-73.934545,11221
684747,0,0,0,156,0,156,40.58628,-73.822861,11694
791755,0,0,0,4,12,16,40.665697,-73.919029,11212
452732,0,0,0,2,10,12,42.332417,-77.656671,14843
636284,0,0,0,0,12,12,40.876415,-73.908653,10463
736567,0,0,0,4,12,16,40.792508,-73.972304,10025
775169,0,0,0,2,6,8,42.79656,-73.934939,12303
296907,0,0,0,4,12,16,40.646863,-73.902978,11236
243827,0,0,0,400,0,400,40.745551,-73.727719,11426
44642,0,0,0,80,0,80,42.627766,-73.819158,12054
41637,0,0,0,115,0,115,43.05703,-77.50985,14534
342841,0,0,0,4,12,16,42.653409,-74.482335,12187
695122,0,0,0,4,12,16,43.105913,-79.033288,14305
656332,0,0,0,2,6,8,40.839503,-73.91366,10452
837183,0,0,0,4,12,16,42.921481,-76.794204,13148
369610,0,0,0,4,12,16,40.684458,-73.93441,11233
817350,0,0,0,4,12,16,40.877472,-73.856742,10469
798145,0,0,0,33,0,33,40.656802,-73.904707,11212
709854,0,0,0,127,0,127,40.615267,-73.976639,11204
833292,0,0,0,4,12,16,40.690004,-73.929186,11221
493803,0,0,0,2,6,8,40.679293,-73.606352,11510
840532,0,0,0,4,12,16,40.734582,-73.789515,11365
552035,0,0,0,200,0,200,40.633823,-74.078395,10301
585662,0,0,0,4,12,16,40.924793,-73.901147,10705
21834,0,0,0,4,12,16,40.673477,-73.669464,11565
878136,0,0,0,4,12,16,40.667089,-73.993845,11215
842634,0,0,0,4,12,16,40.859222,-73.902405,10468
721792,0,0,0,0,10,10,40.846775,-73.891039,10457
329623,0,0,0,4,12,16,40.701663,-73.741504,11411
780375,0,0,0,24,0,24,40.653563,-73.955807,11226
752945,0,0,0,2,12,14,40.879824,-73.876261,10467
828897,0,0,0,4,12,16,41.064516,-74.00224,10965
768169,40,72,168,100,0,380,42.5443,-79.0019,14081
72230,0,0,0,4,12,16,40.657868,-73.951587,11225
716682,0,0,0,60,0,60,41.584092,-74.085073,12589
5795,0,0,0,2,6,8,43.188353,-77.595639,14621
758688,0,0,0,2,6,8,40.81962,-73.846848,10473
849565,0,0,0,4,12,16,40.644385,-73.908199,11236
623172,0,0,12,0,0,12,42.957969,-78.803216,14226
647785,0,0,0,147,0,147,40.701497,-73.981671,11201
874739,0,0,0,360,0,360,40.652078,-74.007082,11232
44996,16,40,104,0,0,160,41.650171,-73.924777,12601
20217,0,0,0,2,6,8,42.919178,-78.855301,14208
546835,0,0,0,4,12,16,40.682492,-73.885466,11208
272623,0,0,0,2,6,8,40.667435,-73.86026,11208
750909,0,0,0,2,6,8,40.838464,-73.917555,10452
430776,0,0,0,4,12,16,40.586794,-73.937613,11235
229356,0,0,0,130,0,130,40.6944,-73.288789,11795
432941,0,12,51,0,0,63,41.956717,-74.011584,12401
107543,0,0,0,2,12,14,40.843419,-73.882824,10460
880136,0,0,0,4,12,16,40.660278,-73.934447,11203
814786,0,0,0,0,12,12,40.870275,-73.906368,10463
875073,0,0,0,4,12,16,40.827305,-73.901442,10456
261352,0,0,0,4,12,16,40.675785,-73.757838,11413
30230,0,0,0,4,12,16,41.5151,-74.22677,12549
798858,0,0,0,4,12,16,40.651068,-74.0099,11232
72909,0,0,0,26,0,26,40.84075,-73.891357,10460
131813,0,11,177,68,0,256,41.078588,-73.7768,10595
843963,16,21,15,0,0,52,42.099337,-76.826906,14905
805711,0,0,0,60,0,60,40.738274,-73.981438,10010
381536,0,0,0,2,12,14,40.805396,-73.957315,10026
685962,0,0,0,4,12,16,40.868915,-73.883229,10458
700963,0,10,90,0,0,100,40.730231,-73.5335,11756
753650,0,0,0,4,12,16,40.725496,-73.563316,11554
816701,0,0,0,4,12,16,40.859948,-73.896026,10458
771511,0,0,0,4,12,16,40.859349,-73.893799,10458
460761,0,0,0,4,12,16,40.67184,-73.939704,11213
634434,0,0,0,4,12,16,40.872622,-73.886446,10458
522710,0,0,0,4,12,16,40.921147,-73.800485,10801
872309,0,0,0,2,6,8,43.143835,-77.617619,14608
876259,0,0,0,100,0,100,40.95603,-73.807957,10709
789792,0,0,0,4,12,16,42.912795,-78.803448,14211
843007,0,0,0,4,12,16,41.097936,-74.073502,10952
810422,0,0,0,4,12,16,41.155901,-74.030739,10956
829436,0,0,0,0,4,4,40.807624,-72.846176,11950
7308,0,0,0,2,6,8,43.035445,-76.124474,13210
41911,24,26,36,14,0,100,43.0623,-76.036721,13057
449404,0,0,0,2,12,14,43.143743,-77.642451,14611
869428,0,0,0,4,12,16,40.709804,-73.386522,11757
833537,0,0,0,4,12,16,40.846217,-73.907306,10457
849059,0,0,0,0,5,5,41.269242,-73.932631,10566
709912,0,0,0,179,0,179,40.811012,-73.956823,10027
868955,0,0,0,86,0,86,40.752637,-73.896874,11377
21366,0,0,0,4,12,16,40.675275,-73.586155,11575
659920,0,0,0,2,6,8,43.167979,-77.590834,14605
428571,0,0,0,2,6,8,40.788572,-73.939281,10029
794096,0,0,0,4,12,16,40.827983,-73.923761,10452
743579,0,0,0,4,12,16,40.839044,-73.868427,10460
850425,0,0,0,4,12,16,43.172061,-77.572734,14609
640660,0,0,0,2,12,14,40.816736,-73.899687,10455
41062,0,0,0,90,0,90,40.849491,-73.309461,11725
738283,0,0,0,80,0,80,41.851964,-74.153046,12404
300714,0,0,0,4,12,16,40.720699,-73.373939,11704
31215,0,0,0,4,12,16,40.67663,-73.550457,11566
850135,0,12,18,0,0,30,43.619104,-75.366607,13368
598901,0,0,112,0,0,112,43.121798,-78.949676,14304
481446,6,37,77,11,0,131,40.589705,-73.647033,11561
853263,0,0,0,4,12,16,40.872465,-73.869116,10467
800085,0,0,0,2,6,8,40.712107,-73.992011,10002
676306,0,0,0,4,12,16,40.63965411,-74.11771746,10310
831054,0,0,0,4,12,16,43.143491,-77.67509,14624
876790,8,10,18,7,0,43,41.796116,-74.746792,12754
231439,0,0,0,80,0,80,41.599888,-74.310902,12866
354812,0,0,0,2,12,14,40.578574,-73.939108,11235
144721,0,0,0,2,6,8,40.734829,-73.859677,11374
45231,0,0,0,40,0,40,43.163045,-78.677956,14094
745222,0,0,0,4,12,16,40.85298,-73.855944,10461
823090,0,0,0,4,12,16,43.197679,-77.451251,14580
422651,0,0,0,2,12,14,40.816177,-73.899429,10455
312507,16,30,92,43,0,181,42.857111,-73.784433,12065
73548,0,0,0,677,0,677,40.859002,-73.922705,10034
369217,0,0,0,260,0,260,40.822816,-73.920989,10451
675633,0,0,0,2,6,8,43.03544,-76.145905,13202
363827,0,0,0,2,12,14,40.688898,-73.755082,11412
332842,0,0,0,2,12,14,40.809507,-73.957885,10027
724478,0,0,0,4,12,16,40.668147,-73.567702,11566
717395,0,24,117,0,0,141,40.924743,-73.749236,10538
244578,0,0,0,58,0,58,40.638566,-73.971239,11218
630371,0,0,0,0,12,12,40.853947,-73.905023,10453
875171,0,0,0,4,12,16,43.1467,-77.646226,14611
518567,0,0,0,4,12,16,44.682973,-73.4586,12901
441477,0,0,0,2,12,14,43.140307,-77.623915,14608
40235,16,20,21,0,0,57,42.81641,-73.949372,12305
816170,0,0,0,4,12,16,40.608287,-73.956679,11229
450675,0,0,0,4,12,16,40.870696,-73.868843,10467
359022,0,0,0,99,0,99,41.919465,-73.898299,12572
764404,0,0,51,0,0,51,43.15921,-77.631733,14611
848717,0,0,0,2,6,8,43.165979,-77.560206,14609
803560,0,0,0,0,10,10,40.847037,-73.91694,10453
870516,12,17,21,0,0,50,40.801186,-73.65109,11576
626221,0,0,0,4,12,16,40.67309,-73.861964,11208
528746,0,0,0,2,12,14,40.854294,-73.917505,10453
733191,0,0,0,4,12,16,41.012035,-73.657285,10573
683573,0,0,0,4,12,16,41.288206,-73.908733,10566
658467,0,0,0,0,10,10,40.835506,-73.877488,10472
425696,0,0,0,2,6,8,44.839405,-73.517066,12992
23089,0,0,0,4,12,16,40.91837,-73.836502,10552
588517,0,0,0,4,12,16,40.82002,-73.887783,10474
40752,0,0,0,60,0,60,42.147159,-77.112141,14870
637203,0,0,0,183,0,183,42.894227,-78.888357,14201
32274,0,0,0,4,12,16,43.458243,-76.501364,13126
275518,0,0,0,102,0,102,41.146981,-73.818831,10510
798407,0,0,0,4,12,16,40.699629,-73.618039,11550
299055,0,0,0,4,12,16,40.85726,-73.907952,10453
412879,0,0,0,2,6,8,40.666867,-73.910778,11212
755628,0,0,0,4,12,16,40.844611,-73.911004,10457
714297,0,0,0,2,6,8,44.696205,-75.484731,13669
603275,0,0,0,240,0,240,40.722411,-73.323146,11703
350076,0,0,0,2,6,8,40.748296,-74.001263,10001
385855,0,0,0,4,12,16,40.841652,-73.891228,10460
781617,0,0,0,4,12,16,40.729239,-73.508948,11756
824671,8,12,48,0,0,68,42.419671,-76.517874,14850
831544,0,0,0,4,12,16,40.918512,-73.841935,10550
350701,0,0,0,4,12,16,40.646635,-73.952189,11226
876704,0,0,0,4,12,16,41.084866,-74.039141,10977
39489,8,16,30,52,0,106,42.65793,-78.747658,14025
679158,0,0,0,4,12,16,40.827839,-73.919741,10451
610189,0,0,0,0,7,7,40.833212,-73.928592,10452
859223,0,0,0,2,6,8,40.885042,-73.878543,10467
811743,0,0,0,4,12,16,40.640862,-73.995446,11219
439730,0,0,0,4,12,16,40.654012,-73.924187,11203
804112,0,0,0,4,12,16,43.144178,-76.345702,13027
645085,0,0,0,4,12,16,40.687142,-73.877632,11208
613926,0,0,0,4,12,16,40.784811,-73.975828,10024
673051,0,0,0,4,12,16,40.830466,-73.922297,10452
841465,0,0,0,108,0,108,40.820434,-73.094451,11779
257800,0,0,0,4,12,16,40.935133,-73.890776,10701
62610,0,0,0,2,6,8,40.622427,-73.923546,11234
812621,0,0,0,2,6,8,43.076346,-76.113906,13206
453835,0,0,0,4,12,16,40.837481,-73.920678,10452
720882,0,0,0,4,12,16,40.711635,-73.4066,11701
762093,0,0,0,4,12,16,40.668376,-73.78421,11434
426403,0,0,0,4,12,16,40.685219,-73.99993,11231
879360,0,0,30,240,0,270,42.172207,-77.976719,14880
742490,0,0,0,239,0,239,40.838551,-73.903024,10457
869276,0,0,0,2,6,8,40.84074,-73.899134,10457
224599,0,0,0,199,0,199,40.850674,-73.934108,10033
831633,0,0,0,4,12,16,40.870278,-73.902682,10468
315568,0,0,0,4,12,16,40.865331,-73.892324,10458
732828,0,0,0,2,12,14,40.86608,-73.891185,10458
205657,0,0,0,2,6,8,41.389347,-74.156534,10950
435145,21,60,96,21,0,198,40.80334,-73.517067,11791
867053,0,0,17,0,0,17,42.298634,-75.481463,13733
570892,0,0,0,2,6,8,40.819183,-73.909917,10455
73930,0,0,0,246,0,246,40.860187,-73.92784,10040
687548,0,0,0,2,12,14,40.90044,-73.844919,10466
882795,0,0,0,4,12,16,41.115966,-74.04886,10977
521843,0,0,0,4,12,16,40.814579,-73.908995,10455
866891,16,72,147,0,0,235,40.809156,-73.48871,11797
41020,0,0,0,58,0,58,42.607454,-73.825735,12054
597704,0,0,0,4,12,16,41.117466,-74.038207,10977
547391,0,0,0,44,0,44,42.637833,-73.54175,12018
801483,0,0,0,4,12,16,43.973178,-75.618091,13619
308769,0,0,0,2,12,14,40.678289,-73.877735,11208
279179,0,0,0,4,12,16,40.676303,-73.882978,11208
40383,53,48,103,62,0,266,40.829149,-73.303309,11725
880935,0,0,0,2,6,8,43.186549,-77.595877,14621
790219,0,0,0,103,0,103,40.669082,-73.96052,11225
860999,0,0,0,4,12,16,40.63095,-74.16615,10303
40321,0,0,0,50,0,50,40.840293,-73.142806,11767
335915,0,0,0,2,6,8,42.874064,-78.735415,14227
44133,7,15,22,0,0,44,40.753538,-73.47809,11714
651611,0,0,0,0,12,12,40.853336,-73.916201,10453
479623,0,0,0,4,12,16,40.673584,-73.880843,11208
776457,0,0,0,4,12,16,40.671496,-73.755529,11413
869202,0,0,0,2,6,8,42.191085,-76.840829,14845
734518,0,0,0,4,12,16,40.839353,-73.874821,10460
744350,0,0,0,4,12,16,40.686906,-73.787611,11434
608383,0,0,0,2,6,8,40.791136,-73.938773,10029
760206,0,0,0,4,12,16,43.163975,-77.571051,14609
830332,0,0,0,4,12,16,40.623579,-74.013215,11228
610476,0,0,0,103,0,103,42.672898,-73.849305,12203
388228,0,0,0,2,6,8,40.73692,-73.864089,11368
400196,0,0,44,0,0,44,41.786792,-73.690151,12545
750952,0,0,0,0,12,12,40.843095,-73.878708,10460
717163,0,0,0,248,0,248,40.822412,-73.853463,10473
312170,0,0,0,2,12,14,40.818206,-73.938186,10037
794145,0,0,0,0,12,12,40.835715,-73.92372,10452
659194,0,0,0,2,12,14,40.844671,-73.913496,10452
41584,0,12,56,0,0,68,40.929921,-73.762809,10538
823492,0,0,0,2,6,8,42.587478,-73.691357,12061
766899,0,0,0,2,6,8,43.182858,-77.569168,14609
40165,0,10,116,0,0,126,41.115413,-74.044124,10977
843623,0,0,0,4,12,16,40.837848,-73.865374,10460
384133,32,40,72,20,0,164,42.979256,-78.67328,14221
42339,0,0,0,44,0,44,40.834215,-73.210663,11787
758825,0,0,0,4,12,16,40.860033,-73.857798,10469
42836,0,0,0,40,0,40,41.295611,-74.166673,10926
314396,0,0,0,4,12,16,40.768814,-73.914088,11103
514042,0,0,0,4,12,16,40.812008,-73.953068,10027
857991,16,35,37,0,0,88,41.312674,-73.916907,10567
853338,0,0,0,4,12,16,40.642217,-74.015803,11220
283175,0,0,0,2,12,14,40.850757,-73.866935,10462
879237,0,0,0,192,0,192,40.665061,-73.890775,11207
846065,0,0,0,4,12,16,40.708652,-73.749978,11429
354909,0,0,0,2,12,14,40.923639,-73.800564,10801
22780,0,0,0,2,5,7,41.809945,-73.908584,12538
337551,0,0,0,2,6,8,43.103723,-74.267942,12117
461007,0,0,21,76,0,97,40.945864,-72.841064,11792
117327,0,0,0,2,6,8,41.208214,-73.858351,10520
579746,0,0,0,4,12,16,40.76985,-73.889672,11370
726981,0,0,0,0,6,6,40.676722,-73.652183,11552
836594,0,0,0,175,0,175,40.856129,-73.937294,10040
875919,0,0,35,0,0,35,40.900198,-73.793983,10805
751181,0,0,0,44,0,44,40.812323,-73.734829,11024
743025,0,0,0,4,12,16,40.768705,-73.868806,11369
422711,0,0,0,4,12,16,40.830808,-73.854727,10472
412864,0,0,0,0,12,12,43.046375,-75.871034,13037
631461,0,0,0,2,6,8,40.683383,-73.881554,11208
764932,0,0,0,162,0,162,40.840302,-73.910988,10453
271517,0,0,0,2,6,8,42.824176,-73.858303,12148
763643,0,0,0,4,12,16,40.883902,-73.877825,10467
244334,0,0,0,2,12,14,40.798887,-73.944777,10029
39343,8,21,21,56,0,106,41.673107,-73.805727,12569
847064,0,0,0,4,12,16,40.658984,-73.912255,11212
676262,0,0,0,44,0,44,40.869278,-73.415042,11743
263630,0,0,0,4,12,16,40.860833,-73.906457,10468
805937,0,0,0,2,6,8,43.234043,-77.594973,14617
878575,0,0,0,152,0,152,40.747581,-73.745457,11364
43060,16,31,67,0,0,114,40.747462,-73.053124,11705
40759,0,0,39,0,0,39,42.158844,-78.717579,14779
847816,0,0,0,4,12,16,40.960635,-73.734354,10543
876364,0,0,0,2,12,14,40.828154,-73.899309,10459
810027,0,0,0,2,12,14,40.832621,-73.879347,10472
679242,0,0,0,4,12,16,40.667772,-73.806872,11420
356732,0,0,0,4,12,16,40.66949,-73.889331,11207
812070,0,0,0,154,0,154,40.837319,-73.855045,10462
874944,0,0,0,0,12,12,40.90741,-73.848713,10550
130282,0,0,0,1,6,7,40.663745,-73.98068,11215
39203,0,0,0,60,0,60,42.686048,-73.86117,12203
778665,0,0,0,4,12,16,40.794458,-73.2492,11717
346197,0,0,0,4,12,16,40.628384,-73.920346,11234
292419,0,0,0,79,0,79,40.749247,-74.001598,10001
876622,0,0,39,0,0,39,41.657028,-74.689804,12701
148214,0,0,0,4,12,16,42.219676,-77.13723,14870
709633,0,0,0,136,0,136,40.694469,-73.971291,11205
374006,0,0,0,2,6,8,43.128055,-77.645455,14619
254399,0,0,0,184,0,184,42.674071,-73.81615,12203
875074,0,0,0,4,12,16,40.641274,-73.651289,11572
871527,0,0,0,4,12,16,40.678195,-73.509524,11793
745548,0,0,0,4,12,16,40.836505,-73.923199,10452
799798,0,0,0,4,12,16,40.917394,-73.845167,10550
877934,16,48,95,20,0,179,40.866899,-73.033892,11727
706348,0,0,0,4,12,16,42.705979,-75.45353,13460
582449,0,0,0,4,12,16,40.64795,-73.948121,11226
176580,0,0,0,239,0,239,40.756829,-73.831211,11355
330815,0,0,0,4,12,16,40.608675,-73.759951,11691
41018,0,0,0,55,0,55,42.627586,-73.8205,12054
709729,0,0,0,180,0,180,40.852627,-73.921269,10453
125816,0,0,0,2,6,8,42.862278,-77.00515,14456
815705,0,0,0,4,12,16,40.711461,-73.852396,11375
867450,0,0,0,4,12,16,40.749908,-73.234968,11706
689088,0,0,0,4,12,16,40.661142,-73.835358,11414
414261,0,0,0,2,6,8,44.68545,-75.49305,13669
73828,0,0,0,195,0,195,40.638507,-74.096823,10301
111165,0,0,0,2,6,8,40.785472,-73.271789,11717
881371,0,0,0,0,12,12,40.833611,-73.917154,10456
583629,0,0,0,4,12,16,40.838421,-73.942045,10032
440200,0,0,0,90,0,90,40.693706,-73.982038,11201
874466,0,0,0,4,12,16,40.651475,-74.009071,11232
64926,0,0,0,0,5,5,40.78848,-73.939812,10029
393162,0,0,0,4,12,16,40.76778,-73.868632,11369
296593,0,0,0,4,12,16,40.704221,-73.892721,11385
7225,0,0,0,2,6,8,41.925558,-74.214743,12461
738459,0,0,0,4,12,16,40.670916,-73.863362,11208
856841,0,0,0,0,12,12,40.820091,-73.901164,10459
707327,0,0,0,160,0,160,40.745681,-73.923377,11104
680386,0,0,0,2,6,8,42.434178,-75.578119,13830
360514,0,0,0,4,12,16,42.257711,-77.6267,14843
570035,0,0,0,2,6,8,44.075028,-76.008638,13601
248593,0,0,0,50,0,50,43.094902,-77.779839,14624
649204,0,0,0,4,12,16,41.29234,-73.926625,10566
805535,0,0,0,126,0,126,40.762601,-73.733897,11362
293359,0,0,0,4,12,16,40.817082,-73.845033,10473
709692,0,0,0,80,0,80,40.827038,-73.818645,10465
248525,0,0,0,80,0,80,42.823003,-78.649903,14059
664908,0,0,0,4,12,16,40.636309,-74.163803,10303
847269,0,0,0,4,12,16,40.85446,-73.92894,10040
41801,0,0,18,0,0,18,42.057459,-75.412906,13754
332262,0,0,0,2,12,14,40.836635,-73.91938,10452
43955,0,0,0,115,0,115,40.933318,-73.90018,10701
783536,0,0,0,4,12,16,41.326441,-74.197171,10950
225073,0,0,0,0,6,6,40.882537,-73.90374,10463
523815,0,0,0,4,12,16,43.188264,-77.593759,14621
622229,0,0,0,4,12,16,40.817745,-73.917476,10455
801827,0,0,0,4,12,16,40.855311,-73.893576,10458
752681,0,0,0,4,12,16,40.79923,-73.937419,10035
829674,0,0,0,4,12,16,40.646346,-73.893595,11236
343332,0,0,0,0,12,12,40.862201,-73.907833,10468
237070,0,0,0,2,6,8,40.653681,-73.960456,11226
401016,0,0,0,160,0,160,40.666567,-73.911103,11212
878381,0,0,0,31,0,31,40.826307,-73.87741,10472
722767,0,0,0,4,12,16,40.890102,-73.845233,10466
253607,0,7,60,41,0,108,43.07719,-75.278629,13501
834019,0,0,0,100,0,100,40.813577,-73.9249,10451
850607,0,0,0,4,12,16,42.530312,-75.517545,13815
786453,0,0,0,4,12,16,40.889329,-73.836767,10466
882578,0,0,0,2,6,8,43.166163,-77.63633,14606
789519,0,0,0,4,12,16,40.867977,-73.922744,10034
170474,0,0,0,4,12,16,41.043265,-73.831432,10607
868403,0,0,30,0,0,30,41.653649,-73.75325,12540
793758,0,58,66,0,0,124,40.867699,-73.438579,11743
41174,0,12,144,0,0,156,40.701273,-73.646447,11552
841960,16,44,62,16,0,138,40.875193,-73.123878,11790
524090,0,0,0,2,6,8,43.086756,-76.879838,14433
882948,0,0,0,4,12,16,40.722645,-73.817805,11367
879492,0,0,0,80,0,80,41.172154,-73.859955,10562
417067,0,12,164,0,0,176,41.147163,-74.05977,10977
737883,0,5,35,28,0,68,41.149647,-74.032565,10956
73857,0,0,0,140,0,140,40.655446,-73.886362,11207
712069,0,0,155,44,0,199,42.928958,-76.567424,13021
715332,0,0,0,4,12,16,40.679804,-73.783372,11434
532146,0,0,0,4,12,16,40.676541,-73.405671,11726
327052,0,0,0,4,12,16,40.714794,-73.403071,11701
827695,0,0,0,2,12,14,40.827679,-73.878135,10472
221283,0,0,0,2,6,8,44.201362,-75.965702,13656
881018,0,0,0,4,12,16,40.814789,-73.828163,10465
882929,0,0,0,4,12,16,40.698637,-73.406631,11701
208186,0,0,0,4,12,16,40.652357,-73.711396,11581
273162,16,24,39,20,0,99,42.932235,-78.760285,14225
876073,0,8,17,0,0,25,40.913125,-73.808564,10803
816244,0,0,0,105,0,105,40.880385,-73.052216,11787
31635,0,0,0,4,12,16,43.14978,-77.639244,14611
772967,0,0,0,4,12,16,40.862739,-73.892452,10458
629570,0,0,0,70,0,70,43.321452,-76.144034,13036
854923,0,0,0,100,0,100,40.619691,-74.000673,11228
873691,0,0,0,2,12,14,40.853759,-73.914673,10453
721767,0,0,0,4,12,16,40.652138,-73.937983,11203
686220,0,0,0,2,12,14,40.84155,-73.920721,10452
798089,0,0,0,4,12,16,40.746519,-73.859829,11368
107961,0,0,0,2,6,8,40.664324,-73.928791,11212
880934,0,0,0,4,12,16,42.947727,-76.560531,13021
810639,0,0,0,4,12,16,40.598587,-73.791089,11692
753472,0,0,0,2,6,8,43.040967,-76.173759,13204
735792,7,22,34,22,0,85,42.792188,-78.849161,14219
74109,0,0,0,340,0,340,40.840285,-73.915609,10452
354690,0,0,0,2,12,14,40.692322,-73.960361,11205
272782,0,0,0,4,12,16,40.591434,-73.941018,11235
355865,0,0,0,4,12,16,40.630627,-73.909516,11236
132472,0,0,0,4,12,16,40.861077,-73.908728,10468
631767,16,12,48,104,0,180,42.837175,-73.754854,12065
833194,0,0,0,4,12,16,40.848286,-73.923775,10453
375896,0,0,0,4,12,16,40.82607,-73.825551,10465
814455,0,0,0,4,12,16,40.850971,-73.937098,10033
500590,0,0,0,4,12,16,40.666478,-73.910678,11212
299973,0,0,0,4,12,16,40.870355,-73.84974,10469
462693,0,0,0,2,6,8,40.820847,-73.90323,10456
709655,0,0,0,280,0,280,40.657974,-73.844199,11414
801517,8,24,38,65,0,135,40.616851,-73.740203,11096
297865,0,33,48,0,0,81,40.631961,-73.70941,11598
239587,0,0,0,120,0,120,41.337135,-73.859662,10579
142891,0,0,0,25,0,25,40.66666,-73.736134,11422
223490,0,0,0,2,12,14,40.676291,-73.81208,11420
229343,0,0,0,114,0,114,40.664828,-73.892754,11207
825287,0,8,20,0,0,28,42.217788,-78.273338,14727
64855,0,0,0,2,6,8,40.788174,-73.93908,10029
298875,0,0,0,4,12,16,42.823961,-78.839661,14218
481959,0,0,0,890,0,890,40.620497,-74.164464,10314
397329,0,0,0,2,6,8,40.796141,-73.244116,11717
862101,0,0,0,4,12,16,40.837246,-73.866455,10460
634675,0,0,0,4,12,16,40.812261,-73.915854,10454
850438,0,0,0,4,12,16,40.86649,-73.927403,10034
805225,0,0,0,4,12,16,40.683783,-73.759165,11413
772131,0,10,27,30,0,67,43.288989,-77.791952,14468
41054,0,0,0,50,0,50,40.691099,-73.711132,11003
827317,0,0,0,4,12,16,42.789399,-73.964489,12306
881810,0,0,0,4,12,16,40.591929,-73.655242,11561
797227,0,0,0,4,12,16,40.917019,-73.849256,10704
620895,0,0,0,4,12,16,40.650762,-74.006367,11232
658827,0,32,102,25,0,159,40.637812,-73.635072,11572
871935,0,0,0,4,12,16,40.689608,-73.847388,11421
42191,4,10,72,0,0,86,43.252104,-76.311247,13135
833499,0,0,72,0,0,72,43.053526,-76.174199,13204
41644,0,0,0,40,0,40,43.266984,-77.734672,14468
40276,8,10,18,55,0,91,42.332187,-77.315638,14810
599454,0,0,0,44,0,44,43.162557,-76.330199,13027
820344,0,0,0,4,12,16,40.635093,-74.120588,10310
861850,0,0,0,4,12,16,40.664819,-73.878931,11208
40880,0,0,0,44,0,44,42.742945,-78.742198,14127
844448,0,18,24,0,0,42,43.058839,-76.151529,13208
387298,0,0,0,2,12,14,40.857934,-73.892338,10458
467524,0,0,0,4,12,16,40.816628,-73.909774,10455
767449,0,0,0,30,0,30,40.660048,-73.922007,11212
797803,0,0,0,4,12,16,40.640627,-73.882508,11236
436860,0,0,0,4,12,16,40.669277,-73.805034,11420
881662,0,0,0,4,12,16,40.680408,-73.886849,11207
848100,0,0,0,0,12,12,40.883862,-73.892949,10463
709986,0,0,0,2,6,8,40.83604,-73.889272,10460
40285,0,12,21,0,0,33,40.894137,-73.014972,11727
31864,0,0,0,2,6,8,42.600272,-73.782142,12077
370460,0,0,0,4,12,16,40.66394968,-73.92982807,11212
454041,0,0,0,2,6,8,42.79451,-73.941377,12303
522883,0,0,0,4,12,16,40.665902,-73.577861,11520
529394,0,0,0,120,0,120,40.665536,-73.939353,11213
800475,0,0,0,30,0,30,43.139045,-78.977371,14304
72820,0,0,0,191,0,191,40.731502,-73.983296,10003
816906,0,0,0,4,12,16,40.752309,-73.859986,11368
880033,0,0,0,2,6,8,40.687606,-73.875052,11208
750782,0,0,0,4,12,16,40.676356,-73.888318,11207
625594,0,0,0,4,12,16,40.831018,-73.19212,11788
250013,0,0,0,2,6,8,43.308898,-73.667721,12804
827048,0,0,0,60,0,60,43.094991,-76.180516,13088
265272,0,0,0,4,12,16,43.240363,-73.680986,12831
878210,0,0,0,4,12,16,40.919006,-73.898355,10705
42715,0,0,0,24,0,24,40.765853,-73.228296,11717
637503,0,0,0,4,12,16,40.843755,-73.941165,10032
69494,0,0,0,2,6,8,40.585774,-73.82055,11694
8980,0,0,0,4,12,16,43.139767,-76.156784,13212
782776,0,0,0,4,12,16,40.667506,-73.431089,11758
529212,0,0,0,2,6,8,40.687582,-73.92007,11221
324437,0,0,0,2,6,8,40.791845,-73.967549,10025
811961,0,0,0,4,12,16,40.758013,-73.83381,11354
857228,16,36,21,0,0,73,43.013232,-78.821818,14228
16905,0,0,0,4,12,16,42.448021,-75.073689,13820
667816,0,0,0,4,12,16,40.694088,-73.789817,11433
774190,0,0,0,4,12,16,40.752995,-73.575128,11590
709334,0,0,44,0,0,44,42.728094,-73.939078,12303
112292,0,0,0,4,12,16,40.666583,-73.893302,11207
854363,0,0,0,4,12,16,40.84977,-73.886862,10457
831730,21,21,28,0,0,70,42.782016,-73.695642,12188
102905,0,0,0,2,6,8,40.814591,-73.957595,10027
799169,0,0,0,4,12,16,40.659477,-73.985502,11215
807231,0,0,0,4,12,16,40.767516,-73.875945,11369
340769,0,0,0,4,12,16,40.841618,-73.887143,10460
419915,0,0,0,2,6,8,40.754047,-73.294711,11706
853579,0,0,0,4,12,16,40.676818,-73.713785,11580
718299,0,0,0,4,12,16,40.685359,-73.869013,11208
764709,16,36,48,34,0,134,43.20912,-77.663889,14615
809280,0,0,0,151,0,151,40.763877,-73.948116,10044
342527,0,0,0,0,12,12,40.826917,-73.90554,10456
770437,0,0,0,135,0,135,40.910368,-73.799442,10801
551280,0,0,0,2,6,8,41.479314,-73.539252,12563
563447,0,0,0,4,12,16,40.788992,-73.968585,10024
688216,0,0,0,4,12,16,40.837488,-73.94433,10032
671858,0,0,0,4,12,16,40.836308,-73.853916,10462
642223,0,0,0,4,12,16,40.601168,-73.756159,11691
547388,0,0,0,44,0,44,42.642083,-73.609086,12196
137554,32,48,90,21,0,191,40.724605,-73.523108,11756
874108,0,0,56,0,0,56,42.251035,-73.784938,12534
829005,16,36,69,33,0,154,42.967176,-78.718939,14221
737116,0,0,0,4,12,16,44.751933,-75.000973,13668
837858,0,0,0,4,12,16,40.661613,-73.914065,11212
451803,0,0,0,2,6,8,42.574365,-76.453011,13073
509195,0,0,0,2,6,8,42.125693,-75.956619,13790
754232,0,0,0,4,12,16,40.829773,-73.899058,10459
821704,0,0,0,0,12,12,40.8765,-73.843291,10469
72619,0,0,0,2,12,14,40.629976,-74.14838,10303
316682,0,0,0,2,12,14,40.814971,-73.866622,10473
366771,0,0,0,2,6,8,43.176361,-77.720848,14606
454896,0,0,0,312,0,312,40.67769,-73.88676,11207
250629,0,0,0,4,12,16,40.688079,-73.704723,11003
845252,0,0,0,4,12,16,40.831173,-73.890475,10459
758448,0,0,0,84,0,84,40.74242,-73.759893,11364
613769,0,0,0,4,12,16,40.664345,-73.913095,11212
866942,0,0,0,4,12,16,40.9181,-73.0036,11766
475728,0,0,0,2,6,8,44.575457,-75.191489,13617
477206,0,0,0,0,12,12,40.839736,-73.782586,10464
856221,0,0,0,4,12,16,40.764388,-73.869392,11369
617551,0,0,0,2,6,8,42.121373,-76.822245,14903
43939,0,123,143,0,0,266,41.14067,-74.035137,10977
837166,0,0,0,4,12,16,40.857086,-73.930163,10040
585528,0,0,0,4,12,16,40.860613,-73.852281,10469
31304,0,0,0,4,12,16,43.460302,-76.220694,13114
700180,0,0,0,2,6,8,42.164441,-75.131167,13856
503506,0,0,234,0,0,234,42.735996,-77.827844,14510
25671,0,0,0,2,6,8,43.170387,-77.184013,14505
840830,0,0,0,4,12,16,40.677738,-73.611764,11510
242036,0,0,0,4,12,16,43.112618,-77.496,14445
44882,0,0,0,110,0,110,43.003547,-73.846876,12020
879777,32,58,74,16,0,180,42.777546,-78.779801,14127
44691,8,10,30,0,0,48,41.02477,-73.669785,10573
519405,0,0,0,4,12,16,40.746658,-73.881896,11373
40067,8,12,39,16,0,75,41.445552,-74.41703,10940
72333,0,0,0,4,12,16,40.687292,-73.830273,11419
251902,0,0,0,4,12,16,40.746924,-73.361626,11798
757660,0,0,0,2,6,8,43.114938,-79.047916,14305
29905,0,0,0,2,6,8,41.720189,-73.851711,12603
695510,5,5,8,3,0,21,41.103771,-73.937154,10989
160947,0,0,0,4,12,16,42.930824,-76.549621,13021
744768,0,0,0,30,0,30,40.843185,-73.894925,10457
441669,0,0,0,0,12,12,40.805396,-73.957315,10026
830692,0,0,0,4,12,16,40.831845,-73.930254,10452
872320,0,0,0,0,6,6,40.853203,-73.9089,10453
4647,0,0,0,2,12,14,41.01537,-73.837593,10502
709926,0,0,0,111,0,111,40.674995,-73.736625,11422
341947,0,0,0,85,0,85,40.61801,-74.132845,10314
262870,16,24,37,58,0,135,43.058424,-76.032162,13057
804045,0,0,0,2,12,14,40.835365,-73.915668,10456
39309,12,12,39,0,0,63,44.689716,-73.47038,12901
288108,0,0,0,4,12,16,40.66181,-73.89702,11207
589615,0,0,0,4,12,16,40.930717,-73.893669,10701
876990,0,0,320,0,0,320,42.99661,-78.844683,14150
848986,0,0,0,4,12,16,40.882646,-73.884063,10467
40561,0,0,63,0,0,63,41.041356,-73.749654,10604
769264,0,0,0,40,0,40,40.947584,-73.869584,10701
71553,0,0,0,0,12,12,40.840315,-73.913785,10452
785116,0,0,0,2,12,14,40.879437,-73.886068,10468
290977,0,0,0,2,6,8,40.820507,-73.904148,10456
843039,0,0,16,0,0,16,43.25602,-75.184262,13304
794166,0,0,0,2,6,8,44.57137,-75.144133,13617
756454,0,0,0,4,12,16,40.855195,-73.90815,10453
165669,0,0,20,0,0,20,44.080002,-73.512363,12956
411006,0,0,0,2,6,8,41.714899,-73.972233,12528
445048,0,0,0,1,6,7,40.682887,-73.954472,11216
445591,0,0,0,4,12,16,43.026837,-76.143988,13205
10434,0,0,0,2,6,8,43.108308,-75.276116,13495
635580,0,0,0,2,12,14,40.857467,-73.903196,10453
39167,16,36,42,28,0,122,42.654294,-73.749628,12207
44040,0,0,0,30,0,30,42.6367,-76.1789,13077
721458,0,0,0,4,12,16,42.934712,-78.020143,14525
359309,0,0,0,32,0,32,43.108204,-77.408582,14450
781845,0,0,0,4,12,16,40.871189,-73.885431,10458
72464,0,0,0,4,12,16,40.684462,-73.87117,11208
540688,0,0,62,0,0,62,42.097203,-79.270855,14701
799977,0,0,0,0,12,12,40.668916,-73.883208,11208
438878,0,0,0,4,12,16,42.082881,-76.79122,14904
2268,0,0,0,4,12,16,40.712997,-73.52772,11756
881126,0,0,0,4,12,16,40.844259,-73.866466,10462
591811,0,0,0,4,12,16,40.668815,-73.989377,11215
171491,0,0,0,24,0,24,41.547894,-73.865855,12524
111505,0,8,48,0,0,56,42.742092,-74.239667,12053
267488,0,0,0,14,0,14,40.912485,-73.822082,10552
521327,0,0,0,4,12,16,40.749134,-73.879284,11372
574796,0,0,0,4,12,16,42.940158,-78.803937,14215
791874,0,0,0,276,0,276,40.647879,-73.972852,11218
448651,0,0,107,0,0,107,42.646896,-73.75743,12207
840486,0,0,0,4,12,16,40.836275,-73.946914,10032
841510,0,0,0,4,12,16,40.793601,-73.230985,11717
74234,0,0,0,435,0,435,40.75588,-73.772459,11361
39491,0,0,135,0,0,135,42.894718,-78.886988,14201
819827,0,0,0,4,12,16,40.638028,-73.898734,11236
879135,0,0,0,2,6,8,42.8038,-73.7359,12047
735084,0,0,0,4,12,16,40.761836,-73.069084,11782
509784,0,0,0,2,12,14,40.850282,-73.832235,10461
858803,0,0,0,2,10,12,40.687147,-73.599658,11553
817490,0,0,0,4,12,16,40.806934,-73.850159,10473
771361,0,0,57,0,0,57,41.797842,-73.962111,12528
356870,16,48,77,32,0,173,40.901223,-73.08577,11733
867002,0,0,20,0,0,20,43.060292,-74.662703,13452
870688,0,0,0,2,6,8,42.724221,-73.777946,12211
42531,0,0,0,60,0,60,40.884515,-73.158497,11780
829074,0,0,0,19,0,19,42.83055,-77.87967,14539
275814,0,0,0,95,0,95,40.54782,-74.152115,10308
520851,0,0,0,4,12,16,40.727654,-73.783629,11432
355347,0,0,0,4,12,16,42.97865,-75.362315,13480
8459,0,0,0,2,6,8,42.721577,-78.005903,14530
398023,0,0,0,2,12,14,40.833284,-73.941466,10032
175521,0,0,0,2,6,8,43.489958,-73.748033,12845
720224,0,0,0,4,12,16,40.834797,-73.925085,10452
378654,0,0,0,4,12,16,40.623342,-73.928069,11234
40233,16,32,94,128,0,270,42.832069,-73.892,12309
719531,16,40,74,0,0,130,40.793067,-73.696753,11030
595026,0,0,0,2,12,14,40.670836,-73.986562,11215
842755,0,0,0,130,0,130,40.673568,-73.694074,11580
403645,0,0,0,4,12,16,40.711875,-73.735243,11429
814923,0,0,0,4,12,16,40.872651,-73.885312,10458
670297,0,0,0,4,12,16,40.847541,-73.939451,10033
395979,0,0,0,2,6,8,43.052219,-73.834487,12866
197338,0,0,0,2,6,8,40.797773,-73.251149,11717
671377,0,0,100,0,0,100,40.762114,-73.088017,11782
103357,0,0,0,4,12,16,43.131263,-78.99485,14305
33523,0,0,0,2,6,8,44.692151,-75.490278,13669
531751,0,0,0,4,12,16,40.706563,-73.774027,11423
565238,0,0,0,4,12,16,40.637451,-73.949878,11210
792684,0,0,0,4,12,16,43.185984,-77.618502,14621
831710,0,0,0,91,0,91,40.831208,-73.886724,10460
881641,8,8,8,0,0,24,42.562614,-77.696659,14437
189444,0,0,0,4,12,16,41.441002,-74.105957,12553
269674,0,0,0,2,12,14,40.675319,-73.878455,11208
709673,0,0,0,200,0,200,40.659545,-73.734726,11422
774751,0,0,0,4,12,16,40.926204,-73.830805,10552
581968,0,0,0,4,12,16,42.771013,-73.711236,12047
874654,0,0,0,4,12,16,40.788238,-73.819233,11357
481335,0,0,0,0,12,12,40.749871,-73.895187,11372
668728,0,0,0,4,12,16,40.743198,-73.858646,11368
257741,0,0,0,4,12,16,40.816856,-73.942878,10030
517886,0,0,0,4,12,16,40.832767,-73.914561,10456
353532,0,0,0,2,6,8,42.828406,-73.962278,12302
725503,0,0,0,0,12,12,40.842306,-73.892232,10457
44975,12,28,49,10,0,99,43.0608,-78.837208,14120
192786,0,0,0,190,0,190,40.706949,-73.945432,11206
773378,0,0,0,4,12,16,42.33392,-76.790277,14869
61977,0,0,0,2,6,8,40.671526,-73.927929,11213
486629,0,0,0,2,6,8,42.929788,-76.564618,13021
787647,0,0,0,4,12,16,40.883147,-73.89763,10463
272356,0,0,0,4,12,16,41.00351,-73.678848,10573
459617,0,0,0,4,12,16,40.835707,-73.911461,10456
852485,0,0,0,4,12,16,40.743898,-73.909056,11377
693011,0,0,0,120,0,120,40.654002,-73.894626,11207
780071,0,0,0,0,10,10,40.86857,-73.892061,10458
777112,0,24,41,0,0,65,40.781929,-73.733829,11021
868100,0,0,0,4,12,16,40.608551,-73.754208,11691
844097,0,0,0,63,0,63,40.758735,-73.892247,11369
45356,0,0,51,0,0,51,40.78603336,-73.14478522,11716
346827,0,0,0,4,12,16,40.750446,-73.809765,11355
765600,0,0,43,0,0,43,43.075885,-77.475862,14450
396866,0,0,0,126,0,126,40.886141,-73.845307,10466
693515,0,0,0,2,6,8,43.147854,-77.654807,14611
846806,0,0,0,4,12,16,40.862083,-73.919569,10034
870470,0,0,0,4,12,16,40.884543,-73.910558,10463
802707,0,0,0,4,12,16,40.684527,-73.881266,11208
40446,7,19,41,0,0,67,41.740246,-74.028622,12528
864478,0,0,0,4,12,16,40.908302,-73.865146,10704
628409,0,0,0,4,12,16,40.903164,-73.828865,10553
740782,0,0,0,4,12,16,40.854546,-73.898267,10457
795489,0,0,0,40,0,40,40.632601,-74.163301,10303
41345,0,0,0,70,0,70,40.967272,-73.717068,10528
749443,0,10,16,20,0,46,40.823029,-73.131394,11779
826434,0,0,0,4,12,16,40.631961,-73.976358,11218
682388,0,0,0,160,0,160,40.669473,-73.879455,11208
597436,0,0,0,250,0,250,40.739567,-73.330495,11703
347356,8,20,32,28,0,88,41.555435,-73.783673,12533
623441,0,0,0,4,12,16,40.84903,-73.92071,10453
350658,0,0,0,55,0,55,43.177131,-76.271622,13027
876802,0,0,0,0,12,12,41.129083,-74.074606,10952
778138,0,0,0,4,12,16,41.98826,-73.965105,12401
859884,0,0,0,0,12,12,40.8527,-73.900099,10457
803631,0,0,0,4,12,16,40.624793,-73.910879,11234
751520,0,0,0,4,12,16,40.849503,-73.890313,10457
832636,0,0,0,59,0,59,42.872541,-78.015225,14525
793225,0,0,0,4,12,16,40.643129,-73.591602,11520
306797,0,0,0,4,12,16,40.871763,-73.898976,10468
244602,0,0,0,111,0,111,40.536547,-74.163616,10312
400485,0,0,0,4,12,16,40.67951,-73.795828,11436
869545,0,0,0,2,6,8,40.835029,-73.875397,10472
877192,0,0,0,0,12,12,40.905794,-73.849044,10470
401768,0,0,0,4,12,16,40.856754,-73.929606,10040
286771,0,0,0,4,12,16,40.618014,-73.914549,11234
804186,0,0,0,4,12,16,40.595541,-73.796176,11692
796360,0,0,0,80,0,80,41.982596,-73.998944,12449
560998,0,0,0,2,12,14,43.026286,-76.148313,13205
552596,0,0,0,4,12,16,42.712982,-73.712581,12189
40882,0,0,0,44,0,44,42.719414,-78.834168,14075
409280,0,0,0,4,12,16,42.917129,-78.892797,14213
348736,0,0,0,0,10,10,40.83251,-73.910797,10456
122967,0,0,0,244,0,244,40.634169,-74.029072,11209
407333,0,0,0,44,0,44,42.994933,-78.954074,14072
816641,0,0,0,2,6,8,40.673724,-73.892985,11207
39824,0,0,0,93,0,93,40.68028,-73.549642,11566
73951,0,0,0,279,0,279,40.688797,-73.910046,11207
760907,0,0,0,4,12,16,40.827822,-73.831458,10465
462089,0,0,0,2,12,14,40.872219,-73.899774,10468
261081,0,0,0,4,12,16,40.684578,-73.410723,11701
709800,0,0,0,325,0,325,40.648768,-73.907506,11236
266308,0,0,0,2,6,8,40.953533,-73.893366,10701
873386,0,0,0,2,12,14,40.860001,-73.914412,10468
484840,0,0,0,4,12,16,40.761294,-73.870985,11369
105945,0,0,0,4,12,16,40.940557,-72.622594,11901
850955,0,0,0,4,12,16,40.808176,-73.91443,10454
701118,0,0,0,4,12,16,43.018243,-75.039264,13357
783965,0,0,0,0,10,10,40.815483,-73.904693,10455
766070,0,0,0,4,12,16,40.840164,-73.924445,10452
430777,0,0,0,30,0,30,40.694923,-73.951985,11206
882792,0,0,0,4,12,16,40.634467,-73.580071,11520
648394,0,0,0,4,12,16,40.721296,-73.822197,11367
795121,0,0,0,4,12,16,40.697034,-73.772212,11433
843192,0,0,0,4,12,16,40.707839,-73.332461,11702
878999,0,0,0,2,6,8,40.856943,-73.901747,10453
876246,16,24,72,20,0,132,43.155421,-77.606272,14604
43448,16,34,49,27,0,126,43.126104,-77.790005,14514
43822,8,24,31,0,0,63,42.708176,-78.932871,14085
664114,0,0,0,60,0,60,40.91733,-73.84968,10701
713800,0,0,0,40,0,40,41.603328,-73.708867,12570
308535,16,24,39,85,0,164,43.176229,-76.085179,13039
450339,0,0,42,24,0,66,40.74902,-73.69671,11040
527104,0,0,0,2,6,8,40.668186,-73.88708,11207
799267,0,0,0,4,12,16,40.687163,-73.588812,11575
790141,0,0,0,83,0,83,40.820853,-73.941606,10030
874589,0,0,0,160,0,160,40.629752,-74.147216,10303
875496,0,0,0,0,12,12,40.844478,-73.90957,10457
44764,0,0,0,37,0,37,40.758874,-73.656911,11596
140287,0,0,0,2,6,8,40.830994,-73.899715,10456
780922,0,0,0,4,12,16,40.836006,-73.912294,10456
535901,0,0,0,4,12,16,40.82677,-73.925507,10451
882831,0,0,0,4,12,16,40.815793,-73.936496,10037
827592,0,0,0,4,12,16,44.550926,-73.449106,12972
847582,0,0,0,2,6,8,41.608723,-74.140877,12589
764278,0,0,0,0,12,12,40.703249,-73.940363,11206
52620,0,0,0,2,6,8,40.823026,-73.918491,10451
877320,0,0,0,4,12,16,40.864671,-73.92692,10040
476031,0,0,0,4,12,16,40.812436,-73.917313,10454
845344,0,0,0,4,12,16,40.612548,-73.988724,11204
835822,0,0,0,4,12,16,43.076313,-76.121299,13206
879204,0,0,73,0,0,73,41.711759,-73.909026,12601
713102,0,0,0,0,10,10,40.855266,-73.903877,10453
7908,0,0,0,4,12,16,44.329096,-74.134411,12983
215109,0,0,0,2,5,7,40.822777,-73.951973,10031
245994,0,0,0,177,0,177,40.859957,-73.906047,10468
762711,0,0,0,4,12,16,41.706809,-73.918373,12601
541406,0,0,0,2,6,8,40.67912,-73.789757,11434
862745,0,0,0,40,0,40,43.084086,-76.132293,13208
867917,0,0,0,4,12,16,42.905811,-78.804798,14211
245774,0,0,0,200,0,200,40.858493,-73.887169,10458
543533,0,0,0,4,12,16,40.702605,-73.697569,11003
321160,0,0,18,0,0,18,43.071275,-73.781241,12866
855204,0,0,0,0,12,12,40.838885,-73.918084,10452
358018,0,0,0,4,12,16,42.892428,-78.855144,14204
783304,0,0,0,4,12,16,40.678252,-73.892831,11207
756907,0,0,0,2,6,8,42.898077,-78.845575,14211
557383,0,0,0,4,12,16,40.674587,-73.997972,11231
329041,0,0,18,93,0,111,40.713158,-73.991349,10002
39631,16,22,30,10,0,78,43.069138,-77.605834,14623
769187,0,0,0,4,12,16,40.531693,-74.194932,10312
149573,0,0,0,2,6,8,42.177213,-76.881179,14845
828162,0,0,0,4,12,16,40.72663,-73.877875,11379
731123,0,0,0,4,12,16,40.770135,-73.773849,11361
43705,8,25,30,0,0,63,40.67681,-73.66597,11565
350967,0,0,0,4,12,16,40.679837,-73.889193,11207
826163,0,0,0,4,12,16,43.05114,-76.094758,13224
35410,0,0,0,2,6,8,42.902717,-73.93941,12019
391003,0,0,0,4,12,16,40.88011,-73.876115,10467
243182,0,0,0,2,12,14,40.665119,-73.873064,11208
748354,0,0,0,4,12,16,40.683797,-73.694169,11580
608560,0,0,0,4,12,16,40.602979,-73.663057,11558
578503,0,0,0,4,12,16,40.829626,-73.898869,10459
716227,0,0,0,4,12,16,40.869089,-73.922762,10034
362686,0,0,0,2,6,8,42.672091,-73.671087,12198
166273,0,0,0,4,12,16,40.71154173,-73.70383332,11003
590487,0,0,0,4,12,16,40.760331,-73.918804,11103
689634,0,0,0,60,0,60,40.646082,-74.087954,10301
109289,0,0,0,2,6,8,42.815724,-75.426835,13355
43688,16,10,28,3,0,57,42.990903,-78.85331,14150
28297,0,0,0,2,6,8,44.454526,-73.587814,12944
344265,0,0,0,4,12,16,40.822874,-73.954144,10031
741070,0,12,36,0,0,48,42.5887,-76.1798,13045
339618,0,0,0,150,0,150,40.726236,-73.949696,11222
217241,0,0,0,200,0,200,40.887748,-73.859806,10466
776217,0,18,0,0,0,18,41.164377,-73.988349,10956
489529,0,0,0,4,12,16,40.813027,-73.901705,10455
128111,0,0,0,2,6,8,43.242471,-76.537563,13033
747231,22,12,33,18,0,85,42.81235,-73.9171,12308
790340,0,0,0,4,12,16,40.765682,-73.120195,11716
42459,0,0,0,40,0,40,43.040319,-76.233835,13219
833925,0,0,0,4,12,16,40.73249,-73.75863,11427
228621,0,0,0,4,12,16,40.645127,-73.905422,11236
369742,0,0,30,0,0,30,42.328447,-77.664611,14843
459006,0,0,0,2,6,8,40.83118,-73.93607,10039
346627,0,0,0,4,12,16,40.604638,-73.75581,11691
650184,0,0,0,4,12,16,40.678707,-73.969966,11238
41504,0,0,0,30,0,30,43.274335,-78.696505,14108
612252,0,0,0,4,12,16,40.641046,-73.94062,11203
796135,0,0,0,298,0,298,40.688628,-73.836028,11419
880314,0,0,0,327,0,327,40.744736,-73.978219,10016
709846,0,0,0,163,0,163,40.831565,-73.87768,10472
212566,0,0,0,2,6,8,40.883136,-73.832714,10475
759392,0,0,0,60,0,60,41.849259,-74.536444,12740
318269,0,0,0,0,10,10,40.691958,-73.618034,11550
820056,0,0,0,4,12,16,40.591044,-73.798131,11692
842439,0,0,0,4,12,16,40.844744,-73.866174,10462
871102,0,0,0,4,12,16,41.036241,-73.78406,10606
413138,0,0,0,4,12,16,40.66575,-73.955458,11225
832360,16,23,14,12,0,65,41.778635,-74.073566,12561
660252,0,0,0,4,12,16,40.871867,-73.842246,10469
873937,0,0,0,4,12,16,40.825121,-73.95173,10031
881530,0,0,0,4,12,16,42.304421,-75.428317,13733
44891,16,24,49,0,0,89,40.791968,-73.644619,11577
791543,0,0,0,2,6,8,40.847342,-73.933536,10033
40820,24,34,123,107,0,288,42.087599,-75.952801,13850
537296,0,0,0,4,12,16,40.803131,-73.265937,11717
711304,0,0,100,0,0,100,40.766194,-73.587328,11590
868622,0,0,0,133,0,133,43.149605,-77.435958,14526
683803,0,0,0,4,12,16,40.790892,-73.838629,11356
666601,0,0,0,4,12,16,40.745163,-73.276529,11706
858372,0,0,0,4,12,16,40.670885,-73.656982,11570
639652,0,0,23,7,0,30,41.625669,-73.875129,12590
302935,0,0,0,4,12,16,41.020333,-73.766268,10605
836698,0,0,0,2,6,8,41.655704,-73.890725,12603
616694,0,0,0,4,12,16,40.658516,-73.89444,11207
878416,0,0,0,4,12,16,40.829371,-73.944804,10031
742590,16,30,30,0,0,76,41.669897,-73.836525,12603
882508,0,0,0,145,0,145,40.785951,-73.817348,11357
699059,16,24,39,20,0,99,41.560973,-73.796107,12533
273524,0,0,0,4,12,16,42.903055,-78.814749,14211
72017,0,0,0,4,12,16,40.866974,-73.888464,10458
218934,16,24,39,20,0,99,43.035356,-78.808241,14228
42611,4,12,13,30,0,59,42.933721,-78.901558,14207
880784,0,0,0,40,0,40,40.663148,-73.70886,11581
669684,0,0,0,105,0,105,40.866585,-73.923778,10034
821990,0,0,0,4,12,16,41.199308,-73.978682,10927
880490,0,0,0,4,12,16,41.050166,-73.820972,10523
775577,0,0,0,4,12,16,42.903341,-77.291976,14424
302813,0,0,0,4,12,16,40.764505,-73.770786,11361
766614,0,0,0,56,0,56,40.830903,-73.494258,11791
785395,0,0,0,4,12,16,40.776141,-73.270307,11717
851420,0,0,0,2,6,8,44.731908,-73.647929,12962
339146,0,0,0,123,0,123,40.61364,-73.930109,11234
73988,0,0,0,192,0,192,40.677102,-74.011444,11231
495054,0,0,0,0,12,12,40.863807,-73.90571,10468
309956,0,0,0,2,6,8,40.84772,-73.919784,10453
729468,0,0,0,2,6,8,43.182732,-77.611955,14621
733761,0,0,0,54,0,54,41.073348,-73.860039,10591
853137,0,0,0,37,0,37,40.64372,-74.108732,10310
870207,8,19,41,13,0,81,41.383869,-73.72556,10541
709896,0,0,0,126,0,126,40.800877,-73.939368,10035
868190,0,0,54,0,0,54,40.847766,-73.410836,11746
846695,0,0,0,2,6,8,42.995221,-77.636906,14543
575473,0,0,0,4,12,16,40.684603,-73.88282,11208
410615,0,0,0,2,6,8,40.851747,-73.895561,10457
44661,16,26,39,17,0,98,42.977674,-78.667098,14221
760375,0,0,0,4,12,16,40.666211,-73.930544,11213
813362,0,0,0,4,12,16,43.032463,-76.163701,13207
229521,0,0,0,4,12,16,43.18035,-77.623277,14621
352833,0,0,0,4,12,16,40.65053,-73.926111,11203
819392,0,0,36,0,0,36,43.073957,-76.148843,13208
855549,0,0,0,4,12,16,40.808228,-73.9144,10454
820692,0,0,0,2,6,8,42.946812,-78.798621,14215
878896,0,0,0,4,12,16,40.841404,-73.885327,10460
869897,0,0,0,4,12,16,40.81448,-73.916316,10455
203883,0,0,0,2,6,8,40.711555,-73.705189,11003
753267,0,0,0,2,12,14,40.844414,-73.904689,10457
196359,0,0,0,4,12,16,40.864551,-73.921356,10034
784890,0,0,0,110,0,110,40.755887,-73.473704,11714
432382,0,0,0,2,12,14,40.825181,-73.879166,10472
55894,0,0,0,2,6,8,40.823113,-73.88895,10459
868892,0,0,0,40,0,40,41.251863,-74.351538,10990
36659,0,0,0,2,6,8,42.361146,-76.758412,14869
780996,0,0,0,4,12,16,40.803459,-73.956278,10026
641959,0,0,0,4,12,16,40.749062,-73.789352,11365
877465,0,0,0,4,12,16,40.635292,-73.990787,11219
280908,0,0,0,4,12,16,40.719503,-73.319482,11703
661260,0,0,0,4,12,16,40.70221,-73.808891,11435
825674,0,0,0,4,12,16,43.190074,-77.58172,14621
777901,0,0,0,4,12,16,40.860386,-73.926937,10040
824234,0,0,0,0,10,10,42.922046,-78.863235,14209
601595,0,0,0,2,12,14,40.816407,-73.807644,10465
845667,0,0,0,2,6,8,42.896262,-77.904367,14486
866807,0,0,106,0,0,106,42.132314,-76.064637,13760
841220,0,0,0,4,12,16,40.834435,-73.920722,10452
663055,0,0,86,0,0,86,40.763796,-72.84926,11951
843265,0,0,0,4,12,16,41.558712,-74.13468,12586
100645,16,33,49,24,0,122,42.881305,-78.678138,14086
40036,24,36,105,0,0,165,43.044871,-76.073166,13214
592958,0,0,0,4,12,16,40.854927,-73.901994,10453
596773,0,0,0,2,12,14,40.859535,-73.894457,10458
752851,0,0,0,2,6,8,40.70914,-73.99898,10038
12432,0,0,0,2,10,12,42.917267,-78.825546,14215
737660,0,0,0,2,6,8,40.661746,-73.897917,11207
837608,0,0,0,4,12,16,40.856723,-73.92697,10040
334783,0,0,0,60,0,60,40.745755,-73.632621,11501
818014,0,0,0,4,12,16,40.669016,-73.845034,11414
681712,0,0,0,4,12,16,40.853143,-73.913938,10453
822830,0,0,0,2,6,8,42.930315,-78.815103,14215
40689,0,0,0,60,0,60,42.600676,-73.706104,12061
644771,0,0,0,85,0,85,40.66402,-73.927679,11212
223170,0,0,0,4,12,16,40.564277,-74.181501,10312
872682,0,0,0,44,0,44,42.796049,-78.823744,14219
41126,0,0,0,80,0,80,42.731783,-73.838832,12205
42848,64,0,0,0,0,64,42.469173,-79.318549,14048
646079,0,0,0,4,12,16,40.814371,-73.864975,10473
765977,0,0,0,2,6,8,43.192528,-77.644814,14615
686503,0,0,0,4,12,16,40.868732,-73.852611,10469
40391,6,21,20,0,0,47,40.896923,-73.308164,11768
717006,0,0,0,180,0,180,40.58095,-73.831671,11694
786989,0,0,0,2,6,8,40.846551,-73.863544,10462
44427,12,17,18,0,0,47,43.085284,-75.752491,13032
857390,0,0,0,45,0,45,40.761818,-73.95005,10044
741672,0,0,0,4,12,16,40.848129,-73.935989,10033
651784,0,0,0,4,12,16,40.847272,-73.915475,10453
860864,0,0,0,0,12,12,40.84878,-73.907274,10453
787784,0,0,0,4,12,16,41.132784,-74.03682,10977
202073,0,0,0,238,0,238,40.697488,-73.91402,11237
468318,0,0,0,4,12,16,43.287405,-78.824329,14172
349674,0,0,0,4,12,16,41.115884,-74.070155,10952
868699,0,0,0,0,10,10,40.812238,-73.920944,10454
740575,0,0,0,4,12,16,40.874221,-73.885589,10458
768254,0,0,0,4,12,16,40.842016,-73.911192,10457
873639,0,0,53,0,0,53,41.515705,-74.024579,12550
677681,0,0,0,4,12,16,40.677538,-73.874153,11208
151462,0,0,0,4,12,16,40.729749,-73.866677,11374
876595,0,0,0,4,12,16,40.761814,-73.863964,11369
204119,0,0,0,2,6,8,40.772299,-73.004958,11772
642749,0,0,0,2,6,8,43.310553,-73.65692,12801
193278,0,0,0,16,0,16,40.639947,-73.954046,11226
828330,0,0,0,4,12,16,41.161228,-73.860061,10562
223832,0,22,82,15,0,119,43.077144,-75.264145,13501
866614,0,0,0,1,12,13,40.827263,-73.907628,10456
624524,0,0,0,0,12,12,40.878532,-73.857583,10469
480353,0,0,0,2,6,8,42.365365,-77.158121,14879
24068,0,0,0,4,12,16,40.763314,-73.564052,11590
821761,0,0,0,4,12,16,40.7657,-73.876602,11369
830620,0,0,0,160,0,160,40.826073,-73.938198,10039
734650,0,8,83,0,0,91,40.663601,-73.644956,11570
44537,16,30,269,0,0,315,40.77345,-73.493145,11803
786694,0,0,0,4,12,16,40.790493,-73.227816,11717
244026,0,0,0,4,12,16,40.679382,-73.972031,11217
698060,0,0,0,4,12,16,40.822762,-73.950847,10031
159006,0,0,0,4,12,16,40.596584,-73.798286,11692
524418,16,24,100,7,0,147,43.084675,-77.605611,14623
851678,0,0,0,2,6,8,40.801239,-73.95055,10026
844247,0,0,0,4,12,16,40.657447,-73.880865,11207
788489,0,0,0,4,12,16,40.767781,-73.875302,11369
422352,0,0,0,4,12,16,40.662257,-73.986707,11215
828824,0,0,0,4,12,16,40.748812,-73.698836,11040
779375,0,0,0,4,12,16,43.182459,-77.569972,14609
823706,0,0,0,4,12,16,41.15234,-74.062592,10977
42299,0,0,0,23,0,23,42.705825,-76.420619,13118
39236,0,0,36,0,0,36,42.114939,-75.93793,13905
240526,0,0,0,240,0,240,41.01741,-72.155001,11937
466754,0,0,0,2,6,8,43.119514,-77.815242,14514
534922,0,0,0,4,12,16,40.856413,-73.933742,10040
645551,0,0,0,219,0,219,40.715264,-73.956841,11211
867705,8,10,0,0,0,18,43.248155,-77.698225,14612
544194,0,0,0,4,12,16,42.978607,-75.340332,13480
879284,0,0,0,0,7,7,40.877515,-73.88201,10467
685436,0,0,0,80,0,80,40.635838,-74.117709,10310
845934,0,0,0,104,0,104,40.833828,-73.031507,11738
500686,0,0,0,0,10,10,40.815032,-73.906325,10455
709682,0,0,0,266,0,266,40.700664,-73.781951,11433
22363,0,0,0,4,12,16,42.155719,-77.795484,14806
856497,0,0,0,2,6,8,43.175242,-77.577118,14609
41692,0,0,199,0,0,199,41.057158,-73.993138,10965
849151,0,0,0,0,12,12,40.688771,-73.942585,11221
847952,0,0,0,2,6,8,42.332427,-78.863098,14719
770162,0,0,0,4,12,16,41.175205,-73.847531,10562
763268,0,0,0,2,6,8,40.911037,-73.817029,10553
16576,0,0,0,2,5,7,43.134506,-77.627343,14608
408888,0,0,0,2,12,14,40.711692,-73.905919,11385
850062,0,0,0,4,12,16,40.682702,-73.927811,11233
40706,0,20,63,0,0,83,40.938068,-73.090445,11733
743070,0,0,0,4,12,16,40.856094,-73.903056,10453
383666,0,0,0,4,12,16,40.633442,-74.142443,10302
345902,0,11,61,0,0,72,40.65631,-73.669608,11563
226853,0,0,0,4,12,16,40.655912,-73.74514,11422
755297,0,0,0,15,0,15,40.643686,-73.900268,11236
869155,0,0,0,65,0,65,42.878238,-78.877675,14202
120660,0,0,0,4,12,16,40.837322,-73.946567,10032
739360,0,0,0,4,12,16,40.86739,-73.892954,10458
853445,0,0,0,21,0,21,40.615666,-74.078885,10304
70989,0,0,0,2,6,8,40.808498,-73.916525,10454
854007,32,36,69,8,0,145,41.33754,-73.78438,10598
664773,0,0,0,4,12,16,40.657134,-73.895149,11207
700432,0,0,0,4,12,16,40.703174,-73.602588,11550
605703,0,0,0,4,12,16,40.874618,-73.874064,10467
867540,0,0,0,61,0,61,40.793782,-73.946902,10029
688790,0,0,0,2,6,8,40.737973,-73.873323,11373
440903,0,0,0,4,12,16,40.67212,-73.867052,11208
45071,0,0,0,340,0,340,40.7014,-73.702241,11003
219742,0,0,0,4,12,16,42.969301,-73.777811,12020
295838,0,0,0,70,0,70,43.151079,-76.277567,13027
880557,0,0,0,50,0,50,42.479689,-76.47821,14850
821910,0,0,0,4,12,16,40.824235,-73.87588,10472
26780,0,0,0,2,6,8,42.835728,-73.962757,12302
426728,0,0,0,4,12,16,40.723039,-73.279575,11706
715117,0,0,34,0,0,34,43.063161,-76.126785,13203
163477,0,0,0,2,10,12,40.62899,-73.929717,11234
872030,0,0,0,4,12,16,40.861219,-73.928883,10040
874508,0,0,47,0,0,47,42.773345,-73.703622,12047
235008,0,0,0,4,12,16,40.832745,-73.684628,11050
746309,0,0,0,4,12,16,40.873091,-73.898896,10468
871800,0,0,0,2,6,8,42.367546,-75.644786,13830
278399,0,0,0,124,0,124,40.751579,-73.885344,11372
177249,8,20,32,0,0,60,42.585077,-76.369789,13073
361024,0,0,0,4,12,16,40.860386,-73.926937,10040
829348,0,0,0,2,6,8,40.750591,-73.268119,11706
822562,0,0,0,109,0,109,40.807803,-73.955813,10027
824841,8,36,50,0,0,94,40.815649,-73.501013,11791
820866,0,0,0,4,12,16,40.878872,-73.845522,10469
585596,0,0,0,2,6,8,43.152678,-77.63375,14611
152593,0,0,0,2,6,8,43.086605,-77.443741,14450
30909,0,0,0,2,5,7,44.678232,-73.462584,12901
709647,0,0,0,173,0,173,40.671985,-73.984151,11215
816252,0,0,0,80,0,80,40.88019,-73.036802,11784
174795,0,0,0,162,0,162,40.828106,-73.636701,11545
798219,0,0,0,4,12,16,41.206566,-73.986814,10993
878240,0,0,0,4,12,16,41.700704,-73.853808,12603
206797,0,0,0,230,0,230,41.029914,-73.956417,10983
233257,0,0,0,107,0,107,40.71816,-73.981774,10002
654125,0,0,68,0,0,68,42.862599,-73.794393,12065
547885,0,0,0,4,12,16,40.704904,-73.943968,11206
877266,0,0,0,100,0,100,43.987057,-75.901849,13601
838044,0,0,0,4,12,16,40.685094,-73.996678,11231
712198,0,0,0,4,12,16,40.768766,-73.877547,11369
356304,0,0,0,4,12,16,40.631059,-73.935131,11210
210806,0,0,0,80,0,80,42.473256,-76.467982,14850
529679,0,0,0,4,12,16,41.927826,-73.998167,12401
801177,0,0,0,4,12,16,40.860901,-73.857915,10469
830215,0,35,55,18,0,108,40.731099,-73.689064,11040
127878,0,0,0,44,0,44,42.857132,-73.787682,12065
221519,0,0,0,75,0,75,42.729352,-73.685799,12180
264979,0,0,0,4,12,16,40.760516,-73.563953,11590
882859,0,0,0,4,12,16,42.654598,-73.800347,12208
587855,0,0,0,4,12,16,40.682473,-73.844853,11417
41332,16,36,39,0,0,91,40.967672,-73.881446,10701
268930,0,0,0,0,12,12,40.833994,-73.915617,10456
234214,0,0,0,4,12,16,43.223162,-77.367663,14519
559402,6,9,13,18,0,46,41.318138,-73.895708,10567
847326,0,0,0,4,12,16,40.664068,-73.95958,11225
772930,0,0,0,2,12,14,40.807133,-73.918589,10454
822568,0,0,94,0,0,94,43.112636,-75.403061,13490
839532,0,0,0,2,6,8,40.86297,-73.923946,10034
338396,0,0,37,20,0,57,40.956885,-73.806562,10709
211712,0,0,0,4,12,16,40.711347,-73.699233,11003
416503,16,24,44,0,0,84,42.894227,-78.888357,14201
757360,0,0,0,4,12,16,40.891086,-73.86189,10466
762008,0,0,0,4,12,16,40.836187,-73.918138,10452
674930,0,0,0,2,6,8,40.666938,-73.860478,11208
43922,0,0,0,100,0,100,41.020686,-73.759293,10605
843616,0,0,0,2,12,14,40.848229,-73.932919,10033
622443,0,0,0,4,12,16,40.630309,-73.99367,11219
456073,0,0,0,0,12,12,40.835987,-73.884497,10460
73331,0,0,0,31,0,31,40.667519,-73.944854,11213
759170,0,0,0,4,12,16,40.835682,-73.929442,10452
114372,0,0,0,2,6,8,43.228252,-75.058334,13431
675854,0,0,0,4,12,16,40.873101,-73.885436,10458
808244,0,0,0,4,12,16,40.868487,-73.900706,10468
43074,0,0,0,60,0,60,43.176191,-76.105808,13039
848795,0,0,0,2,6,8,43.313131,-76.393893,13069
39324,0,0,38,0,0,38,42.316785,-75.39017,13838
861149,0,0,0,4,12,16,40.654455,-73.877568,11239
651995,0,0,0,2,12,14,40.831096,-73.858165,10472
377478,0,0,0,4,12,16,40.6663,-73.660698,11563
861125,0,36,0,0,0,36,41.435505,-74.032473,12518
657595,0,0,0,4,12,16,40.637892,-73.891761,11236
300414,0,0,0,4,12,16,41.437014,-74.409214,10940
679668,0,0,0,4,12,16,40.860876,-73.901416,10468
769684,15,20,35,0,0,70,41.251051,-73.683803,10536
702570,0,0,0,4,12,16,40.656362,-73.898386,11207
72656,0,0,0,0,10,10,40.627821,-74.121648,10310
485938,0,0,0,509,0,509,40.706359,-74.017652,10280
837640,0,0,0,4,12,16,40.677428,-73.84737,11417
332105,0,0,0,4,12,16,40.68483,-73.837529,11416
879443,0,0,0,2,6,8,40.960165,-73.867594,10710
882083,0,0,0,0,12,12,40.838008,-73.926227,10452
357642,0,0,0,2,5,7,40.83118,-73.93607,10039
777632,0,0,0,4,12,16,41.543953,-74.236342,12549
258853,0,0,0,4,12,16,40.668352,-73.589004,11520
733045,0,0,0,2,6,8,40.657458,-73.876198,11207
318437,0,0,0,4,12,16,40.649777,-73.947353,11226
43359,0,0,44,0,0,44,42.040061,-74.143763,12498
706169,0,0,0,88,0,88,40.708334,-73.804129,11432
835595,0,0,0,4,12,16,40.641952,-74.011413,11220
656097,0,0,0,0,6,6,40.848665,-73.888179,10457
744199,0,0,0,4,12,16,40.552307,-74.158737,10308
852222,0,0,0,2,6,8,43.056077,-76.130202,13203
649435,0,0,0,4,12,16,40.838161,-73.8634,10462
41028,16,24,18,0,0,58,40.789862,-73.720484,11021
499582,0,0,0,2,12,14,40.841274,-73.915924,10452
466226,0,0,0,4,12,16,40.842716,-73.892266,10457
54669,0,0,0,0,6,6,40.813863,-73.916922,10455
771997,0,0,0,0,12,12,40.608529,-74.002798,11214
821241,0,0,0,2,6,8,40.826737,-73.152951,11788
601487,0,0,0,0,4,4,40.852797,-73.932982,10033
556466,0,0,0,2,12,14,42.688835,-78.780063,14075
803921,0,0,0,4,12,16,40.923498,-73.897258,10705
620570,24,36,73,20,0,153,40.858055,-73.19553,11787
802155,0,0,0,4,12,16,40.853925,-73.869064,10462
735649,0,0,0,40,0,40,43.067227,-76.031267,13057
797477,0,0,0,42,0,42,44.199803,-75.610416,13608
730265,0,0,0,4,12,16,40.644369,-74.001814,11220
155165,0,0,0,2,6,8,42.730117,-73.741518,12110
867225,0,0,0,4,12,16,40.833044,-73.910967,10456
298773,0,0,0,4,12,16,40.621534,-73.926284,11234
38505,0,0,0,2,6,8,42.536603,-76.455272,13068
181954,0,0,0,4,12,16,42.478343,-73.810463,12143
73512,0,0,0,140,0,140,40.793421,-73.938802,10029
811621,0,0,0,4,12,16,40.642242,-74.004336,11220
42942,0,0,0,40,0,40,42.099196,-75.930314,13905
354266,0,0,0,278,0,278,40.674591,-73.790011,11434
42974,8,28,20,30,0,86,43.221864,-79.017439,14174
187574,0,55,180,80,0,315,40.873961,-73.417527,11743
262566,0,0,0,4,12,16,40.662905,-73.886155,11207
179966,0,0,0,60,0,60,43.11822,-75.213701,13502
880129,0,0,0,0,12,12,40.830128,-73.901414,10456
72372,0,0,0,4,12,16,40.863193,-73.927801,10040
842021,12,12,42,0,0,66,40.807254,-72.820568,11955
797483,0,0,0,200,0,200,43.958988,-75.912139,13601
73660,0,0,0,138,0,138,40.83895,-73.936622,10032
665772,0,0,0,4,12,16,40.827291,-73.87124,10472
774251,0,0,0,44,0,44,40.787042,-73.193513,11722
190608,0,0,0,2,10,12,43.020238,-76.131713,13210
857387,0,0,0,4,12,16,40.825848,-73.889306,10459
788797,0,0,0,4,12,16,40.800904,-73.966436,10025
583925,0,0,0,4,12,16,41.131785,-74.020406,10956
27899,0,0,0,4,12,16,41.089705,-74.003053,10954
628117,0,0,0,40,0,40,40.961192,-73.837704,10710
453948,0,0,0,4,12,16,43.12684,-75.450759,13440
275329,0,0,0,41,0,41,43.318475,-73.578327,12839
726516,0,0,0,44,0,44,44.929507,-74.07879,12920
326177,0,0,0,2,6,8,40.689265,-73.71927,11003
625915,0,0,0,4,12,16,40.862083,-73.919569,10034
816773,0,0,0,4,12,16,40.700036,-73.983288,11201
880095,0,0,0,0,12,12,40.86379,-73.902635,10468
72856,0,0,0,59,0,59,40.805938,-73.918537,10454
778439,0,0,0,4,12,16,40.667817,-73.984322,11215
814648,0,0,0,60,0,60,40.659565,-73.946221,11203
875337,0,0,0,70,0,70,42.853005,-73.7948,12065
839999,0,0,0,4,12,16,40.843428,-73.882195,10460
37605,0,0,0,4,12,16,40.95244,-73.861956,10701
881253,0,0,0,2,10,12,40.817952,-73.924186,10451
724394,0,0,0,170,0,170,40.922321,-73.900134,10705
39552,8,15,17,0,0,40,44.296721,-74.093431,12977
788379,0,0,0,2,6,8,40.793981,-73.944035,10029
849911,0,0,0,4,12,16,40.64764,-73.577689,11520
667485,0,0,0,4,12,16,40.851899,-73.93209,10033
10903,0,0,0,2,6,8,43.072358,-75.327925,13413
40190,0,0,0,44,0,44,42.905727,-73.938303,12019
872114,0,0,0,4,12,16,42.820649,-73.993563,12306
735,0,0,0,2,6,8,42.827913,-78.690647,14059
104712,0,0,0,4,12,16,42.169007,-76.82793,14845
703554,0,0,0,4,12,16,40.703195,-73.813787,11435
523235,0,0,0,4,12,16,40.667183,-73.984849,11215
874284,0,0,0,4,12,16,43.14652,-77.657967,14611
730526,0,0,0,300,0,300,40.723356,-73.976493,10009
482866,0,0,0,4,12,16,40.681699,-73.754288,11413
781679,0,0,0,4,12,16,40.848406,-73.905361,10457
239143,0,0,0,2,12,14,40.846975,-73.895217,10457
768507,0,0,0,157,0,157,40.763877,-73.948116,10044
709836,0,0,0,149,0,149,40.63493,-73.981678,11204
545730,0,0,0,4,12,16,40.677319,-73.57753,11575
399824,0,0,0,160,0,160,40.694714,-73.988501,11201
44064,0,0,37,0,0,37,42.704352,-76.419853,13118
29121,0,0,0,2,5,7,42.593454,-76.366795,13073
451542,0,0,0,4,12,16,40.885256,-73.866125,10467
158699,0,0,0,2,6,8,40.830713,-73.945337,10031
828726,0,0,0,76,0,76,40.641732,-74.085513,10301
779043,0,0,0,213,0,213,40.715216,-73.852933,11375
252754,0,0,0,4,12,16,40.598011,-73.988082,11214
844429,0,0,0,4,12,16,43.179909,-77.604978,14621
599306,0,0,0,2,6,8,40.920315,-73.850164,10704
109496,0,0,0,4,12,16,40.814922,-73.947503,10027
261462,0,0,0,4,12,16,40.645753,-73.963518,11226
877760,0,0,0,4,12,16,42.841484,-77.303591,14424
875114,0,0,0,191,0,191,40.745225,-73.829164,11355
833625,0,0,0,4,12,16,44.985146,-73.446361,12919
351915,0,0,0,90,0,90,41.956617,-75.280395,13783
41032,11,12,19,10,0,52,43.153539,-77.590331,14607
505555,0,0,0,2,6,8,43.178405,-77.634589,14613
34214,0,0,0,4,12,16,40.761407,-73.068823,11782
572061,0,0,0,4,12,16,40.831214,-73.848004,10462
725047,0,0,0,2,6,8,43.178332,-77.580445,14609
261856,0,0,0,4,12,16,40.665373,-73.765981,11434
406697,0,0,0,2,6,8,40.713191,-73.527718,11756
39842,0,0,76,0,0,76,40.619121,-73.737155,11559
875437,0,0,0,4,12,16,43.132196,-77.647496,14619
731782,0,0,0,0,12,12,40.838884,-73.928399,10452
455523,0,0,0,4,12,16,40.873835,-73.901859,10468
720400,0,0,0,4,12,16,40.736973,-73.908813,11377
867051,0,0,17,0,0,17,42.625223,-75.340285,13411
815794,0,0,0,4,12,16,43.052968,-78.977447,14072
284380,0,12,32,0,0,44,40.781753,-73.483993,11803
42220,0,32,79,0,0,111,41.017123,-73.668779,10573
810165,0,0,0,4,12,16,40.85701,-73.902735,10453
809125,0,0,0,123,0,123,40.680623,-73.926255,11233
40586,0,12,101,0,0,113,41.021946,-73.746959,10605
562903,0,0,0,4,12,16,40.669777,-73.817552,11420
877038,0,0,0,2,6,8,43.149187,-75.560634,13478
392847,0,0,0,4,12,16,40.86416,-73.901488,10468
43326,0,12,36,0,0,48,43.063978,-76.989215,14489
113817,16,24,53,81,0,174,43.144274,-76.115805,13039
528297,0,0,0,2,12,14,40.839987,-73.883803,10460
39439,24,36,39,0,0,99,42.916263,-78.900107,14213
589050,0,0,0,4,12,16,40.854294,-73.917505,10453
400765,0,0,0,4,12,16,40.872654,-73.826142,10475
663356,0,0,0,4,12,16,40.704069,-73.485703,11783
842314,0,0,0,2,12,14,40.851758,-73.908156,10453
253987,0,0,0,4,12,16,40.628204,-73.930211,11234
789919,0,0,0,0,12,12,40.677787,-73.950346,11216
849150,0,0,0,4,12,16,40.843755,-73.941165,10032
461219,0,0,217,0,0,217,41.024984,-73.778992,10606
249551,0,24,54,0,0,78,43.449741,-76.534116,13126
807060,0,0,0,137,0,137,40.831806,-73.8787,10472
744778,0,0,0,89,0,89,40.79501,-73.945291,10029
402357,6,12,21,4,0,43,41.660347,-73.889862,12603
652364,0,0,0,25,0,25,40.702123,-73.812678,11435
790580,0,0,0,0,12,12,40.895517,-73.855308,10466
330490,0,0,0,0,12,12,40.81648,-73.909834,10455
276598,0,0,231,0,0,231,40.807077,-73.481858,11797
14326,0,0,0,0,12,12,40.676939,-73.651279,11552
607763,0,0,0,146,0,146,40.682541,-73.955329,11216
737100,0,0,0,32,0,32,40.676713,-74.00449,11231
744961,0,0,0,200,0,200,40.758591,-73.939372,11101
40465,0,0,0,45,0,45,43.329498,-73.690596,12804
32909,0,0,0,2,6,8,42.805506,-73.918726,12308
43933,0,48,70,0,0,118,40.795397,-73.741993,11023
415950,0,0,0,4,12,16,40.676433,-73.984019,11215
567811,0,0,0,4,12,16,41.537478,-74.210257,12549
654681,0,0,0,4,12,16,40.840039,-73.925061,10452
205873,8,12,116,0,0,136,40.829758,-72.996089,11763
617412,0,0,0,4,12,16,40.828672,-73.894537,10459
30723,0,0,0,2,6,8,42.739721,-73.654904,12180
427122,0,0,0,0,6,6,40.650795,-73.964148,11226
836325,0,0,0,217,0,217,40.694046,-73.790794,11433
793108,0,0,75,0,0,75,40.756462,-73.361483,11798
101721,0,0,0,131,0,131,40.865578,-73.924758,10034
282285,0,0,0,4,12,16,40.802791,-73.935384,10035
271115,0,0,0,4,12,16,43.388207,-73.314399,12832
257997,0,0,0,4,12,16,40.60822,-73.966213,11223
340240,0,0,0,4,12,16,40.751564,-73.560355,11590
731840,0,0,0,2,12,14,40.762007,-73.868031,11369
25993,0,0,0,4,12,16,42.995889,-78.209304,14020
697809,16,48,72,21,0,157,40.746035,-73.143008,11769
877503,0,0,0,0,12,12,40.832507,-73.940631,10032
656025,0,0,0,2,12,14,40.84863483,-73.91410241,10453
313976,0,0,0,2,6,8,44.866488,-73.420463,12921
636593,0,0,0,92,0,92,40.691026,-73.609722,11550
800964,0,0,0,4,12,16,40.709131,-73.677087,11010
879825,0,0,0,4,12,16,40.591114,-73.800165,11692
825936,0,0,0,4,12,16,40.661572,-73.914706,11212
844883,0,0,0,2,6,8,42.155383,-76.085817,13760
738570,0,0,0,4,12,16,40.842364,-73.124156,11755
477768,0,0,0,2,12,14,42.806869,-73.938114,12307
876406,0,0,0,36,0,36,40.688544,-73.935409,11221
710593,0,0,0,4,12,16,40.683614,-73.766877,11434
882261,0,0,0,2,6,8,43.066854,-76.070502,13057
73287,0,0,0,20,0,20,40.747825,-73.782205,11365
40378,0,20,103,0,0,123,40.901127,-73.343034,11768
599847,0,0,0,4,12,16,40.662708,-73.892666,11207
255786,0,0,0,4,12,16,40.652315,-73.937414,11203
62943,0,0,0,2,6,8,40.646311,-74.005045,11220
442720,0,0,0,2,12,14,40.864751,-73.919947,10034
806735,0,0,0,4,12,16,40.799662,-73.650571,11576
839115,0,0,0,4,12,16,41.533937,-74.032929,12550
878097,0,0,0,4,12,16,40.670657,-73.590679,11520
71688,0,0,0,4,12,16,40.820458,-73.938729,10030
874734,0,0,0,298,0,298,40.649173,-74.012222,11220
861789,0,0,0,2,6,8,42.891847,-78.856316,14204
675839,0,0,0,4,12,16,41.292279,-73.885161,10567
728823,0,0,0,4,12,16,42.078033,-76.047402,13850
171899,0,0,0,120,0,120,42.134141,-75.962265,13790
437763,0,0,0,4,12,16,40.764878,-73.569496,11590
876023,0,0,0,2,6,8,43.083707,-75.256538,13501
396636,0,0,0,4,12,16,40.869472,-73.901967,10468
833338,0,0,0,0,12,12,40.822062,-73.915142,10451
137588,24,60,52,12,0,148,42.67875,-73.69922,12180
752374,0,0,0,4,12,16,40.672796,-73.390363,11726
723078,0,0,0,0,10,10,40.855181,-73.909639,10453
549998,0,0,90,0,0,90,40.921448,-72.663137,11901
279479,0,0,0,4,12,16,40.694368,-73.939538,11206
45292,0,0,0,120,0,120,42.912901,-78.888611,14213
700673,0,0,0,4,12,16,40.946691,-73.875861,10701
42006,16,17,42,0,0,75,42.630756,-73.811967,12054
150266,0,0,0,4,12,16,40.81459,-73.899158,10455
854169,0,0,0,4,12,16,42.671129,-73.773898,12206
657536,0,0,0,4,12,16,40.715736,-73.659824,11530
792954,0,0,0,4,12,16,40.88383,-73.857714,10467
428101,0,0,0,4,12,16,40.844918,-73.94248,10032
44232,24,30,60,20,0,134,40.786782,-73.124286,11716
42251,16,22,45,8,0,91,43.056198,-78.725619,14228
823293,0,0,0,2,6,8,43.053085,-76.165887,13204
709754,0,0,0,100,0,100,40.544386,-74.1975,10312
324214,0,0,0,40,0,40,41.240069,-73.990679,10980
74232,0,0,0,187,0,187,40.741546,-73.712977,11004
169088,0,0,0,4,12,16,40.669088,-73.489096,11783
840288,0,0,0,2,6,8,40.692509,-73.622701,11550
848643,0,0,0,150,0,150,40.774344,-73.817932,11354
870849,0,0,0,2,6,8,40.647542,-73.958812,11226
289374,0,0,35,0,0,35,43.065404,-74.335975,12078
592422,0,0,0,11,0,11,40.585912,-73.950815,11235
594201,8,44,238,0,0,290,40.70332,-73.539252,11710
39731,8,15,36,40,0,99,43.154226,-77.497926,14625
820535,0,0,0,4,12,16,40.673811,-73.885805,11207
251646,8,21,18,0,0,47,42.880006,-76.963809,14456
703608,0,0,0,4,12,16,40.831652,-73.857805,10472
465242,0,0,0,111,0,111,40.666248,-73.876403,11208
406098,0,0,0,0,12,12,40.676633,-73.948391,11216
854009,8,17,32,9,0,66,41.629509,-73.702121,12533
458338,0,0,0,4,12,16,40.868539,-73.919846,10034
531269,0,0,0,4,12,16,40.660594,-73.917347,11212
41552,0,0,0,60,0,60,43.173897,-76.226006,13090
169484,0,0,0,125,0,125,40.657822,-73.769744,11434
699764,0,0,0,0,12,12,40.854172,-73.900434,10457
738654,0,0,0,16,0,16,40.654741,-73.957369,11226
38834,0,0,0,4,12,16,40.704342,-73.682813,11010
806960,0,0,0,134,0,134,40.791538,-73.970763,10025
860157,0,0,0,4,12,16,40.637621,-74.145509,10303
565448,0,0,0,4,12,16,40.673913,-73.984173,11215
811369,0,0,0,4,12,16,40.849299,-73.632676,11542
586234,0,0,0,0,12,12,40.871521,-73.888089,10458
640992,0,0,0,4,12,16,40.832138,-73.876992,10472
834847,0,0,0,2,6,8,40.812786,-73.921534,10454
817403,0,0,0,4,12,16,40.814409,-73.909533,10455
799005,0,0,0,2,6,8,40.848129,-73.935989,10033
647854,0,0,0,220,0,220,40.977523,-73.833699,10710
429471,0,0,0,2,12,14,40.590407,-73.788551,11692
619425,0,0,0,4,12,16,42.529887,-77.027452,14837
794979,0,0,0,2,6,8,40.762626,-72.870096,11967
432254,0,0,0,4,12,16,43.152644,-77.63243,14611
794290,0,0,0,2,6,8,40.672648,-73.81805,11420
596999,0,0,0,2,6,8,40.801245,-73.961999,10025
815123,0,0,0,4,12,16,40.852358,-73.902144,10457
881898,0,0,0,0,10,10,40.842363,-73.921103,10452
653262,0,0,0,4,12,16,40.758298,-73.911124,11103
802022,0,0,0,75,0,75,40.653542,-73.691526,11582
521109,0,0,0,60,0,60,40.994028,-73.868629,10706
125239,0,0,0,4,12,16,40.773127,-73.271118,11706
72067,0,0,0,0,10,10,40.703811,-73.74482,11429
543289,0,0,0,4,12,16,40.703195,-73.813787,11435
837913,0,0,0,55,0,55,42.902005,-78.261084,14005
355028,0,0,0,2,6,8,40.795566,-73.964947,10025
774918,0,0,0,44,0,44,40.819382,-73.911467,10455
39792,19,59,42,0,0,120,40.678643,-73.718759,11580
807817,0,0,0,4,12,16,40.857868,-73.904474,10453
144076,0,0,0,4,12,16,40.546155,-74.196987,10312
859095,0,0,0,4,12,16,40.714764,-73.835082,11375
879082,0,0,0,4,12,16,40.601785,-73.758769,11691
250289,0,0,0,4,12,16,40.663,-73.921802,11212
43583,0,0,0,44,0,44,42.767314,-78.613451,14052
603670,0,0,0,2,12,14,40.641358,-74.015864,11220
233693,0,0,0,4,12,16,43.050107,-75.733341,13032
446311,0,0,0,4,12,16,40.726428,-73.823179,11367
876834,0,12,108,0,0,120,43.985368,-75.939752,13601
40526,0,0,0,68,0,68,41.322654,-73.82174,10598
868275,0,0,0,40,0,40,44.703512,-73.455362,12901
245031,0,0,0,2,12,14,40.701532,-73.760859,11412
795542,0,0,0,2,6,8,40.83198,-73.902222,10456
750379,24,48,95,0,0,167,40.641118,-73.605422,11510
629468,0,0,0,4,12,16,40.814561,-73.908779,10455
41120,0,0,0,44,0,44,42.77516,-73.757035,12047
53318,0,0,0,0,6,6,40.827747,-73.918645,10451
431633,0,0,0,4,12,16,40.684269,-73.894524,11207
725929,0,0,0,4,12,16,41.459273,-73.921049,10516
231931,0,0,0,180,0,180,40.822075,-73.894037,10459
232191,0,0,0,2,12,14,40.837003,-73.925618,10452
268149,0,0,0,4,12,16,40.719308,-73.799944,11432
852545,0,9,36,15,0,60,40.691085,-73.720732,11003
851860,0,0,0,120,0,120,42.947586,-78.883737,14207
36456,0,0,0,2,6,8,40.764464,-73.219396,11717
878487,0,0,0,4,12,16,40.936446,-73.897006,10701
494454,0,0,0,4,12,16,40.596861,-73.768664,11691
276252,0,16,34,0,0,50,42.643041,-74.320845,12157
41931,0,0,0,60,0,60,43.332852,-76.39117,13069
38048,0,0,0,2,12,14,41.139763,-73.977065,10956
270178,0,12,120,0,0,132,42.89879,-77.309993,14424
396380,0,0,0,2,6,8,43.228021,-75.064463,13431
73148,0,0,0,119,0,119,40.646968,-73.943646,11203
385282,0,0,0,237,0,237,40.64911,-73.975848,11218
40113,0,0,20,0,0,20,42.3255,-75.311078,13849
194273,0,0,0,4,12,16,40.793255,-72.954688,11713
714310,0,0,44,0,0,44,42.437338,-79.338662,14063
863944,0,36,0,0,0,36,43.178393,-77.663011,14606
160421,0,0,0,4,12,16,40.687137,-73.751688,11413
839039,0,0,0,4,12,16,42.541604,-75.500072,13815
40019,8,12,24,0,0,44,43.040216,-76.082459,13214
201433,0,0,0,180,0,180,40.755439,-73.944636,11101
848363,0,0,81,0,0,81,42.703395,-73.881156,12203
714020,0,0,0,40,0,40,41.334085,-73.985414,10928
611426,0,0,0,4,12,16,40.644092,-73.950597,11226
348959,0,0,0,216,0,216,40.864383,-73.824239,10475
865899,0,0,0,4,12,16,42.625995,-73.727505,12144
773722,16,10,30,119,0,175,42.960368,-77.060426,14532
233319,0,0,0,2,12,14,40.631929,-74.129687,10310
486525,0,0,0,4,12,16,40.955239,-73.80418,10709
627315,0,0,0,257,0,257,40.843679,-73.889919,10457
880850,0,0,0,4,12,16,40.654053,-73.86515,11239
831654,0,0,0,4,12,16,40.675319,-73.884794,11208
41570,0,0,0,44,0,44,42.849621,-73.946366,12302
873141,8,12,52,0,0,72,43.315812,-76.43278,13069
525499,0,0,0,4,12,16,40.836358,-73.92778,10452
14914,0,0,0,2,5,7,42.107227,-79.124756,14747
450325,0,0,0,60,0,60,40.682595,-73.518147,11793
813072,0,0,0,172,0,172,40.669349,-73.934315,11213
868974,0,0,0,4,12,16,40.692612,-73.811592,11419
846773,0,0,0,45,0,45,43.97254,-75.903825,13601
877138,0,0,0,4,12,16,40.65861,-73.599881,11520
727475,0,0,0,4,12,16,40.653706,-73.91455,11236
435884,0,0,0,1,6,7,40.620771,-74.02368,11209
499462,0,0,0,2,12,14,40.863749,-73.919053,10034
638892,0,0,0,2,6,8,43.165951,-77.558995,14609
816454,0,0,0,2,12,14,40.861537,-73.90835,10468
40432,8,12,18,0,0,38,42.39978,-76.457517,14850
819552,0,0,0,4,12,16,41.704507,-74.08111,12561
158113,0,0,0,2,6,8,40.812965,-73.94892,10027
272147,0,0,0,4,12,16,40.622759,-73.923576,11234
770885,0,0,0,4,12,16,40.841769,-73.921637,10452
704507,0,0,0,4,12,16,40.657474,-73.592739,11520
796192,0,0,0,4,12,16,44.737482,-73.406429,12901
876169,0,0,0,0,12,12,40.660002,-73.750469,11413
882355,0,0,0,2,6,8,42.874074,-78.735962,14227
539740,0,0,0,4,12,16,41.05471,-73.810889,10523
34721,0,0,0,4,12,16,43.178255,-77.594157,14621
391407,0,0,0,2,12,14,43.250109,-75.454551,13440
73926,0,0,0,63,0,63,40.627706,-73.903997,11236
837439,0,0,0,2,6,8,43.174313,-77.571504,14609
873427,0,0,0,4,12,16,40.628359,-74.083545,10304
140046,0,0,0,2,5,7,40.670538,-73.863876,11208
742484,0,0,0,120,0,120,40.753822,-73.873852,11372
831317,8,8,8,5,0,29,42.885467,-78.784171,14206
791291,0,0,0,4,12,16,40.896041,-73.784396,10805
832746,0,0,0,4,12,16,41.158688,-74.192239,10974
695896,0,0,0,4,12,16,42.933124,-73.959533,12019
483919,0,0,0,4,12,16,40.692204,-73.765569,11434
859384,0,0,0,4,12,16,40.729025,-73.864682,11374
842122,0,0,0,4,12,16,40.77058,-73.529015,11801
709796,0,0,0,130,0,130,40.873196,-73.832177,10475
875835,0,0,70,25,0,95,43.078904,-77.582487,14623
808937,0,0,0,4,12,16,40.836988,-73.888695,10460
247701,0,0,0,4,12,16,40.655255,-73.950671,11226
183945,0,0,0,4,12,16,40.701783,-73.827881,11418
870828,0,0,0,2,6,8,42.014474,-73.992594,12449
701676,0,0,0,2,6,8,40.836635,-73.91938,10452
471120,0,0,0,4,12,16,40.681363,-73.594015,11575
387066,0,0,0,4,12,16,40.832408,-73.877054,10472
857868,0,0,0,40,0,40,40.806768,-73.944813,10027
623897,0,0,0,158,0,158,40.693922,-73.816313,11419
182874,0,0,0,4,12,16,40.650811,-73.922368,11203
873049,0,0,0,4,12,16,40.952352,-73.869112,10701
576628,0,0,0,2,6,8,43.070773,-76.149471,13208
115686,0,0,0,104,0,104,40.847544,-73.34231,11743
105708,8,8,42,0,0,58,43.095396,-75.232682,13501
359639,0,0,0,2,12,14,40.841498,-73.915477,10452
412238,0,0,0,2,12,14,40.829989,-73.892139,10459
40351,0,0,0,66,0,66,40.813198,-73.205596,11788
758109,0,0,74,0,0,74,42.913309,-78.864632,14209
728377,0,0,0,175,0,175,40.821962,-73.877008,10473
697086,0,0,0,4,12,16,40.829375,-73.919351,10456
19502,0,0,0,4,12,16,44.693273,-75.479959,13669
709764,0,0,0,168,0,168,40.672571,-73.937257,11213
668544,0,0,0,4,12,16,40.82892,-73.90466,10456
41465,0,0,118,0,0,118,43.980616,-75.909021,13601
749024,0,0,0,0,12,12,40.678184,-73.649049,11552
339166,0,0,0,200,0,200,40.873037,-73.833343,10475
375000,0,0,0,2,6,8,42.17985,-77.068143,14830
129128,8,10,86,0,0,104,43.094781,-75.230448,13501
496722,0,0,0,4,12,16,40.847889,-73.934993,10033
26402,0,0,0,2,6,8,43.213431,-78.47231,14105
761455,0,0,0,4,12,16,40.668093,-73.767341,11434
44174,0,0,39,0,0,39,42.045788,-77.546279,14885
41005,0,0,0,44,0,44,43.12567,-73.746919,12866
511324,0,0,0,2,6,8,42.971817,-77.15127,14432
434914,0,0,0,350,0,350,40.615163,-73.987044,11204
597707,0,0,0,2,12,14,40.865345,-73.899348,10468
819466,0,0,0,4,12,16,40.849715,-73.904209,10457
553651,0,0,0,2,6,8,40.807684,-73.924256,10454
799478,0,0,0,4,12,16,40.701688,-73.692634,11003
216037,0,0,0,116,0,116,40.836662,-73.93711,10032
873865,13,55,65,0,0,133,41.019996,-73.757606,10605
413308,8,12,34,35,0,89,40.943613,-73.000654,11764
709917,0,0,0,140,0,140,40.866585,-73.923778,10034
40488,16,36,54,60,0,166,43.246884,-76.724065,13143
872463,0,0,0,2,6,8,43.180248,-77.603735,14621
245882,0,0,0,4,12,16,40.695778,-73.922712,11221
867980,0,0,0,4,12,16,40.730342,-73.353108,11704
13681,0,0,0,4,12,16,43.302611,-76.486863,13074
747808,0,0,0,171,0,171,40.761603,-73.810996,11355
280475,0,0,0,2,12,14,40.834027,-73.905745,10456
880279,0,0,0,4,12,16,40.620967,-74.031564,11209
783689,0,0,0,2,6,8,40.805254,-73.916273,10454
121836,0,0,0,4,12,16,40.692135,-73.613697,11550
864856,0,0,0,4,12,16,40.829983,-73.85356,10472
406392,0,0,0,4,12,16,40.643338,-73.905363,11236
403207,0,0,0,30,0,30,40.877752,-73.849748,10469
741983,0,0,0,11,0,11,40.760598,-73.983401,10019
690234,0,0,0,4,12,16,40.846355,-73.880959,10460
39763,0,0,0,108,0,108,43.069746,-77.52669,14534
872503,0,0,0,4,12,16,40.729832,-73.727715,11426
672612,0,0,0,4,12,16,40.63261,-74.141594,10302
863041,32,32,74,30,0,168,43.122824,-77.594296,14620
41820,0,0,0,110,0,110,42.959809,-78.783232,14226
765493,0,0,0,2,12,14,40.868361,-73.883851,10458
420658,0,0,0,4,12,16,40.756338,-73.926485,11106
283973,0,0,0,200,0,200,40.846101,-73.898845,10457
40812,0,0,0,55,0,55,42.121701,-76.83152,14903
39891,16,24,32,17,0,89,43.153178,-79.033237,14092
834828,0,0,0,0,12,12,40.812297,-73.924098,10454
808547,0,0,0,4,12,16,42.076661,-76.836433,14905
9598,0,0,0,2,6,8,42.644429,-78.735318,14025
866654,0,0,0,50,0,50,43.123999,-76.299953,13027
825762,0,12,18,40,0,70,42.776564,-73.933767,12303
791655,0,0,0,4,12,16,40.867715,-73.884975,10458
268729,0,0,0,2,5,7,40.840134,-73.916742,10452
828045,0,0,0,4,12,16,40.695349,-73.528341,11710
877944,0,0,0,40,0,40,40.587537,-73.696127,11561
847651,0,0,0,2,6,8,43.07679,-75.589574,13461
28804,0,0,0,4,12,16,42.912896,-78.83364,14211
380276,0,0,0,4,12,16,40.821231,-73.893744,10459
845534,0,0,0,4,12,16,42.725263,-73.706607,12189
29408,0,0,0,4,12,16,40.956484,-72.897011,11786
819639,0,0,0,2,6,8,40.659407,-73.962422,11225
713313,0,0,90,0,0,90,42.904211,-78.693331,14043
698360,0,12,161,0,0,173,41.036232,-73.923388,10968
210128,0,0,0,4,12,16,40.660261,-73.75854,11413
260286,0,0,0,57,0,57,40.738621,-73.989766,10003
877335,0,0,0,4,12,16,40.836544,-73.909314,10456
569563,0,0,0,44,0,44,42.644159,-79.028758,14006
117851,0,0,0,4,12,16,40.642636,-73.889521,11236
51679,0,0,0,0,6,6,40.851936,-73.907683,10453
343813,0,0,0,44,0,44,42.607466,-73.869702,12054
248080,0,0,0,20,0,20,43.944012,-76.121399,13685
755142,0,0,0,4,12,16,40.609805,-73.991378,11214
747138,16,24,0,0,0,40,40.674616,-73.576766,11575
230803,0,0,0,4,12,16,40.685803,-73.859631,11421
43202,0,0,32,8,0,40,42.836545,-78.8073,14220
693908,0,0,0,2,6,8,42.585089,-76.22873,13045
489103,0,0,0,4,12,16,40.855345,-73.931236,10040
42279,16,30,48,0,0,94,43.041186,-76.150691,13202
266512,0,0,0,43,0,43,40.69085,-73.728586,11411
323094,0,0,0,4,12,16,43.171893,-77.581211,14609
603575,0,0,0,40,0,40,42.834871,-75.986455,13063
44096,8,0,0,0,0,8,43.068932,-76.101543,13206
42765,12,20,14,7,0,53,42.900405,-78.404773,14040
665687,0,0,0,4,12,16,40.683414,-73.813912,11420
647535,0,0,0,4,12,16,40.643979,-73.902135,11236
715916,0,0,0,4,12,16,40.640809,-73.904062,11236
301747,0,0,0,0,6,6,40.857913,-73.897881,10458
459969,0,0,0,4,12,16,40.640006,-74.085425,10301
784730,0,0,0,139,0,139,40.764758,-73.484738,11803
256144,0,0,0,4,12,16,41.267947,-74.362476,10990
878679,0,0,0,124,0,124,40.8728,-73.875449,10467
673474,0,0,0,4,12,16,40.855706,-73.898803,10457
809596,0,0,0,4,12,16,40.815047,-73.8679,10473
742504,0,0,0,60,0,60,40.691421,-73.85668,11421
415265,8,10,21,23,0,62,42.8914,-78.540477,14004
40513,0,12,36,0,0,48,41.275941,-73.781437,10598
42431,0,0,0,160,0,160,43.955953,-75.910084,13601
580945,0,0,0,2,6,8,41.53796,-73.878921,12524
702648,6,10,12,12,0,40,44.31643,-74.154587,12983
800707,0,0,0,265,0,265,40.790443,-73.839654,11356
767756,0,0,34,0,0,34,44.085333,-75.807646,13637
760518,0,0,0,4,12,16,40.888389,-73.833031,10466
855105,0,0,0,4,12,16,40.857331,-73.900379,10453
748434,0,0,40,0,0,40,42.595,-74.328966,12122
626643,0,0,0,60,0,60,40.646447,-73.878676,11239
328282,0,0,0,4,12,16,40.645693,-73.911056,11236
379503,0,0,0,2,6,8,40.841039,-73.920513,10452
866266,0,0,0,4,12,16,40.669293,-73.989291,11215
878091,0,0,0,4,12,16,40.844078,-73.89357,10457
340104,0,0,0,4,12,16,40.699243,-73.614931,11550
718978,0,0,0,2,12,14,40.594724,-74.09631,10304
54152,0,0,0,1,6,7,40.856687,-73.903672,10453
73124,0,0,0,80,0,80,40.68514,-73.990282,11201
838026,0,0,0,17,0,17,41.624513,-73.573961,12594
41141,0,0,102,0,0,102,40.673128,-73.581321,11575
878526,0,0,0,4,12,16,42.842643,-73.803947,12065
875799,0,0,0,4,12,16,40.701486,-73.920975,11237
853066,0,0,0,4,12,16,40.829791,-73.917971,10456
227406,32,0,48,15,0,95,43.224019,-78.042006,14470
71974,0,0,0,4,12,16,40.895146,-73.851035,10466
846635,0,0,0,4,12,16,40.87649,-73.87413,10467
839610,0,0,0,4,12,16,40.58873,-73.989925,11214
789554,0,0,0,4,12,16,40.69232,-73.594247,11553
188577,0,0,0,2,5,7,40.801569,-73.936382,10035
540100,0,0,0,4,12,16,40.601621,-73.978654,11223
644398,0,0,0,2,6,8,43.229014,-77.634843,14616
704351,0,0,0,4,12,16,40.72639,-73.806627,11366
826744,8,10,25,0,0,43,41.47743,-73.917185,10516
881045,0,0,0,144,0,144,40.668739,-73.917883,11212
42583,40,56,64,0,0,160,43.135963,-77.495217,14625
43136,6,8,34,26,0,74,41.170337,-73.817238,10510
701752,0,0,0,4,12,16,40.951867,-73.82445,10707
470089,0,0,0,4,12,16,40.77354,-73.949767,10028
181095,0,0,0,4,12,16,40.757468,-73.336154,11729
238212,0,0,0,4,12,16,40.640729,-74.020084,11220
366023,0,0,0,4,12,16,40.847286,-73.401658,11746
827215,0,0,0,0,12,12,40.845906,-73.880308,10460
880512,0,0,0,4,12,16,41.802749,-73.849543,12578
723951,0,0,0,0,12,12,40.844169,-73.880369,10460
736227,0,0,10,290,0,300,40.64758,-74.083429,10301
812729,0,0,0,4,12,16,40.854723,-73.900215,10457
868766,0,0,70,0,0,70,40.969438,-72.561978,11948
832036,0,0,48,0,0,48,42.099565,-75.904629,13901
45156,0,0,36,0,0,36,40.671274,-73.561993,11566
512796,0,0,0,4,12,16,44.280261,-73.985471,12946
185805,0,0,0,4,12,16,40.703642,-73.728564,11429
852040,0,0,0,4,12,16,40.790438,-73.838833,11356
228507,0,0,0,24,0,24,40.640931,-73.909107,11236
517724,0,0,0,4,12,16,40.63647,-73.942406,11210
40674,8,21,35,10,0,74,42.741302,-73.942176,12303
709902,0,0,0,150,0,150,40.845843,-73.940138,10033
818094,0,0,0,2,6,8,42.381481,-75.659604,13830
20880,0,0,0,2,6,8,42.243856,-73.658481,12534
260710,0,0,0,156,0,156,40.575452,-73.959702,11235
795985,0,0,0,4,12,16,40.827415,-73.920422,10451
684078,0,0,0,145,0,145,40.821165,-73.952011,10031
685257,0,0,0,4,12,16,42.807207,-73.905935,12309
711602,0,0,0,4,12,16,43.264625,-75.463761,13440
25232,0,0,0,2,6,8,43.100439,-75.323805,13492
44240,16,20,39,30,0,105,43.061182,-76.207927,13209
64266,0,0,0,2,6,8,40.727191,-73.979525,10009
694623,0,0,0,4,12,16,40.685356,-73.803069,11435
217759,0,0,0,4,12,16,40.660403,-73.947494,11225
264085,0,0,0,4,12,16,40.681088,-73.937376,11233
769924,0,0,0,4,12,16,40.828954,-73.940934,10031
16146,0,0,0,2,6,8,41.160696,-74.178753,10974
842105,0,0,0,2,12,14,40.874253,-73.874305,10467
728032,0,0,0,4,12,16,40.68387,-73.939378,11216
871405,0,0,0,0,12,12,40.812052,-73.905235,10455
572258,0,0,0,4,12,16,40.853947,-73.905023,10453
810742,0,0,0,2,12,14,40.839848,-73.865849,10460
580297,0,0,0,4,12,16,40.694854,-73.914246,11221
865502,0,0,0,235,0,235,40.846274,-73.901484,10457
779656,0,0,0,4,12,16,42.269081,-77.599204,14823
880404,0,0,0,4,12,16,42.076668,-74.034379,12477
277844,0,0,0,114,0,114,40.723619,-73.942156,11222
198452,0,0,0,4,12,16,40.861481,-73.900175,10468
783156,0,0,0,4,12,16,40.858891,-73.930278,10040
463991,0,0,0,4,12,16,41.21436,-74.002531,10923
252821,16,24,39,14,0,93,43.15756,-77.614052,14614
39619,16,20,32,20,0,88,43.231478,-77.657951,14616
42527,0,0,0,40,0,40,40.876202,-73.235207,11754
709716,0,0,0,138,0,138,40.764875,-73.871148,11369
621410,0,0,0,4,12,16,42.814862,-73.902324,12309
43455,0,28,43,42,0,113,40.707073,-73.592722,11553
135280,0,0,0,4,12,16,40.646592,-73.953011,11226
786906,0,0,0,2,6,8,43.156386,-77.503751,14625
615866,0,0,0,0,12,12,40.832632,-73.916332,10456
243205,0,0,0,360,0,360,40.595434,-73.99314,11214
877740,0,12,76,0,0,88,40.904536,-72.986202,11727
877358,16,36,36,34,0,122,42.971406,-74.178481,12010
742229,0,0,0,4,12,16,42.468483,-79.333588,14048
875634,0,0,0,4,12,16,40.640862,-73.995446,11219
854418,0,0,0,4,12,16,40.691751,-73.906223,11207
259321,0,0,0,0,6,6,40.871921,-73.884257,10458
447940,0,0,0,170,0,170,41.090046,-74.000734,10954
692059,0,0,15,50,0,65,44.886895,-73.434128,12921
115665,0,0,0,2,6,8,43.186859,-77.617096,14621
821344,0,0,0,4,12,16,40.667426,-73.919558,11212
512592,0,0,0,2,6,8,40.655382,-73.909291,11212
775467,0,0,0,4,12,16,40.629321,-74.137943,10302
670001,0,0,0,4,12,16,40.700015,-73.631953,11550
868563,0,0,0,4,12,16,40.838716,-73.866706,10460
43889,0,24,64,0,0,88,40.839665,-73.704509,11050
637832,0,0,0,2,12,14,40.825987,-73.879825,10472
761750,0,0,0,4,12,16,40.741191,-73.239023,11706
229764,0,0,0,2,6,8,40.82415,-73.953304,10031
101574,0,0,0,4,12,16,40.682136,-73.65379,11552
42420,0,0,0,70,0,70,40.683518,-73.714921,11580
787291,0,0,0,4,12,16,40.847178,-73.903885,10457
779517,0,0,0,4,12,16,40.863077,-73.899248,10468
852675,0,0,0,4,12,16,40.726491,-73.80665,11366
40727,0,0,91,0,0,91,40.913301,-72.653444,11901
766494,0,0,0,2,6,8,40.836595,-73.90314,10456
810278,0,0,0,2,6,8,43.10742,-74.667204,13329
39904,7,12,32,10,0,61,43.14339,-78.877169,14132
327808,0,0,0,2,12,14,40.720428,-73.812182,11367
874738,0,0,0,220,0,220,40.639748,-74.019887,11220
44219,0,0,0,220,0,220,40.677503,-73.439235,11758
878747,0,0,0,4,12,16,40.87846,-73.86777,10467
336183,0,0,0,0,12,12,40.857422,-73.896297,10458
246865,0,0,0,2,12,14,40.604618,-73.984619,11223
838405,0,0,0,2,6,8,43.073944,-76.154289,13208
872837,0,0,0,66,0,66,40.677635,-74.005112,11231
42878,0,8,123,0,0,131,43.213858,-75.41349,13440
151021,0,0,0,2,6,8,40.716635,-73.980113,10002
845873,0,0,0,0,12,12,40.847592,-73.906943,10457
211223,0,0,166,13,0,179,42.51812,-78.649997,14141
768704,0,0,0,4,12,16,40.760499,-73.876594,11369
501166,0,0,0,2,6,8,41.605779,-73.818182,12590
660793,0,0,0,2,12,14,40.829853,-73.922667,10452
803191,0,0,0,20,0,20,42.298638,-73.996655,12413
488139,0,0,0,4,12,16,42.711601,-73.709489,12189
686807,0,0,0,294,0,294,40.633635,-74.024106,11209
865550,0,0,0,4,12,16,40.64963,-74.006946,11232
562244,0,0,0,4,12,16,40.779101,-73.263732,11717
44454,17,12,46,0,0,75,40.675986,-73.557023,11566
743446,0,0,0,4,12,16,40.671993,-73.869941,11208
830081,0,0,0,4,12,16,42.899607,-73.586891,12154
667842,0,0,0,4,12,16,40.833131,-73.921488,10452
860531,32,42,57,0,0,131,42.872072,-73.776055,12065
523602,0,0,0,38,0,38,40.708861,-73.813912,11435
469107,0,0,0,4,12,16,40.828623,-73.921351,10451
18537,0,0,0,4,12,16,41.534856,-74.030033,12550
787926,0,0,0,4,12,16,41.650871,-74.692266,12701
118357,0,0,0,2,6,8,43.168088,-77.580597,14609
873614,0,0,0,4,12,16,40.663167,-73.772292,11434
66813,0,0,0,2,6,8,40.76225,-73.988324,10019
743982,0,0,0,2,6,8,41.352655,-73.77507,10541
685441,0,0,0,4,12,16,40.704886,-73.720592,11003
131801,24,10,30,0,0,64,43.056229,-75.22943,13413
39191,0,24,80,0,0,104,42.655686,-73.801906,12208
612679,0,0,0,0,12,12,40.831377,-73.947168,10031
263066,0,0,0,4,12,16,43.211573,-75.432953,13440
548625,0,0,0,4,12,16,43.149977,-77.625216,14608
615263,0,0,0,4,12,16,41.001254,-73.667006,10573
702495,0,0,0,4,12,16,40.75552,-73.730361,11362
204282,0,0,0,2,6,8,42.213024,-76.499774,14883
834734,24,41,74,0,0,139,40.682138,-73.431452,11758
72099,0,0,0,4,12,16,40.684569,-73.918197,11233
409057,0,0,0,2,6,8,40.85433,-73.890976,10458
709911,0,0,0,149,0,149,40.819312,-73.956843,10027
202760,0,0,0,8,0,8,40.602799,-74.121399,10314
875241,0,0,0,44,0,44,42.811695,-73.685431,12188
815711,0,0,0,4,12,16,40.663588,-73.993814,11232
853987,0,0,0,133,0,133,40.849031,-73.931586,10033
631099,0,0,0,4,12,16,40.734289,-73.804604,11365
825526,0,0,0,4,12,16,40.841869,-73.917722,10452
772592,0,0,0,4,12,16,40.789255,-73.973658,10024
244134,0,0,0,111,0,111,42.872037,-78.833989,14210
209045,0,0,0,4,12,16,40.816391,-73.85006,10473
102703,0,0,0,2,6,8,42.863379,-73.824535,12065
670024,0,12,70,0,0,82,40.709172,-73.322668,11702
577062,0,0,0,4,12,16,40.890371,-73.861163,10466
174526,0,0,0,30,0,30,43.214325,-78.394177,14103
788750,0,0,0,2,6,8,40.816188,-73.866117,10473
877809,0,0,0,4,12,16,43.195062,-77.690196,14626
345776,0,0,0,4,12,16,40.615597,-73.960827,11230
694316,0,0,0,4,12,16,40.847893,-73.888859,10457
42716,0,0,0,98,0,98,41.108015,-74.136615,10901
566123,0,0,0,4,12,16,40.823107,-73.904171,10456
167467,0,0,0,2,12,14,40.682846,-74.00067,11231
675208,0,0,0,4,12,16,40.87971,-73.873076,10467
794010,0,0,0,4,12,16,40.644742,-73.957489,11226
44555,16,25,48,0,0,89,41.365836,-73.760845,10541
545215,0,0,0,0,12,12,40.84591,-73.908244,10457
688333,0,0,0,4,12,16,40.689026,-73.931449,11221
41135,24,39,133,13,0,209,42.306499,-75.404068,13838
355885,0,0,38,0,0,38,40.959122,-73.819493,10707
363807,0,0,18,0,0,18,43.49302,-73.774762,12885
849222,0,0,0,4,12,16,40.801818,-73.962609,10025
41654,0,0,0,60,0,60,41.121901,-73.970239,10994
737502,0,0,0,4,12,16,42.747077,-78.849142,14075
879723,0,0,0,4,12,16,40.579662,-74.000669,11224
252540,24,24,21,20,0,89,44.024538,-75.735795,13619
800474,0,0,0,40,0,40,43.141787,-78.891643,14132
567240,0,0,0,2,6,8,40.981801,-73.833914,10710
542084,0,0,0,4,12,16,40.813196,-73.890147,10474
148986,0,0,0,89,0,89,40.710335,-73.996702,10038
793469,0,0,0,2,6,8,43.144635,-77.656345,14611
869951,0,0,0,4,12,16,41.475892,-74.371999,10941
528350,7,11,30,7,0,55,43.15666,-77.626222,14608
733222,0,0,0,4,12,16,40.652688,-73.741692,11422
318690,0,0,0,4,12,16,40.667851,-73.80647,11420
40544,16,12,73,0,0,101,40.93292,-73.903159,10701
43327,32,20,32,0,0,84,43.086156,-77.675241,14623
228365,16,32,82,12,0,142,40.937396,-72.984752,11764
40760,24,32,54,0,0,110,42.085559,-78.44323,14760
44803,0,0,0,80,0,80,41.119028,-74.038039,10977
824645,0,0,0,4,12,16,41.023958,-73.777249,10606
220200,0,0,28,31,0,59,42.121956,-77.926627,14895
848766,0,0,0,4,12,16,40.798754,-73.945376,10029
874229,0,0,0,4,12,16,40.665142,-73.855794,11414
43477,0,0,0,40,0,40,42.585377,-76.358469,13073
709658,0,0,0,353,0,353,40.813564,-73.908816,10455
670810,0,0,0,4,12,16,40.824899,-73.861186,10473
709837,0,0,0,229,0,229,40.845674,-73.886531,10460
798411,0,0,0,4,12,16,40.879116,-73.844715,10469
781400,0,0,0,2,12,14,40.59622,-73.764092,11691
71799,0,0,0,4,12,16,40.852962,-73.902755,10457
72772,0,0,0,2,12,14,40.848011,-73.906045,10457
233098,0,0,0,70,0,70,40.753079,-73.084456,11782
820263,0,0,0,2,6,8,42.225242,-73.828831,12534
762845,0,0,0,110,0,110,40.665515,-73.925767,11212
42085,0,0,0,52,0,52,43.053732,-76.124401,13203
866734,0,8,10,0,0,18,43.067951,-78.75265,14228
842316,0,0,0,4,12,16,40.696168,-73.565689,11566
856960,0,0,0,4,12,16,40.935645,-73.86593,10701
879468,0,0,0,2,6,8,40.838553,-73.917219,10452
855836,0,0,0,2,6,8,42.11093,-75.91784,13905
689581,0,0,0,120,0,120,40.817788,-73.954017,10027
275446,0,0,0,70,0,70,40.636615,-73.951439,11210
152685,0,0,0,2,6,8,44.220912,-74.450058,12986
801926,0,0,0,173,0,173,40.720607,-73.746671,11428
834454,0,0,0,4,12,16,43.01783,-76.141446,13205
583114,0,0,0,4,12,16,40.843429,-73.91439,10452
41312,0,0,20,0,0,20,41.619484,-74.075669,12589
652213,0,0,0,4,12,16,40.827499,-73.901361,10456
856755,0,0,0,4,12,16,40.851268,-73.90019,10457
839395,0,0,0,4,12,16,40.831614,-73.921635,10452
697816,0,0,0,4,12,16,40.68363,-73.857596,11416
441324,0,0,0,2,5,7,40.839581,-73.912138,10457
848065,16,12,20,12,0,60,42.756069,-78.134879,14569
880589,0,0,0,4,12,16,40.855326,-73.865847,10462
770048,0,0,0,4,12,16,40.954649,-73.869302,10701
603273,0,0,0,170,0,170,40.728389,-73.356319,11704
426884,0,0,36,0,0,36,43.124747,-75.234455,13502
74024,0,0,0,272,0,272,40.64816,-73.946123,11203
825957,16,23,46,0,0,85,43.018735,-78.965031,14072
864933,0,0,0,4,12,16,40.822381,-73.924626,10451
841466,0,0,0,105,0,105,40.960713,-72.987832,11764
843853,0,0,0,4,12,16,40.715995,-73.802756,11432
663351,0,0,11,40,0,51,42.995689,-78.315431,14036
871512,0,0,0,2,6,8,43.064184,-75.868875,13037
730549,0,0,0,96,0,96,40.732438,-73.883083,11373
662087,0,0,0,2,6,8,40.880961,-73.859313,10467
372865,0,0,0,4,12,16,40.77351,-73.802418,11358
879845,0,0,0,4,12,16,44.663972,-73.757479,12981
837643,0,0,0,2,6,8,43.1804,-76.235305,13090
818934,0,0,0,2,6,8,43.019828,-73.912496,12020
587439,0,0,0,4,12,16,40.759768,-73.565648,11590
737034,0,0,0,4,12,16,41.137623,-74.055644,10977
657920,0,0,0,0,12,12,40.867641,-73.86332,10467
700512,0,0,0,4,12,16,40.668058,-73.601618,11520
161836,0,0,0,2,6,8,40.651718,-73.944652,11203
822656,8,24,29,9,0,70,40.938384,-73.885997,10701
39591,0,0,20,0,0,20,43.980972,-75.609924,13619
874000,0,0,0,16,0,16,40.607424,-73.955288,11229
350132,0,0,0,4,12,16,40.680294,-73.78403,11434
548083,0,0,0,4,12,16,40.707149,-73.900597,11385
42228,0,0,0,61,0,61,40.866104,-73.354912,11740
359964,0,0,0,4,12,16,40.684449,-73.879651,11208
882012,0,0,0,4,12,16,40.749615,-73.253826,11706
394398,0,0,0,2,6,8,43.135958,-77.476041,14526
875702,0,0,0,4,12,16,40.837441,-73.90197,10457
871746,0,0,0,4,12,16,40.614278,-73.990076,11204
279372,0,0,0,4,12,16,40.756149,-73.227975,11717
150215,0,0,0,4,12,16,40.666962,-73.893391,11207
204679,0,0,0,1,6,7,40.844039,-73.887868,10460
746548,0,0,0,4,12,16,40.608447,-73.965156,11223
426225,0,0,0,2,6,8,40.66366,-73.813693,11420
822401,0,0,0,4,12,16,40.86683,-73.927397,10034
867092,0,0,0,4,12,16,40.878131,-73.882361,10467
757202,16,48,61,20,0,145,40.654335,-73.610453,11510
43089,0,24,36,0,0,60,43.302579,-73.587969,12839
764674,0,0,0,138,0,138,40.648264,-73.92548,11203
349322,0,0,0,2,6,8,40.823029,-73.951825,10031
868746,0,0,0,2,6,8,42.166809,-78.719507,14779
44235,20,20,30,20,0,90,43.004305,-78.738479,14221
680046,24,34,100,20,0,178,43.060845,-77.467339,14534
762094,0,0,0,4,12,16,40.873256,-73.900793,10468
27131,0,0,0,4,12,16,41.111528,-74.082707,10952
485890,0,0,43,0,0,43,41.359041,-74.502024,10998
702597,0,0,0,4,12,16,40.85434,-73.911579,10453
521802,0,0,0,115,0,115,42.325386,-77.658495,14843
39182,6,27,56,0,0,89,42.602688,-73.792369,12077
596161,8,24,72,0,0,104,42.493219,-76.557792,14850
878133,0,0,0,4,12,16,40.65537,-73.932938,11203
42916,0,0,0,127,0,127,40.677817,-73.568646,11566
839931,0,0,0,585,0,585,40.731143,-74.007768,10014
33249,0,0,0,2,6,8,43.179111,-77.554376,14609
817078,0,0,0,87,0,87,40.668516,-73.904732,11212
695494,0,0,0,2,6,8,40.64668,-73.962731,11226
377083,0,0,0,2,12,14,43.050918,-75.886952,13037
18926,0,0,0,2,6,8,41.693078,-73.895468,12603
293780,0,0,0,4,12,16,40.805732,-73.957898,10026
636985,0,0,0,4,12,16,40.854325,-73.88159,10458
868697,0,0,0,4,12,16,40.612424,-73.950211,11229
43897,7,11,42,8,0,68,41.263428,-74.361336,10990
774304,0,0,0,4,12,16,40.656511,-74.003822,11232
730188,0,0,0,2,6,8,40.844373,-73.934406,10033
792192,0,0,0,4,12,16,40.879602,-73.847525,10469
249359,0,0,0,0,10,10,40.844172,-73.939188,10032
267207,0,0,0,2,12,14,40.856094,-73.903056,10453
848590,0,0,0,4,12,16,40.770813,-73.211768,11722
852938,0,0,0,4,12,16,40.637424,-74.139686,10302
40166,8,24,45,0,0,77,41.132662,-74.083777,10901
109826,0,0,0,60,0,60,42.449162,-76.631841,14850
230725,0,0,0,4,12,16,40.649258,-73.929843,11203
878270,0,0,0,4,12,16,40.722888,-73.813253,11367
814131,0,0,0,4,12,16,42.327557,-75.770319,13778
179580,0,0,0,2,6,8,40.705126,-73.939581,11206
844669,0,0,0,4,12,16,40.857141,-73.899726,10457
832881,0,0,0,4,12,16,40.595117,-73.953953,11229
42990,0,5,22,20,0,47,42.637012,-73.607545,12196
245773,0,0,0,313,0,313,40.858843,-73.909921,10453
71639,0,0,0,4,12,16,40.60435,-73.760508,11691
500140,0,0,0,4,12,16,40.869654,-73.893911,10468
233838,0,0,0,160,0,160,40.686425,-73.768532,11434
822242,0,0,0,4,12,16,40.843335,-73.868722,10460
843543,0,0,0,4,12,16,40.676433,-73.984019,11215
143845,0,0,0,40,0,40,41.412961,-74.32028,10924
311150,0,0,0,30,0,30,42.350802,-73.808523,12051
303596,0,0,0,2,6,8,42.517667,-73.609545,12123
878265,0,0,0,4,12,16,40.637384,-74.162229,10303
32597,0,0,0,2,6,8,42.9919,-76.4548,13153
735582,0,0,0,4,12,16,40.707681,-73.587516,11553
838283,0,0,0,205,0,205,40.683931,-73.815514,11420
622481,0,0,0,184,0,184,40.680623,-73.926255,11233
872093,24,88,122,0,0,234,40.778133,-73.63756,11577
72172,0,0,0,4,12,16,40.731898,-73.853806,11374
759575,0,0,0,200,0,200,40.745793,-73.866446,11368
867807,7,20,32,0,0,59,40.922467,-72.682939,11901
351583,32,24,70,8,0,134,43.041749,-76.151309,13202
720180,0,9,17,16,0,42,43.036334,-78.946813,14072
306118,0,0,0,2,12,14,40.813423,-73.942892,10030
648675,0,0,0,2,12,14,40.839896,-73.846187,10461
611129,0,0,0,146,0,146,40.636722,-73.933452,11203
865686,0,0,0,4,12,16,42.337534,-75.7712,13778
277172,0,0,0,2,10,12,40.641501,-73.908249,11236
466717,0,0,0,2,6,8,42.306454,-75.391326,13838
853320,0,0,0,4,12,16,40.706266,-73.588458,11553
880654,0,0,0,4,12,16,40.75511,-73.825989,11355
226474,0,0,0,4,12,16,40.84029,-73.925003,10452
787954,0,0,0,4,12,16,40.953869,-73.880639,10703
816256,0,0,0,80,0,80,40.864303,-73.116318,11755
810130,0,0,0,4,12,16,40.691717,-73.714195,11003
821775,0,0,0,4,12,16,40.643873,-73.587582,11520
416223,0,0,0,0,10,10,40.855314,-73.912516,10453
796866,0,12,230,0,0,242,41.525966,-74.227588,12549
861950,0,0,0,195,0,195,40.608448,-73.974495,11204
27448,0,0,0,2,6,8,42.66159,-78.35723,14082
488,0,0,0,4,12,16,44.783344,-73.551137,12992
105144,0,0,0,65,0,65,41.723788,-73.961913,12528
58470,0,0,0,2,6,8,40.852194,-73.922623,10453
619831,0,0,0,0,12,12,40.824107,-73.92416,10451
875159,0,0,0,2,6,8,42.136996,-76.931989,14814
504413,0,0,0,4,12,16,40.621627,-73.925023,11234
741997,0,0,0,483,0,483,40.736332,-73.992653,10003
263477,0,0,0,4,12,16,40.833124,-73.872305,10472
207440,0,0,0,260,0,260,40.686225,-73.783942,11434
44848,32,48,80,0,0,160,40.897948,-73.12922,11794
732309,0,0,0,159,0,159,40.70507,-73.801084,11432
604989,0,0,0,4,12,16,40.888381,-73.859181,10466
72402,0,0,0,4,12,16,40.730667,-73.846384,11375
555690,0,0,0,4,12,16,42.173972,-75.627263,13787
404856,0,34,111,0,0,145,40.671225,-73.622518,11570
666143,0,0,0,2,6,8,43.254419,-77.601723,14617
730639,0,0,0,240,0,240,40.704719,-73.952472,11211
857776,8,17,21,0,0,46,43.118396,-77.816073,14514
191758,0,0,0,2,6,8,44.469143,-73.56296,12944
654332,0,0,0,0,12,12,40.717684,-73.499419,11756
842740,0,0,0,2,6,8,43.055687,-75.86722,13037
663526,0,0,0,2,6,8,40.647204,-73.973243,11218
30550,0,0,0,4,12,16,41.650592,-73.764677,12540
331465,0,0,0,2,12,14,40.847497,-73.904259,10457
41871,4,10,15,0,0,29,42.982458,-74.298186,12095
642837,0,0,0,4,12,16,40.633047,-73.982502,11204
872211,0,0,0,4,12,16,41.699051,-73.972231,12528
840040,0,0,0,4,12,16,43.071537,-75.271004,13501
281948,0,0,78,0,0,78,43.170995,-77.585661,14605
744944,0,0,0,111,0,111,40.787056,-72.858462,11967
571568,0,0,0,4,12,16,40.835491,-73.924497,10452
440630,0,0,0,4,12,16,40.637122,-73.940207,11210
414078,0,0,0,4,12,16,42.920935,-78.811137,14215
846966,0,0,0,4,12,16,40.916271,-73.899835,10705
39834,0,0,0,150,0,150,40.666921,-73.553304,11566
806662,0,0,0,40,0,40,40.670148,-73.908574,11212
780461,0,0,0,4,12,16,40.83725,-73.944047,10032
266023,0,0,0,22,0,22,40.696653,-73.913696,11237
607916,0,0,0,116,0,116,40.667,-73.899606,11207
834378,0,0,0,4,12,16,40.688078,-73.780935,11434
309209,0,0,0,127,0,127,40.527924,-74.19223,10312
164186,0,0,0,2,6,8,43.299473,-73.713635,12804
844944,0,0,0,4,12,16,40.678252,-73.892831,11207
822916,0,0,0,79,0,79,40.70613,-73.38893,11757
527599,0,0,0,4,12,16,40.875282,-73.856446,10469
39470,0,0,149,0,0,149,42.950253,-78.887928,14207
584441,0,0,0,4,12,16,40.8225,-73.952495,10031
391755,0,0,0,4,12,16,40.67884,-73.968636,11238
173656,0,0,0,2,6,8,40.860584,-73.035137,11784
877265,0,0,0,100,0,100,43.96223,-75.905567,13601
559555,0,0,0,4,12,16,40.85812,-73.897452,10458
39409,16,32,39,15,0,102,42.799905,-78.744108,14127
534125,0,0,0,4,12,16,40.680565,-73.993092,11231
495555,0,0,0,4,12,16,40.649573,-73.951769,11226
739041,0,0,0,0,12,12,40.841505,-73.891445,10457
28877,0,0,0,2,6,8,42.942986,-76.486949,13021
731438,0,0,0,2,6,8,40.831343,-73.918478,10456
815943,0,0,0,260,0,260,40.640318,-73.977383,11218
11875,0,0,0,4,12,16,42.773223,-78.833607,14219
809246,0,0,0,2,6,8,40.755427,-73.910243,11377
40595,0,16,68,0,0,84,40.92983,-73.75459,10538
643415,0,0,0,0,12,12,40.8527,-73.900099,10457
371762,0,0,0,4,12,16,40.60751,-74.006231,11214
874336,0,0,0,2,6,8,42.229213,-75.849809,13746
722602,0,0,0,4,12,16,40.671181,-73.937822,11213
877097,0,0,0,4,12,16,40.685424,-73.880233,11208
678371,0,0,0,2,12,14,40.818365,-73.895127,10459
367914,0,0,0,2,12,14,40.75612,-73.830243,11355
656912,0,0,0,0,12,12,40.834834,-73.913348,10456
102228,0,0,0,167,0,167,40.686034,-73.869466,11208
42475,0,0,64,0,0,64,44.979126,-74.693324,13655
793034,0,0,0,4,12,16,40.879683,-73.905272,10463
21905,0,0,0,2,5,7,42.471715,-77.10561,14837
695066,0,0,0,4,12,16,40.655956,-73.741927,11422
839148,0,0,0,4,12,16,40.757206,-73.580697,11590
761146,0,0,0,4,12,16,40.830677,-73.874701,10472
875387,0,0,0,2,12,14,40.825848,-73.889306,10459
241816,16,24,39,0,0,79,40.801818,-73.039318,11742
815327,0,0,0,2,6,8,43.009107,-75.043489,13357
506834,0,0,0,2,6,8,44.990504,-73.442891,12919
736563,12,12,18,0,0,42,40.672747,-73.5388,11710
406495,0,0,0,4,12,16,40.886989,-73.847006,10466
877535,0,0,0,4,12,16,42.944298,-78.828977,14214
855413,0,0,0,2,6,8,42.361163,-74.990105,13757
875406,0,0,0,4,12,16,40.893145,-73.858701,10466
264737,0,0,0,0,12,12,40.746663,-73.242237,11706
875991,0,0,0,2,6,8,42.255451,-77.20286,14821
138364,24,40,94,18,0,176,41.112638,-74.130804,10901
835046,0,0,0,4,12,16,40.857705,-73.893624,10458
697795,0,0,0,4,12,16,40.680862,-73.832241,11419
6265,0,0,0,4,12,16,42.951073,-74.304562,12068
438389,0,0,0,68,0,68,40.612954,-74.069329,10305
826376,0,0,0,2,6,8,42.580476,-76.557667,14882
788763,0,0,0,4,12,16,40.659392,-73.960735,11225
700623,0,0,0,2,6,8,40.61938,-73.922847,11234
400923,0,0,0,4,12,16,40.643171,-74.084129,10301
828971,0,0,0,120,0,120,43.005107,-78.170557,14020
114317,0,0,0,2,6,8,42.118039,-77.034699,14830
150585,0,0,0,4,12,16,42.840907,-78.823483,14220
697277,0,0,0,4,12,16,40.66741,-73.584251,11520
255434,0,51,91,0,0,142,40.99653,-73.803732,10583
847715,0,0,0,13,0,13,40.668616,-73.908168,11212
677437,0,0,0,0,12,12,40.837232,-73.925491,10452
40604,16,12,33,0,0,61,41.244333,-73.92619,10548
864178,0,0,0,4,12,16,40.848991,-73.85791,10462
861611,0,0,0,4,12,16,40.820579,-73.87982,10473
222677,0,0,0,2,12,14,40.601541,-73.747932,11691
329297,0,0,0,4,12,16,43.170452,-76.14937,13041
600660,8,6,11,10,0,35,41.200122,-73.708654,10549
437497,0,0,0,2,12,14,40.927944,-73.902174,10701
313412,0,0,0,4,12,16,40.816407,-73.807644,10465
73207,0,0,0,100,0,100,40.661189,-73.906461,11212
797478,0,0,0,95,0,95,43.788695,-76.119847,13605
717976,0,0,0,4,12,16,40.686887,-73.87522,11208
394217,0,0,0,2,6,8,40.875845,-73.909373,10463
882290,0,0,0,2,6,8,43.086058,-75.238999,13501
716681,0,0,0,40,0,40,41.527061,-74.189113,12549
809704,0,0,0,4,12,16,40.826069,-73.904813,10456
710353,0,0,0,4,12,16,40.630765,-73.987781,11219
141670,0,0,0,0,12,12,40.831081,-73.922975,10452
798875,0,0,0,4,12,16,43.208062,-77.71324,14626
71275,0,0,0,4,12,16,40.774065,-73.947139,10028
647746,0,0,0,35,0,35,44.704943,-73.462633,12901
618984,32,48,102,88,0,270,40.872213,-73.246522,11754
39701,0,12,72,36,0,120,43.178182,-77.581477,14609
841055,0,0,0,4,12,16,40.65302,-73.593568,11520
43565,16,20,68,41,0,145,43.066532,-77.30744,14502
368277,0,0,0,4,12,16,40.632569,-73.980794,11204
604082,0,0,0,4,12,16,40.870082,-73.839974,10469
703885,0,0,0,2,12,14,40.830478,-73.899538,10456
882300,0,0,0,4,12,16,40.669757,-73.894168,11207
699738,0,0,0,49,0,49,40.802785,-73.496039,11791
814342,0,0,0,83,0,83,40.653743,-73.933972,11203
575774,8,12,45,20,0,85,42.252137,-74.935018,13753
73899,0,0,0,282,0,282,40.861217,-73.86869,10467
580709,0,0,0,4,12,16,40.865971,-73.904187,10468
724791,0,0,0,15,0,15,40.695902,-73.896414,11385
332820,0,0,0,4,12,16,40.683231,-73.912469,11233
854112,0,0,0,4,12,16,40.824919,-73.953092,10031
860065,0,0,0,4,12,16,40.690444,-73.914301,11221
872534,0,0,0,51,0,51,40.625368,-74.15249,10303
811914,0,0,0,2,12,14,40.867896,-73.895484,10468
420490,0,0,0,4,12,16,40.678809,-73.590724,11575
266589,0,0,0,40,0,40,42.11231,-76.821844,14901
705518,0,0,54,0,0,54,43.164321,-78.69492,14094
149357,0,0,0,4,12,16,40.625009,-73.959237,11230
592010,0,0,0,4,12,16,41.428389,-73.684155,10512
855931,0,0,0,4,12,16,40.913145,-73.88236,10705
813646,0,0,0,4,12,16,40.866556,-73.889953,10458
858895,0,0,0,0,10,10,40.836142,-73.927902,10452
40941,12,24,37,0,0,73,43.054302,-77.443218,14450
431946,0,0,0,40,0,40,42.82232,-75.546938,13346
406340,0,0,0,2,12,14,40.831677,-73.935738,10039
134735,0,0,42,0,0,42,44.6759,-74.9733,13676
322374,0,0,0,2,6,8,42.449394,-75.912913,13863
829521,0,0,0,4,12,16,40.848129,-73.935989,10033
473620,0,0,0,4,12,16,40.675086,-73.794477,11436
43220,0,12,95,0,0,107,42.867669,-77.010869,14456
607733,0,0,0,0,12,12,40.856617,-73.903993,10453
634387,0,0,0,0,10,10,40.837046,-73.91716,10452
178633,0,0,0,4,12,16,43.017936,-76.162811,13207
807585,0,0,0,4,12,16,42.93368,-74.287635,12010
39784,0,0,0,65,0,65,40.676117,-73.671758,11565
40692,0,0,0,100,0,100,42.620975,-73.723215,12144
853160,0,0,0,2,6,8,40.710744,-73.755774,11423
874875,0,0,0,2,12,14,40.863206,-73.89273,10458
429708,0,0,17,0,0,17,43.174714,-76.553347,13033
498690,0,0,0,2,6,8,43.215945,-77.548125,14622
827094,0,0,0,4,12,16,41.975573,-74.522133,12725
590420,0,0,0,4,12,16,42.712347,-73.777679,12211
708272,0,0,0,2,6,8,43.224472,-77.182564,14589
597089,0,0,0,4,12,16,40.833117,-73.880551,10472
259651,0,0,0,2,12,14,40.814207,-73.910383,10455
250563,8,34,108,0,0,150,41.94042,-73.992966,12401
73423,0,0,0,200,0,200,40.715975,-73.990879,10002
665708,0,0,0,4,12,16,40.823448,-73.912532,10451
464847,0,0,0,176,0,176,40.955764,-73.783619,10801
114661,24,63,0,0,0,87,42.795096,-73.924135,12304
808114,0,0,0,4,12,16,42.783784,-74.548519,13459
573805,0,0,0,4,12,16,40.602062,-74.002989,11214
262429,0,0,0,4,12,16,40.639384,-73.908571,11236
74205,0,0,0,142,0,142,40.817657,-73.952936,10027
849741,0,0,0,4,12,16,40.684846,-73.956984,11238
850143,0,0,0,2,6,8,40.858002,-73.890199,10458
866245,8,17,20,0,0,45,40.824028,-73.2246,11788
755830,0,5,18,0,0,23,42.442848,-76.497255,14850
879053,0,0,42,60,0,102,40.650936,-73.58594,11520
433286,0,0,0,2,6,8,43.040884,-76.280934,13031
399592,0,0,0,4,12,16,40.65903,-73.960774,11225
232617,16,24,55,29,0,124,43.010617,-78.770223,14068
155103,0,0,0,2,6,8,40.708638,-73.948626,11206
45282,0,0,0,200,0,200,40.962725,-72.195135,11937
124444,0,0,0,4,12,16,43.08589,-77.938885,14416
627129,0,0,0,4,12,16,40.722483,-73.976508,10009
823023,0,0,0,4,12,16,40.879723,-73.872264,10467
738246,0,0,0,0,12,12,40.871521,-73.888089,10458
284129,0,16,132,0,0,148,40.815414,-72.959931,11763
709770,0,0,0,131,0,131,40.649496,-73.958256,11226
319209,0,0,0,4,12,16,40.715669,-73.589032,11553
39368,8,22,42,30,0,102,41.705721,-73.927094,12601
740274,0,0,0,4,12,16,40.841019,-73.910482,10457
375358,24,44,61,39,0,168,42.945638,-77.334599,14425
683020,0,0,0,2,6,8,40.643644,-74.080663,10301
108567,0,0,0,4,12,16,40.7,-73.616786,11550
497379,0,0,0,2,6,8,40.784737,-73.272825,11717
714259,0,0,0,2,6,8,40.807596,-73.174655,11749
878863,0,0,8,392,0,400,40.543218,-74.182497,10312
761512,0,0,0,4,12,16,40.631553,-73.600807,11510
44195,0,0,0,56,0,56,40.811314,-73.368226,11746
156693,0,0,0,178,0,178,40.649177,-73.955615,11226
588714,0,0,0,4,12,16,40.663112,-73.921928,11212
672829,0,0,0,4,12,16,44.93386,-74.568327,12914
818081,0,0,0,4,12,16,40.857913,-73.897881,10458
44483,8,16,42,0,0,66,42.897028,-78.841671,14212
813265,0,0,0,40,0,40,44.713746,-73.721893,12981
693369,8,16,41,30,0,95,43.000303,-73.849152,12020
863682,0,0,0,4,12,16,40.672174,-73.826003,11420
44532,0,0,0,70,0,70,42.450837,-76.495782,14850
742579,0,0,0,2,6,8,42.333613,-73.995316,12431
40336,0,0,0,82,0,82,40.876725,-73.337233,11731
831943,0,0,0,4,12,16,40.663941,-73.574905,11520
859485,0,0,0,2,12,14,40.87971,-73.873076,10467
683249,0,0,0,200,0,200,40.75818,-73.878748,11369
21455,0,0,0,4,12,16,42.992722,-78.183187,14020
339200,0,0,0,285,0,285,40.71912,-73.983281,10002
727962,0,0,0,2,6,8,43.225392,-77.596868,14617
833891,0,0,0,4,12,16,40.677927,-73.955498,11238
626024,0,0,0,96,0,96,40.822144,-73.855873,10473
39989,0,30,20,24,0,74,43.068932,-76.101543,13206
870482,0,0,0,2,6,8,43.073343,-76.147128,13208
662577,0,0,0,2,6,8,42.619312,-78.251582,14024
42587,16,16,24,0,0,56,41.340512,-74.358659,10921
238339,0,0,0,4,12,16,40.639035,-73.882028,11236
492886,0,0,0,4,12,16,40.619892,-73.749402,11096
658230,0,0,0,4,12,16,40.658991,-73.923707,11212
746837,0,0,0,157,0,157,40.86284,-73.859237,10469
742497,0,0,0,196,0,196,40.606692,-74.007946,11214
72042,0,0,0,2,12,14,40.67065,-73.740407,11413
495043,0,0,0,4,12,16,40.607423,-73.991033,11214
734124,0,0,0,4,12,16,40.916985,-73.89578,10705
847045,0,0,0,2,6,8,44.022053,-75.714439,13619
654695,0,0,0,4,12,16,41.192219,-74.040902,10970
450960,0,0,0,2,6,8,43.042525,-76.1613,13204
765276,0,0,0,4,12,16,40.857088,-73.905189,10453
265333,0,0,0,0,12,12,40.831706,-73.879772,10472
821514,0,0,0,0,12,12,40.832036,-73.91677,10456
520132,0,0,0,2,12,14,40.855465,-73.90867,10453
848657,0,0,0,4,12,16,40.660419,-73.581817,11520
41411,0,0,0,44,0,44,42.933787,-78.694487,14086
748853,0,0,0,2,6,8,40.912816,-73.895338,10705
196047,0,0,0,2,6,8,42.938913,-74.170872,12010
732816,0,58,159,0,0,217,40.666095,-73.642345,11570
315526,0,0,0,4,12,16,40.712544,-73.773063,11423
858173,0,0,0,102,0,102,40.67812,-73.889688,11207
864105,0,0,0,4,12,16,40.83827,-73.922293,10452
248021,0,0,0,300,0,300,40.703128,-73.948137,11206
184544,0,0,0,2,5,7,43.061462,-76.601513,13166
40702,0,0,0,77,0,77,42.832109,-73.891624,12309
826825,0,0,0,229,0,229,40.766037,-73.98953,10019
812246,0,0,0,4,12,16,41.048343,-73.823134,10523
828416,0,0,0,4,12,16,43.206576,-77.595991,14617
435377,0,0,0,1,5,6,40.832889,-73.916548,10456
851127,0,0,0,2,6,8,42.927025,-78.848547,14214
819421,8,21,96,0,0,125,41.22087,-73.88322,10520
286294,0,0,0,4,12,16,40.686115,-73.431373,11758
40626,0,0,0,138,0,138,42.649098,-73.936548,12186
855102,0,0,0,2,6,8,41.63375,-73.929439,12601
236600,0,0,0,4,12,16,40.887728,-73.832769,10466
831632,0,0,0,4,12,16,40.671918,-73.822579,11420
823939,0,0,0,4,12,16,40.655541,-73.935449,11203
869285,0,6,38,0,0,44,40.64121,-73.651317,11572
218792,0,0,0,4,12,16,40.919369,-73.858802,10704
616705,0,0,0,4,12,16,42.980491,-74.344467,12095
728046,0,0,0,2,6,8,42.89703,-76.862188,13165
832842,0,0,0,4,12,16,41.060092,-73.812701,10523
453492,0,0,0,4,12,16,40.682202,-73.890545,11207
40080,8,12,58,20,0,98,41.436728,-74.427984,10940
279545,0,0,0,2,6,8,43.058691,-76.144065,13203
847695,0,0,0,4,12,16,40.876957,-73.863826,10467
808609,0,0,0,144,0,144,40.872912,-73.874694,10467
736150,0,0,0,4,12,16,40.868733,-73.884447,10458
838863,0,0,0,4,12,16,40.866636,-73.923067,10034
801428,0,0,0,4,12,16,40.653406,-73.934323,11203
349221,0,0,0,4,12,16,40.813113,-73.13225,11779
471974,0,0,0,4,12,16,44.692441,-73.476527,12901
848198,0,0,0,4,12,16,40.856343,-73.929931,10040
128730,0,0,0,4,12,16,40.605315,-73.758876,11691
773947,0,0,0,155,0,155,42.816733,-78.802549,14218
866858,0,0,0,4,12,16,40.879824,-73.876261,10467
71378,0,0,0,4,12,16,40.610436,-73.971334,11230
770700,8,12,98,0,0,118,40.835286,-73.063959,11738
42508,0,0,0,93,0,93,41.331636,-73.789433,10598
844312,0,0,0,0,12,12,40.884142,-73.902391,10463
613922,0,0,0,4,12,16,40.687273,-73.780227,11434
445214,0,0,0,177,0,177,40.832467,-73.918974,10456
692014,0,0,0,4,12,16,40.665607,-73.883862,11207
806999,0,0,0,2,12,14,40.866803,-73.889303,10458
837345,8,12,92,0,0,112,40.955348,-73.889117,10701
146029,0,0,0,4,12,16,40.607937,-73.984283,11204
831434,0,0,0,0,12,12,40.860869,-73.907648,10468
742242,0,0,0,4,12,16,40.740258,-73.85167,11368
29830,0,0,0,2,6,8,43.252925,-76.240398,13132
647879,0,0,0,4,12,16,40.69048,-73.628944,11550
741408,0,0,0,40,0,40,41.59807,-73.88136,12590
835829,0,0,0,4,12,16,40.711242,-73.809432,11435
870848,0,0,0,4,12,16,41.323441,-74.127141,10917
698754,0,0,0,4,12,16,40.787386,-73.64158,11577
256424,0,0,0,4,12,16,40.680036,-73.780769,11434
867702,0,0,0,2,6,8,43.128079,-77.639578,14611
222346,0,0,0,2,6,8,40.696896,-73.720258,11003
101469,0,0,0,326,0,326,40.609302,-74.103973,10301
45044,0,0,0,40,0,40,41.560139,-74.190095,12586
389726,8,20,18,0,0,46,40.756948,-73.58757,11590
159549,0,0,0,2,6,8,40.673035,-73.940724,11213
177950,0,0,0,4,12,16,40.924261,-73.797736,10801
771744,0,0,0,4,12,16,40.814892,-73.863802,10473
655472,0,0,0,4,12,16,40.765057,-72.867975,11967
633751,0,0,0,4,12,16,40.818482,-73.889338,10474
709740,0,0,0,365,0,365,40.664132,-73.92172,11212
854008,12,12,16,17,0,57,41.47843,-73.650183,12531
418374,0,0,0,4,12,16,41.448245,-74.434033,10940
44000,0,0,0,40,0,40,43.149375,-76.184792,13090
40584,0,20,181,38,0,239,40.982973,-73.777761,10583
277567,0,0,0,4,12,16,40.689297,-73.862742,11421
869748,0,0,0,2,6,8,42.746224,-78.130825,14569
761562,0,0,0,4,12,16,43.069852,-76.146845,13208
26213,0,0,0,0,10,10,40.69794,-73.586762,11553
716577,0,0,0,4,12,16,40.706683,-73.606886,11550
494138,0,0,0,4,12,16,40.849138,-73.864823,10462
39779,16,23,20,0,0,59,43.194557,-77.501208,14580
807469,0,0,0,0,12,12,40.831437,-73.876573,10472
790777,0,0,0,4,12,16,41.043753,-73.793632,10607
414940,0,0,0,300,0,300,40.627694,-74.004065,11219
800739,0,0,0,2,6,8,41.703945,-73.91419,12601
216453,0,0,0,2,12,14,40.869137,-73.921804,10034
823305,0,0,0,4,12,16,43.187447,-77.601988,14621
41564,0,0,0,44,0,44,42.868635,-73.808407,12065
852172,16,32,34,20,0,102,42.894481,-78.630802,14086
840601,0,0,0,23,0,23,40.676331,-73.892959,11207
72513,0,0,0,4,12,16,40.689831,-73.757606,11412
43591,0,0,18,0,0,18,44.89289,-73.84124,12935
645512,0,0,0,60,0,60,40.908137,-73.842167,10550
41080,0,9,73,0,0,82,41.010811,-73.793466,10583
765881,0,0,0,4,12,16,40.837878,-73.905972,10456
845352,0,0,0,4,12,16,40.661711,-73.991256,11215
402585,8,8,38,0,0,54,42.927012,-78.742106,14225
782093,0,0,0,4,12,16,40.874023,-73.152056,11780
865966,0,0,0,0,12,12,40.864488,-73.891087,10458
379785,0,0,0,2,6,8,42.806021,-73.911272,12309
233455,0,0,0,2,12,14,40.854385,-73.928766,10040
802315,0,0,0,4,12,16,40.641664,-73.997282,11219
719454,0,0,0,4,12,16,40.835491,-73.924497,10452
831205,0,0,0,2,12,14,40.812833,-73.908098,10455
837949,0,0,0,4,12,16,40.625275,-73.946407,11210
139807,0,0,0,135,0,135,40.735974,-73.211256,11751
832337,0,0,0,4,12,16,40.837575,-73.889189,10460
269469,0,0,0,4,12,16,41.121419,-74.023136,10956
40472,0,24,18,0,0,42,43.320361,-73.576851,12839
606479,0,0,0,4,12,16,40.681918,-73.7814,11434
450093,0,0,0,2,12,14,40.735114,-73.823758,11367
769432,0,0,0,2,12,14,40.869609,-73.886594,10458
39867,47,42,151,176,0,416,40.778336,-73.46723,11803
491506,0,0,0,4,12,16,40.824134,-73.952504,10031
831665,12,20,37,34,0,103,42.797861,-77.791502,14454
240933,0,0,0,4,12,16,42.490788,-76.328705,13068
538172,0,0,0,4,12,16,40.730376,-73.95328,11222
173088,0,0,0,4,12,16,41.147707,-74.043612,10977
680975,0,0,0,300,0,300,40.879695,-73.910229,10463
879320,0,0,0,4,12,16,40.830106,-73.906088,10456
771304,0,0,0,2,6,8,43.166084,-77.636211,14606
42555,0,0,0,40,0,40,41.094123,-73.975395,10994
827752,0,0,0,100,0,100,41.331149,-73.806517,10535
647140,0,0,0,4,12,16,40.666176,-73.983911,11215
373175,0,0,0,4,12,16,40.860386,-73.926937,10040
713544,0,0,0,4,12,16,43.215611,-75.461126,13440
866321,0,0,0,4,12,16,43.207732,-77.713263,14626
878017,0,0,0,4,12,16,40.712748,-73.961055,11211
53402,0,0,0,0,5,5,40.840869,-73.922981,10452
704847,0,0,0,4,12,16,40.827858,-73.896966,10459
796138,0,0,0,326,0,326,40.696707,-73.839266,11418
734957,0,0,63,0,0,63,42.796948,-73.966178,12306
754955,0,0,0,0,12,12,40.904446,-73.851112,10470
36147,0,0,0,4,12,16,43.192477,-77.637516,14615
714629,0,0,0,4,12,16,40.696765,-73.842048,11418
17553,0,0,0,4,12,16,42.310881,-75.401384,13838
324211,0,0,0,4,12,16,40.83798472,-73.86358061,10462
653794,0,0,129,0,0,129,43.164321,-78.69492,14094
72070,0,0,0,4,12,16,40.678012,-73.886256,11207
795676,0,0,0,4,12,16,40.676591,-73.809115,11420
464806,0,0,0,4,12,16,40.778371,-72.848248,11951
199173,20,24,43,40,0,127,42.846794,-78.697561,14224
44065,24,36,64,0,0,124,43.001659,-78.77958,14260
629131,0,0,0,4,12,16,40.822891,-73.950628,10031
43113,8,22,32,80,0,142,42.940052,-78.890154,14207
685009,0,0,0,4,12,16,43.22626,-77.640402,14616
702065,0,0,0,2,12,14,40.61044,-73.970383,11230
181836,0,0,0,2,6,8,41.634781,-73.927836,12601
396885,0,0,0,4,12,16,40.690588,-73.915336,11221
229087,0,0,0,420,0,420,40.852627,-73.921269,10453
709859,0,0,0,444,0,444,40.583355,-73.953826,11235
231041,0,0,0,2,6,8,43.076379,-77.58686,14623
451047,0,0,0,4,12,16,41.620271,-74.115192,12589
879543,0,0,0,4,12,16,40.84501,-73.879617,10460
135827,0,0,0,281,0,281,40.724513,-73.808545,11366
609562,0,0,0,40,0,40,43.077283,-76.021818,13057
865366,0,0,0,0,6,6,40.824004,-73.92615,10451
818301,0,0,0,4,12,16,40.682786,-74.003201,11231
704149,0,0,0,4,12,16,40.760226,-73.813635,11355
826515,0,0,0,0,10,10,40.666223,-73.896505,11207
603401,0,0,0,4,12,16,40.680898,-73.739013,11413
41109,0,0,17,0,0,17,44.982384,-73.409875,12919
836101,0,0,0,160,0,160,40.939567,-73.750307,10543
819560,0,0,0,4,12,16,40.910248,-73.889125,10705
425102,0,0,0,2,12,14,40.840399,-73.869467,10460
614406,0,0,0,2,6,8,40.856539,-73.916386,10453
736330,0,0,0,4,12,16,40.880763,-73.905467,10463
850751,0,0,0,4,12,16,40.697471,-73.76021,11412
804688,0,0,0,0,12,12,43.193705,-77.640848,14615
618267,0,0,0,64,0,64,40.856129,-73.937294,10040
751515,0,0,0,4,12,16,40.887365,-73.862153,10466
40116,0,12,21,11,0,44,41.355807,-73.775103,10541
803660,0,0,0,2,6,8,42.099382,-76.073744,13760
641485,0,0,0,4,12,16,40.824004,-73.92615,10451
875824,0,0,0,4,12,16,40.721949,-73.814954,11367
674560,0,0,0,4,12,16,40.592595,-73.933852,11235
702841,0,0,0,4,12,16,40.776153,-73.927208,11102
880848,0,0,0,4,12,16,40.857357,-73.9162,10453
649582,0,0,0,4,12,16,40.837533,-73.8487,10462
789704,0,0,0,4,12,16,40.812826,-73.916428,10455
258359,0,0,0,2,6,8,40.837298,-73.889569,10460
767187,0,0,0,2,6,8,41.807431,-74.739611,12754
692302,0,0,0,4,12,16,40.598265,-73.740854,11691
709824,0,0,0,139,0,139,40.606609,-73.938867,11229
564465,0,0,63,16,0,79,42.903074,-78.881393,14201
775110,0,0,0,90,0,90,40.81179,-73.956571,10027
533092,0,0,0,4,12,16,40.867417,-73.851333,10469
42795,0,0,0,44,0,44,40.754579,-73.049453,11705
880385,0,0,0,2,12,14,40.830263,-73.895738,10459
469194,0,0,38,0,0,38,42.956914,-78.86169,14216
39605,0,12,21,40,0,73,43.054284,-75.867907,13037
44258,0,35,97,0,0,132,40.77907,-73.477497,11803
881995,0,0,0,206,0,206,40.84505,-73.897193,10457
786712,0,0,0,0,12,12,43.084033,-78.971705,14304
41635,0,0,0,127,0,127,43.249344,-77.694506,14612
842288,0,0,0,4,12,16,40.874994,-73.875197,10467
483391,0,0,10,0,0,10,41.661727,-73.876843,12603
696475,0,0,0,238,0,238,40.730806,-73.805403,11365
765573,0,0,0,50,0,50,43.315812,-76.43278,13069
709763,0,0,0,146,0,146,40.508089,-74.243421,10307
421625,7,12,0,0,0,19,41.142501,-74.029463,10977
41767,0,0,35,0,0,35,42.906233,-76.112359,13084
73092,0,0,0,60,0,60,40.674867,-73.954179,11216
854602,0,0,0,2,6,8,44.847195,-74.282659,12953
511827,0,0,0,4,12,16,41.134526,-74.044961,10977
858540,0,0,0,0,10,10,40.69909,-73.714198,11003
817343,0,0,0,265,0,265,40.635593,-73.886454,11236
401628,0,0,0,4,12,16,42.995636,-78.706603,14221
684491,0,0,0,415,0,415,40.875723,-73.901063,10463
650989,0,0,0,57,0,57,40.842447,-73.917388,10452
229917,0,0,0,4,12,16,41.283493,-73.927935,10566
879223,12,19,34,7,0,72,42.910269,-78.70901,14043
711912,0,0,0,200,0,200,40.712835,-73.908502,11385
24815,0,0,0,2,5,7,42.663226,-77.059585,14527
339159,0,0,0,115,0,115,40.624254,-74.018534,11228
690000,0,0,0,4,12,16,40.816968,-73.900704,10455
863225,0,0,0,4,12,16,40.64414,-74.007488,11220
877713,0,0,0,2,6,8,40.831819,-73.412957,11746
878494,0,0,165,0,0,165,40.94017,-73.890647,10703
364787,0,0,0,4,12,16,40.830851,-73.92174,10452
656324,0,0,0,20,0,20,42.922087,-78.824048,14215
706721,0,0,0,4,12,16,41.484721,-74.477819,10940
43367,0,22,210,0,0,232,43.029102,-77.10582,14513
820990,0,0,0,30,0,30,40.669603,-73.765812,11434
572576,0,0,0,4,12,16,40.841406,-73.936001,10032
860320,0,0,0,4,12,16,41.131291,-74.062328,10952
760362,0,5,37,0,0,42,41.78903,-73.911374,12538
641674,0,0,0,4,12,16,40.865052,-73.90326,10468
388597,0,0,0,4,12,16,40.83427,-73.912328,10456
460886,0,0,0,4,12,16,40.751162,-73.866692,11368
873806,0,0,0,4,12,16,43.191513,-77.635949,14613
261402,0,0,0,4,12,16,40.649313,-73.697429,11581
726539,0,0,0,4,12,16,40.875224,-73.870103,10467
844000,0,0,0,0,12,12,42.170825,-76.216128,13827
578159,0,0,0,4,12,16,40.694446,-73.917432,11221
382946,0,0,0,4,12,16,40.830522,-73.871715,10472
223359,0,0,0,1,6,7,40.836749,-73.846371,10462
229226,0,0,0,2,6,8,40.836089,-73.926146,10452
119358,0,0,0,2,6,8,43.300315,-73.63343,12803
474350,0,0,0,4,12,16,40.819164,-73.911059,10455
411341,0,24,91,0,0,115,40.88049,-73.630249,11542
744599,0,0,44,0,0,44,41.019525,-73.77294,10606
830890,0,0,0,4,12,16,42.919848,-78.799329,14225
669055,0,0,0,4,12,16,40.63891,-74.16931,10303
880184,0,0,0,4,12,16,40.671202,-73.380495,11757
595358,0,0,0,160,0,160,40.662781,-73.453797,11762
805710,0,0,0,116,0,116,40.785116,-73.973387,10024
769009,0,0,0,4,12,16,40.6679,-73.5818,11520
72889,0,0,0,103,0,103,40.808427,-73.916659,10454
41280,16,49,81,21,0,167,41.55242,-73.811509,12533
882931,0,0,0,0,10,10,40.883307,-73.897955,10463
743584,0,0,0,4,12,16,40.871298,-73.882365,10458
685877,0,0,29,0,0,29,43.186164,-77.590699,14621
578982,0,0,0,4,12,16,40.684387,-73.939153,11221
522590,0,0,0,2,6,8,42.133531,-77.035978,14830
107741,0,0,0,4,12,16,40.654237,-73.962002,11226
794125,0,0,0,4,12,16,40.85366,-73.927045,10040
861067,0,0,18,0,0,18,41.526005,-74.236382,12549
112885,0,0,0,466,0,466,40.611381,-73.99456,11214
865627,0,0,19,0,0,19,42.891407,-73.97845,12302
810501,0,0,0,4,12,16,40.607433,-73.984091,11204
190208,0,0,0,4,12,16,40.629062,-74.078556,10304
7753,0,0,0,4,12,16,41.619007,-73.665395,12570
646734,0,0,0,4,12,16,42.284001,-73.756003,12534
39948,16,20,60,0,0,96,43.165074,-75.340017,13424
709905,0,0,0,291,0,291,40.811157,-73.957177,10027
600978,16,24,40,0,0,80,43.109945,-77.44159,14450
546807,0,0,0,2,6,8,40.668515,-73.957444,11225
838689,0,0,0,4,12,16,40.891313,-73.857961,10466
314840,48,51,41,0,0,140,40.660368,-73.550991,11566
878779,0,0,0,4,12,16,40.664276,-73.747727,11413
40881,0,0,0,40,0,40,42.76346,-78.752269,14127
40139,8,12,20,0,0,40,42.525239,-73.71587,12033
610193,0,0,0,102,0,102,40.685077,-73.440157,11762
794112,0,0,0,2,12,14,40.81525,-73.904925,10455
43017,16,24,18,0,0,58,42.135573,-77.038279,14830
354802,0,0,0,4,12,16,40.631991,-73.934885,11210
866963,0,0,0,0,12,12,40.856758,-73.897586,10458
109445,0,0,0,100,0,100,42.919771,-76.719321,13021
312602,0,0,0,4,12,16,40.642217,-74.015803,11220
712601,0,0,0,2,6,8,41.592686,-73.916881,12590
849070,0,0,0,4,12,16,40.695565,-73.617707,11550
620077,0,0,0,298,0,298,40.711048,-74.00536,10038
793351,0,0,0,4,12,16,40.710924,-73.587401,11553
40287,0,0,197,18,0,215,40.806426,-73.342208,11746
870053,0,23,54,24,0,101,41.011928,-73.917529,10964
766230,32,24,78,82,0,216,42.157405,-78.741657,14779
712502,0,0,0,18,0,18,40.593796,-74.087463,10305
798667,0,0,0,2,12,14,40.866309,-73.902347,10468
41899,0,0,0,35,0,35,43.003549,-75.005783,13407
243357,0,0,0,73,0,73,42.081768,-79.240314,14701
660346,0,0,0,80,0,80,40.716321,-73.840989,11375
650107,0,0,0,4,12,16,40.863749,-73.898043,10468
346622,0,0,0,4,12,16,40.894352,-73.845347,10466
40753,0,0,0,100,0,100,42.136862,-77.063282,14830
847119,16,21,30,14,0,81,41.230411,-73.900789,10520
72579,0,0,0,0,12,12,40.832629,-73.921791,10452
9346,0,0,0,4,12,16,43.038757,-76.454602,13060
750783,0,0,0,2,6,8,40.7897,-73.944679,10029
737344,0,0,0,4,12,16,40.875861,-73.886327,10468
717612,0,0,0,2,6,8,43.086721,-76.866308,14433
254731,0,0,0,400,0,400,40.744335,-74.00055,10011
874995,0,0,0,0,12,12,40.669069,-73.577611,11520
800203,0,0,0,159,0,159,40.819048,-73.919393,10451
73562,0,0,0,160,0,160,40.713158,-73.991349,10002
659458,0,0,0,4,12,16,40.680368,-73.384155,11757
745071,0,0,0,4,12,16,40.662231,-73.893614,11207
836488,0,0,0,4,12,16,40.756417,-73.934929,11101
598890,0,0,0,4,12,16,40.68315,-73.876969,11208
874967,0,0,0,4,12,16,40.697257,-73.670888,11010
40559,8,8,29,0,0,45,41.288587,-73.920322,10566
880543,0,0,0,4,12,16,40.722952,-73.365415,11704
136955,0,0,0,2,12,14,40.788344,-73.939487,10029
861448,0,0,0,4,12,16,40.848127,-73.885518,10457
763960,0,0,0,4,12,16,43.214091,-77.612211,14617
778803,0,0,0,4,12,16,40.84903,-73.92071,10453
387484,0,0,0,4,12,16,40.695404,-73.893806,11385
876747,0,0,0,2,6,8,43.163489,-76.348157,13027
694157,0,0,0,4,12,16,40.84041,-73.881596,10460
676499,0,0,0,4,12,16,42.924643,-78.823284,14215
675422,0,0,0,2,6,8,43.153321,-75.917691,13030
208271,0,0,0,4,12,16,40.635637,-73.892082,11236
555208,0,0,0,2,6,8,43.173581,-76.53713,13033
856735,0,0,0,4,12,16,40.789029,-73.952,10029
816157,0,0,0,2,6,8,40.854398,-73.915216,10453
882614,0,0,23,19,0,42,40.907489,-73.832854,10550
840137,0,0,0,4,12,16,42.073254,-76.808151,14904
837756,0,0,0,4,12,16,42.636541,-73.738315,12144
43154,0,30,55,0,0,85,41.165639,-73.761035,10514
587352,0,0,0,4,12,16,43.047565,-76.103385,13224
330984,0,0,0,4,12,16,40.670786,-73.878855,11208
598180,0,0,0,4,12,16,43.167001,-77.651168,14606
32197,0,0,0,2,6,8,43.016198,-74.373073,12095
783354,16,24,67,0,0,107,40.940828,-72.998736,11764
711080,0,0,0,20,0,20,41.653581,-73.910671,12603
842032,0,31,48,0,0,79,40.943547,-73.738767,10543
829839,0,0,0,0,12,12,40.835103,-73.886059,10460
492292,0,0,0,0,12,12,40.820909,-73.906138,10456
661680,0,0,35,10,0,45,41.549164,-73.861926,12524
372166,0,0,0,231,0,231,40.659182,-73.922655,11212
819166,0,0,0,4,12,16,40.637724,-73.934499,11203
877993,0,0,0,62,0,62,42.0883,-78.1536,14774
671258,0,0,0,2,6,8,40.841639,-73.01751,11738
757062,0,0,0,145,0,145,40.836461,-73.892784,10460
876743,0,0,39,0,0,39,41.649139,-73.562108,12594
815496,0,0,0,209,0,209,40.759353,-73.912398,11103
2629,0,0,0,2,6,8,42.862144,-76.997167,14456
877979,0,0,0,2,6,8,44.929527,-74.88842,13662
773061,0,0,0,4,12,16,40.859244,-73.893433,10458
43521,0,12,32,0,0,44,42.457633,-76.486099,14850
709685,0,0,0,144,0,144,40.74432,-73.727034,11426
548365,0,0,0,4,12,16,40.675176,-73.859637,11417
854756,0,0,0,80,0,80,43.096054,-79.041084,14301
877639,0,0,0,132,0,132,40.65341,-73.932976,11203
364142,0,0,0,105,0,105,40.793346,-73.267138,11717
440121,0,0,0,101,0,101,40.760401,-73.818013,11355
781642,0,0,0,0,12,12,40.850908,-73.921544,10453
275554,0,0,0,4,12,16,40.824858,-73.890694,10459
42111,20,24,32,36,0,112,43.177195,-76.307596,13027
237739,0,0,0,120,0,120,42.683534,-73.799394,12205
878280,0,0,0,124,0,124,40.943668,-72.626815,11901
532278,0,0,0,4,12,16,40.657718,-73.738662,11422
871451,0,0,0,2,6,8,44.031525,-76.035908,13634
720852,0,0,0,2,6,8,43.212855,-77.580012,14617
844818,0,0,0,0,12,12,40.830096,-73.906476,10456
644960,0,0,96,101,0,197,41.449215,-74.42201,10940
880334,0,0,0,110,0,110,40.758676,-73.824384,11355
502254,0,0,0,0,6,6,40.848237,-73.914401,10453
709668,0,0,0,240,0,240,40.818766,-73.905816,10456
40838,0,32,76,0,0,108,42.087231,-75.965702,13850
879377,0,0,0,2,6,8,43.157224,-77.630045,14611
264246,0,41,81,0,0,122,41.197412,-73.680414,10549
73733,0,0,0,360,0,360,40.782311,-73.778854,11360
791993,0,0,0,4,12,16,40.699276,-73.6415,11552
205356,0,0,0,4,12,16,41.10143,-74.051701,10977
530785,0,0,0,4,12,16,40.608014,-73.756936,11691
569205,0,0,0,4,12,16,42.393693,-77.691017,14807
44139,0,0,16,100,0,116,42.082099,-78.412784,14760
624602,0,0,0,17,0,17,40.683293,-73.910855,11207
797998,0,0,0,17,0,17,40.864264,-73.889211,10458
44682,0,0,0,108,0,108,42.437445,-76.47795,14850
20425,0,0,0,4,12,16,43.125124,-75.748018,13032
149906,0,0,0,4,12,16,43.142867,-77.634972,14611
877882,0,0,0,4,12,16,41.331034,-74.126641,10917
413130,0,0,0,4,12,16,40.844102,-73.909599,10457
707777,0,0,0,4,12,16,40.950288,-73.790964,10804
106858,0,0,0,160,0,160,40.809207,-73.925525,10454
867052,0,0,17,0,0,17,42.446669,-75.593337,13830
502559,0,0,0,0,12,12,40.867622,-73.924385,10034
582851,8,15,21,0,0,44,41.538655,-73.584708,12564
67207,0,0,0,2,5,7,40.797762,-73.937003,10035
570721,0,0,0,2,6,8,44.448313,-75.150353,13652
40855,0,0,18,0,0,18,42.88534,-75.189425,13491
426431,32,40,60,30,0,162,43.067423,-77.614378,14623
272783,0,0,0,4,12,16,40.61673,-74.037306,11209
689306,0,0,0,4,12,16,40.697071,-73.605304,11550
789180,0,0,0,4,12,16,40.837059,-73.914707,10456
171422,0,0,162,0,0,162,42.46417,-79.333403,14048
462258,0,0,0,183,0,183,40.806362,-73.921358,10454
874400,16,47,85,20,0,168,40.776505,-73.469821,11803
881017,0,0,0,4,12,16,40.840751,-73.911308,10457
42248,0,0,0,60,0,60,43.125455,-79.05108,14305
866805,0,0,14,0,0,14,42.145797,-75.89003,13901
288259,0,12,159,0,0,171,40.823501,-73.185998,11788
39310,6,10,15,10,0,41,42.419163,-73.675219,12184
687534,0,0,0,298,0,298,40.85309,-73.927559,10040
42802,0,0,0,61,0,61,40.869898,-72.519572,11946
14165,0,0,0,2,6,8,42.902325,-73.912889,12027
764565,0,0,0,2,6,8,40.833129,-73.906743,10456
805025,0,0,0,2,6,8,40.815957,-73.937648,10037
776621,0,0,0,4,12,16,40.86889,-73.922465,10034
73230,0,0,0,175,0,175,40.598714,-73.941329,11229
880239,0,0,0,4,12,16,40.6791,-73.883682,11208
162383,0,0,0,4,12,16,40.657675,-73.732657,11422
843412,0,0,0,4,12,16,40.585232,-73.963348,11235
709540,0,0,0,186,0,186,40.780592,-73.947954,10128
142437,0,0,36,0,0,36,42.612425,-76.191037,13045
371260,0,0,0,4,12,16,40.918399,-73.851554,10704
73664,0,0,0,486,0,486,40.839427,-73.935913,10032
297391,0,0,0,4,12,16,40.866998,-73.856921,10469
230447,0,0,0,173,0,173,40.729071,-73.893468,11378
794156,0,0,0,4,12,16,42.719448,-78.004205,14530
811107,0,0,0,4,12,16,40.686821,-73.868536,11208
34902,0,0,0,0,12,12,40.637373,-73.647668,11572
584941,0,0,0,2,6,8,40.78211,-73.228096,11717
719833,0,0,0,4,12,16,40.707485,-73.607865,11550
833303,0,0,0,2,6,8,40.826238,-73.902097,10456
355638,0,8,75,0,0,83,40.818,-73.16663,11788
503880,0,0,0,2,12,14,40.826206,-73.900722,10456
500307,0,0,0,2,6,8,42.965462,-76.586848,13021
669390,0,0,0,166,0,166,40.768211,-73.922998,11102
857989,0,0,0,4,12,16,40.69043,-73.526843,11710
613252,0,0,0,222,0,222,40.669082,-73.96052,11225
74081,0,0,0,7,0,7,40.615242,-73.944881,11229
840903,0,22,45,0,0,67,40.756354,-73.644456,11596
362789,0,0,0,2,12,14,40.594938,-73.754993,11691
717052,0,0,0,4,12,16,43.405315,-74.286108,12190
539236,0,0,0,0,12,12,40.850663,-73.918013,10453
709648,0,0,0,129,0,129,40.60174,-73.762897,11691
818569,0,0,0,243,0,243,40.827883,-73.914174,10456
631922,0,0,0,2,6,8,43.218674,-77.643785,14616
445458,16,16,33,0,0,65,42.096995,-75.87533,13903
348479,0,0,0,0,12,12,40.738104,-73.855659,11368
244520,0,0,0,166,0,166,40.703897,-73.922573,11237
797904,0,0,0,4,12,16,44.105164,-75.728749,13673
133785,0,0,0,2,6,8,41.084252,-74.046636,10977
861380,0,0,0,4,12,16,40.841364,-73.891609,10457
42685,16,24,49,40,0,129,42.955127,-78.821089,14214
854925,0,0,0,4,12,16,40.87571,-73.88041,10467
44850,0,0,0,40,0,40,41.397743,-74.180772,10992
583244,0,0,0,2,12,14,40.823576,-73.888448,10459
827466,0,0,0,0,12,12,40.840872,-73.854251,10462
703156,0,0,0,2,6,8,40.855983,-73.902212,10453
325035,0,0,0,2,6,8,44.991695,-74.486075,12937
857568,0,0,0,87,0,87,41.150718,-73.944335,10920
405419,0,0,0,1,6,7,40.651306,-74.008205,11232
774035,0,0,0,2,6,8,43.16944,-77.572873,14609
524690,16,24,39,20,0,99,43.218012,-77.732122,14626
597339,0,0,0,4,12,16,40.841817,-73.926261,10452
866469,0,0,0,2,6,8,43.162688,-76.160045,13041
851690,0,0,0,4,12,16,42.130251,-76.988695,14830
741990,0,0,0,380,0,380,40.742337,-74.002348,10011
276128,0,0,0,4,12,16,40.695902,-73.896414,11385
376490,0,0,0,4,12,16,40.659392,-73.960735,11225
772314,0,0,0,4,12,16,42.83755,-77.641854,14485
41043,0,0,0,44,0,44,40.740279,-73.059025,11705
637385,0,0,0,2,12,14,40.841252,-73.890454,10460
710139,0,0,17,0,0,17,43.082675,-75.263017,13501
812069,0,0,0,200,0,200,40.88114,-73.839584,10466
857075,0,0,0,4,12,16,42.924089,-78.797922,14215
588339,0,0,0,4,12,16,40.832484,-73.877072,10472
860995,0,0,0,4,12,16,40.595291,-73.761357,11691
879991,0,0,0,4,12,16,40.654002,-73.980397,11218
240414,0,0,0,2,6,8,42.853659,-73.778481,12065
223774,0,0,0,385,0,385,40.737089,-73.887739,11373
59063,0,0,0,0,6,6,40.688204,-73.973011,11205
825206,0,0,0,60,0,60,40.739268,-73.626099,11530
443903,0,0,0,2,6,8,40.639584,-74.166256,10303
861882,0,0,0,2,6,8,43.031652,-76.159787,13207
291228,0,0,0,44,0,44,42.97148,-78.667865,14221
878157,0,0,0,4,12,16,40.695109,-73.902251,11385
459216,0,19,334,0,0,353,40.724863,-73.521157,11756
610480,0,0,0,4,12,16,40.814523,-73.952895,10027
805702,0,0,0,226,0,226,40.772541,-73.988507,10023
168446,0,0,0,4,12,16,42.997965,-78.193982,14020
736829,0,0,0,44,0,44,42.725726,-78.000173,14530
414634,0,20,106,7,0,133,40.759233,-73.535664,11801
437226,0,23,34,0,0,57,40.99884,-73.676268,10573
881721,0,0,0,4,12,16,40.846294,-73.833597,10461
110660,0,0,0,2,6,8,40.642499,-74.017041,11220
251420,0,0,0,2,6,8,40.834274,-72.870576,11967
287056,0,0,0,0,12,12,40.855825,-73.899836,10457
835415,0,0,0,50,0,50,40.89437,-72.977044,11953
809874,0,0,0,4,12,16,44.882185,-73.775976,12935
828942,0,0,0,4,12,16,40.687719,-73.75727,11412
475354,0,0,0,2,6,8,41.726273,-73.913934,12601
856020,0,0,0,4,12,16,40.628242,-74.15197,10303
108195,0,0,0,4,12,16,40.85439,-73.911523,10453
209629,16,24,39,0,0,79,40.825297,-73.389893,11746
44939,0,0,112,0,0,112,41.049302,-72.437872,11971
495759,0,0,0,4,12,16,40.874146,-73.901907,10468
43394,0,0,0,75,0,75,40.694975,-73.564817,11566
506222,0,0,0,4,12,16,40.584309,-73.952872,11235
270506,0,0,0,4,12,16,40.830029,-72.874092,11967
207169,0,0,0,4,12,16,40.869062,-73.845014,10469
507684,0,0,0,4,12,16,40.883105,-73.885047,10467
764902,0,0,0,100,0,100,40.834487,-73.92973,10452
243866,0,0,0,300,0,300,40.579858,-73.956274,11235
367225,0,0,0,4,12,16,40.665447,-73.892087,11207
871968,0,0,0,2,6,8,43.187887,-77.606004,14621
427284,0,0,0,4,12,16,40.66274,-73.917501,11212
826265,0,0,0,4,12,16,40.679232,-73.979904,11217
783540,0,0,0,2,6,8,42.843834,-78.787879,14224
677771,8,18,34,0,0,60,41.33642,-74.193924,10950
525373,0,0,0,4,12,16,40.917806,-73.891331,10705
72800,0,0,0,4,12,16,40.627438,-73.926593,11234
744760,0,0,0,49,0,49,40.679847,-73.923383,11233
419319,0,0,0,4,12,16,40.834428,-73.899874,10456
872127,0,0,35,0,0,35,40.603412,-73.655863,11558
457953,0,0,0,4,12,16,40.675667,-73.933082,11213
784205,0,0,0,4,12,16,40.792418,-73.217051,11722
874089,0,0,0,2,12,14,40.893314,-73.856655,10466
846195,0,0,0,2,6,8,42.464012,-74.099794,12120
780687,0,0,0,0,6,6,40.852594,-73.909457,10453
739191,8,36,99,0,0,143,40.664731,-73.550108,11566
840711,0,0,0,40,0,40,42.581914,-75.336402,13411
848187,24,56,42,16,0,138,40.746477,-73.621043,11514
751836,0,0,0,4,12,16,40.836142,-73.927902,10452
343157,0,0,0,4,12,16,40.59273,-74.077938,10305
39251,24,24,49,20,0,117,42.079326,-78.434249,14760
801728,0,0,18,0,0,18,42.872499,-73.764126,12065
44702,32,36,112,102,0,282,40.623305,-73.633246,11572
253685,0,0,0,4,12,16,43.072333,-75.222624,13501
847758,0,0,0,161,0,161,40.854319,-73.863657,10462
687440,0,0,0,4,12,16,40.851089,-73.938415,10033
72236,0,0,0,4,12,16,40.665247,-73.929145,11213
165421,0,0,0,4,12,16,40.826971,-73.892694,10459
753936,0,0,0,4,12,16,40.827258,-73.881593,10472
819514,0,0,0,4,12,16,40.832295,-73.881198,10472
757474,0,0,0,4,12,16,40.913091,-73.830562,10550
742773,0,0,0,89,0,89,40.747052,-73.955326,11109
833419,0,0,0,134,0,134,40.624901,-74.142596,10302
30195,0,0,0,2,6,8,42.6628,-78.0701,14550
452569,0,0,131,60,0,191,41.020053,-73.769456,10606
710665,0,0,0,4,12,16,42.921546,-78.828039,14215
43731,16,20,43,0,0,79,43.149413,-76.184047,13090
33453,0,0,0,2,6,8,42.905406,-78.849314,14208
852478,0,0,0,4,12,16,40.758917,-73.961901,10022
257379,0,0,0,4,12,16,40.876449,-73.841299,10469
825344,0,0,0,4,12,16,40.815637,-73.91978,10451
256732,0,0,107,0,0,107,41.377815,-74.452199,10973
616847,0,0,0,2,6,8,40.819334,-73.894583,10459
518821,0,0,0,2,12,14,40.890346,-73.834381,10466
758756,0,0,0,4,12,16,40.663668,-73.925083,11212
670257,0,0,0,4,12,16,40.670192,-73.983486,11215
722381,0,0,0,2,6,8,40.84105,-73.915798,10452
842494,0,0,0,4,12,16,41.127252,-74.115383,10901
252059,0,0,0,4,12,16,41.08582,-73.863687,10591
799261,0,0,0,4,12,16,40.885009,-73.899737,10463
651979,0,0,0,4,12,16,40.667406,-73.941361,11213
873684,0,0,0,4,12,16,40.87184,-73.887211,10458
768106,0,0,0,2,6,8,43.188171,-77.638469,14613
42960,0,17,50,0,0,67,40.805181,-73.706757,11030
241557,0,0,0,4,12,16,40.627764,-73.931542,11234
236999,0,0,0,4,12,16,40.84329,-73.821219,10465
103462,0,0,0,4,12,16,42.047283,-73.94497,12477
748363,0,0,0,4,12,16,40.834875,-73.943315,10032
877679,0,0,0,4,12,16,43.143236,-77.656501,14611
267297,0,0,0,2,12,14,40.670203,-73.986322,11215
272728,32,40,60,30,0,162,43.209386,-77.444382,14580
245141,0,0,0,4,12,16,40.840198,-73.890527,10460
876311,0,0,0,4,12,16,40.647168,-73.885058,11239
7978,0,0,0,2,6,8,41.764991,-73.876593,12601
607538,0,0,0,2,6,8,43.343409,-73.59281,12839
72437,0,0,0,4,12,16,40.69362,-73.818437,11419
634274,0,0,0,267,0,267,40.705631,-73.753041,11412
430483,0,0,0,4,12,16,40.819798,-73.923067,10451
229353,6,22,50,7,0,85,41.29423,-74.169212,10950
866178,0,0,0,4,12,16,40.684696,-73.389805,11726
849430,0,0,0,2,6,8,43.247597,-75.441188,13440
867634,0,0,0,4,12,16,40.715031,-73.58891,11553
847633,0,0,0,2,6,8,43.149283,-77.632036,14611
670573,0,0,0,2,6,8,40.847222,-73.932458,10033
814720,0,0,0,209,0,209,40.755791,-73.855614,11368
294922,0,0,0,4,12,16,40.63071,-74.122437,10310
733472,0,0,0,2,6,8,43.184326,-76.103838,13039
432802,0,0,0,4,12,16,42.639034,-73.770778,12202
870633,0,0,0,146,0,146,40.681053,-73.90671,11207
794746,0,0,0,4,12,16,40.755396,-73.94377,11101
322976,0,0,0,200,0,200,40.870015,-73.898206,10468
444459,0,0,0,4,12,16,40.719139,-73.98712,10002
707154,0,0,112,80,0,192,43.019156,-78.881401,14150
417994,0,0,0,4,12,16,40.636562,-74.165745,10303
859711,0,0,0,4,12,16,40.627968,-73.973911,11230
549446,0,0,0,4,12,16,40.940053,-73.793569,10804
845123,0,0,21,10,0,31,43.164859,-77.580096,14609
849038,0,0,0,2,6,8,42.121297,-75.89763,13901
769193,0,0,0,4,12,16,40.661789,-73.982913,11215
547303,0,0,0,37,0,37,40.589339,-73.959801,11235
785889,0,0,0,4,12,16,40.917839,-73.895975,10705
843120,0,0,0,4,12,16,40.828369,-73.903949,10456
614853,0,0,0,4,12,16,40.885118,-73.862879,10467
662807,0,0,0,4,12,16,40.646279,-73.946331,11203
825127,0,0,0,0,12,12,40.846786,-73.399896,11746
881145,0,0,0,2,12,14,40.873714,-73.863285,10467
575326,0,0,0,4,12,16,40.69933,-73.600172,11553
9771,0,0,0,2,6,8,40.89299,-72.971379,11953
868973,0,0,0,4,12,16,43.21135,-77.558347,14622
876484,16,22,54,41,0,133,40.94727,-73.824506,10707
699465,0,0,0,4,12,16,40.653813,-73.932771,11203
790358,0,0,0,2,6,8,43.225891,-77.466344,14580
449239,0,0,0,69,0,69,40.632004,-73.948517,11210
423304,0,0,0,4,12,16,40.832292,-73.86211,10472
429389,0,0,0,44,0,44,43.081088,-73.767035,12866
25302,0,0,0,4,12,16,40.676247,-73.602068,11510
817684,0,0,0,4,12,16,41.697962,-74.579278,12789
855546,0,0,0,4,12,16,40.832226,-73.940753,10032
40690,0,0,0,100,0,100,42.563681,-73.685455,12033
841727,0,0,0,4,12,16,40.835004,-73.948737,10032
771573,0,0,0,2,6,8,42.792898,-77.519306,14471
410295,0,0,0,4,12,16,40.852681,-73.903796,10453
154645,0,0,0,4,12,16,40.958643,-73.724075,10543
850429,0,0,0,4,12,16,40.844298,-73.911186,10457
395189,0,0,0,4,12,16,40.854606,-73.902973,10453
498365,0,0,0,4,12,16,40.845794,-73.865464,10462
659972,0,0,0,4,12,16,40.854859,-72.961895,11763
853715,0,0,0,4,12,16,44.992696,-73.587925,12958
111833,0,0,0,2,6,8,42.709898,-78.011087,14530
139560,0,0,0,4,12,16,40.854229,-73.905908,10453
868186,0,0,0,4,12,16,43.138482,-76.156404,13212
103890,16,41,60,20,0,137,41.521158,-73.810519,12533
375498,0,0,0,2,6,8,40.813127,-73.907287,10455
881553,0,0,0,4,12,16,40.834909,-73.929442,10452
709780,0,0,0,240,0,240,40.864187,-73.836302,10469
747141,0,0,0,4,12,16,40.657103,-73.915993,11212
725031,0,0,0,2,6,8,42.299413,-73.99926,12413
738336,0,0,0,4,12,16,40.845453,-73.879655,10460
643638,0,0,0,4,12,16,40.856624,-73.898072,10458
841471,0,0,0,60,0,60,40.832291,-73.061132,11742
573188,0,0,0,4,12,16,43.031202,-76.143698,13205
581248,8,20,27,0,0,55,40.8656,-73.029706,11784
216708,0,0,0,44,0,44,42.668406,-73.775017,12206
303106,0,0,0,4,12,16,40.654914,-73.924723,11203
611775,0,0,234,18,0,252,42.995949,-78.829731,14150
71608,0,0,0,4,12,16,40.663115,-73.917674,11212
819675,0,0,0,4,12,16,40.870126,-73.86836,10467
735368,0,0,0,0,12,12,42.808185,-73.94105,12307
784897,0,0,0,4,12,16,40.846482,-73.034713,11784
404338,0,0,72,0,0,72,43.04175,-76.15858,13204
361286,48,84,305,0,0,437,40.846444,-73.309315,11725
368916,0,0,0,0,5,5,40.711922,-73.986388,10002
114791,0,0,0,2,6,8,43.028806,-78.832163,14120
45220,13,12,19,0,0,44,41.004284,-73.86389,10522
71875,0,0,0,4,12,16,40.868773,-73.919994,10034
350383,0,0,0,4,12,16,40.619771,-74.082874,10304
73963,0,0,0,118,0,118,40.821962,-73.877008,10473
803528,0,0,0,253,0,253,40.833587,-73.904271,10456
275686,0,0,0,0,10,10,40.824766,-73.907896,10456
241556,0,0,0,4,12,16,40.794946,-73.936396,10029
384512,0,0,0,12,0,12,40.560953,-74.119767,10306
299022,16,24,42,38,0,120,42.911792,-77.734359,14414
307551,0,0,0,2,6,8,40.821873,-73.951755,10031
358980,0,0,0,4,12,16,40.630483,-73.656173,11572
22925,0,0,0,2,6,8,43.037157,-73.854156,12020
869690,0,0,0,2,6,8,41.088316,-73.858234,10591
270956,0,0,0,4,12,16,40.650522,-73.94293,11203
851330,0,0,0,4,12,16,40.82997,-73.895216,10459
260200,0,0,0,0,10,10,40.858609,-73.928446,10040
683538,0,0,33,0,0,33,43.014487,-78.782075,14228
41381,0,0,0,60,0,60,41.23648,-73.693303,10507
749861,0,0,0,4,12,16,41.060464,-74.018849,10965
23750,0,0,0,2,6,8,43.184976,-77.582024,14621
812074,0,0,0,120,0,120,40.843628,-73.865331,10462
643640,0,0,0,4,12,16,40.849791,-73.897512,10457
35234,0,0,0,2,6,8,42.461133,-74.897818,13750
44337,0,0,18,0,0,18,42.2481,-73.65199,12565
846272,0,0,0,4,12,16,40.874737,-73.880275,10467
829614,0,0,0,4,12,16,40.840487,-73.910022,10457
242838,0,0,0,4,12,16,43.322809,-73.580558,12839
831531,0,0,0,4,12,16,40.839812,-73.913496,10452
709623,0,0,0,291,0,291,40.721107,-73.823138,11367
846413,0,0,0,4,12,16,40.715894,-73.686251,11001
44329,0,0,0,177,0,177,41.012882,-73.762739,10605
764997,0,0,0,2,6,8,40.886461,-73.841643,10466
39477,0,0,100,0,0,100,42.985386,-78.89372,14150
858074,0,0,0,4,12,16,40.598284,-73.945122,11229
518498,0,0,0,4,12,16,41.62447,-74.089549,12589
352941,0,0,0,4,12,16,44.813824,-73.497401,12992
804074,0,0,0,0,12,12,40.852285,-73.886023,10458
878849,0,0,0,4,12,16,40.670065,-73.914951,11212
386260,0,0,0,4,12,16,40.823696,-73.864325,10473
2551,0,0,0,2,6,8,43.149864,-75.982677,13030
787503,0,0,0,123,0,123,40.60744,-74.17091,10311
713714,0,0,0,2,6,8,43.084434,-77.420969,14450
723406,0,0,0,2,6,8,44.718516,-73.718121,12929
876321,0,0,0,139,0,139,40.9714,-73.8069,10583
742493,0,0,0,151,0,151,40.697083,-73.78693,11433
673044,0,0,0,4,12,16,40.678097,-73.978021,11217
43276,0,0,0,30,0,30,42.643427,-76.183255,13077
40322,0,0,0,50,0,50,40.862824,-73.237995,11787
38201,0,0,0,2,6,8,43.072608,-75.329399,13413
811797,0,0,0,2,6,8,40.697293,-73.602289,11550
338932,0,0,0,2,12,14,40.868495,-73.884823,10458
841567,0,0,0,113,0,113,40.849314,-73.123026,11755
869650,0,0,0,4,12,16,40.693425,-73.610574,11550
628632,0,0,0,4,12,16,40.857229,-73.905508,10453
882729,0,0,0,4,12,16,42.105832,-75.916231,13905
795226,0,0,0,4,12,16,40.868897,-73.902139,10468
796473,0,0,0,4,12,16,40.6853,-73.593,11575
648434,16,64,256,0,0,336,40.71305,-73.310687,11795
843261,0,0,0,243,0,243,40.829412,-73.938619,10039
40920,8,24,34,0,0,66,40.873567,-73.533135,11771
816711,0,0,0,4,12,16,40.673668,-73.600303,11575
844386,0,0,0,4,12,16,40.865376,-73.891289,10458
777354,0,0,0,0,12,12,40.672309,-73.876663,11208
308830,0,0,0,4,12,16,40.686134,-73.967178,11238
613771,0,0,0,4,12,16,40.664345,-73.913095,11212
790230,0,0,0,2,12,14,40.863206,-73.89273,10458
874611,0,0,0,4,12,16,40.728131,-73.345471,11704
447277,0,0,0,2,12,14,40.731972,-73.824038,11367
735929,0,0,0,2,6,8,42.739006,-76.12323,13159
739754,0,0,0,2,6,8,43.192491,-77.605244,14621
592649,0,0,0,4,12,16,40.671951,-73.91452,11233
874616,0,0,0,35,0,35,40.576009,-73.971242,11224
801487,0,0,28,0,0,28,42.089844,-79.290457,14701
285182,0,0,0,4,12,16,40.65216,-73.940873,11203
407399,0,0,0,4,12,16,40.867853,-73.918653,10034
826913,0,0,0,4,12,16,40.640436,-73.953679,11226
39830,0,0,0,270,0,270,40.7848,-73.67993,11030
124240,0,0,0,2,12,14,40.720827,-73.946684,11222
862371,0,0,0,4,12,16,40.842792,-73.906539,10457
551837,0,0,0,4,12,16,40.648406,-73.973878,11218
854413,0,0,0,4,12,16,40.828581,-73.079917,11779
872615,0,0,0,2,12,14,40.820709,-73.941263,10030
862553,0,0,0,4,12,16,40.693841,-73.765135,11412
41792,0,0,0,40,0,40,43.296257,-73.620389,12803
747959,0,0,0,4,12,16,40.680769,-73.934772,11233
111360,0,0,0,4,12,16,40.630038,-74.130345,10302
875564,0,0,0,4,12,16,40.781919,-72.866392,11967
327535,0,0,0,4,12,16,40.660438,-73.877809,11208
756671,0,0,0,4,12,16,40.868232,-73.892298,10458
845764,0,0,0,4,12,16,40.605219,-73.987379,11214
866818,0,0,0,60,0,60,40.876793,-73.884529,10458
847531,0,0,0,4,12,16,40.854083,-73.914708,10453
765767,0,0,0,0,12,12,40.811394,-73.857268,10473
827941,0,0,0,2,6,8,43.102235,-75.248291,13502
268101,0,0,0,2,12,14,40.675204,-73.878373,11208
213142,0,0,0,4,12,16,40.691057,-73.835231,11419
712916,0,0,0,2,6,8,43.632715,-76.090272,13145
476938,0,0,0,4,12,16,40.829029,-73.866822,10472
828529,0,0,0,4,12,16,40.83654,-73.890021,10460
347820,0,0,0,4,12,16,41.2879,-73.793664,10598
44922,0,0,0,224,0,224,42.090366,-76.802279,14901
776443,0,0,0,2,6,8,40.698706,-73.950814,11206
747529,0,0,0,4,12,16,40.703963,-73.944231,11206
632915,0,0,0,4,12,16,40.627648,-74.122053,10310
44755,16,36,72,10,0,134,41.470675,-74.027087,12553
680534,0,0,0,2,6,8,41.694603,-73.911573,12603
836802,0,0,0,4,12,16,40.871415,-73.905291,10463
716499,0,0,0,4,12,16,40.848404,-73.101509,11779
802844,0,0,0,4,12,16,42.100366,-76.038363,13760
400238,0,0,0,4,12,16,41.620286,-73.87684,12590
822129,0,0,0,4,12,16,41.09488,-73.969062,10994
39621,12,9,18,0,0,39,43.205234,-77.696686,14626
764251,0,8,129,0,0,137,42.944356,-76.566442,13021
361994,0,0,0,2,12,14,40.827108,-73.875231,10472
806380,0,0,0,4,12,16,42.567668,-77.588755,14572
593760,0,0,0,4,12,16,40.652988,-73.910669,11236
741593,0,0,0,80,0,80,43.09754,-75.220161,13501
837009,0,0,0,4,12,16,40.66403,-73.988221,11215
663927,0,0,0,4,12,16,40.694853,-73.916406,11221
879173,32,36,82,60,0,210,43.232038,-78.90858,14131
200298,0,0,0,2,12,14,40.660074,-73.575062,11520
185585,0,0,0,2,6,8,40.865429,-73.889611,10458
680312,0,0,0,4,12,16,40.867192,-73.917842,10034
761006,0,0,0,4,12,16,40.67957,-73.719802,11580
790991,0,0,0,4,12,16,40.840359,-73.854788,10462
520675,0,0,0,4,12,16,40.592649,-73.933862,11235
17983,0,0,0,4,12,16,41.11907,-74.00829,10954
359812,0,0,0,2,6,8,41.061356,-74.021375,10965
650276,0,0,0,4,12,16,40.671181,-73.937822,11213
139022,0,0,36,0,0,36,42.156696,-75.13594,13856
813152,0,0,0,4,12,16,40.85159,-73.930432,10033
881527,0,0,0,2,6,8,42.863395,-76.997599,14456
160359,0,0,0,115,0,115,43.0345,-76.020674,13066
709748,0,0,0,105,0,105,40.665515,-73.925767,11212
536937,0,0,85,20,0,105,43.067044,-75.285587,13413
543338,0,0,0,2,6,8,42.896058,-76.842212,13165
556879,0,0,0,4,12,16,42.946857,-78.811744,14215
639531,0,0,0,2,6,8,43.167841,-77.572867,14609
357224,0,0,0,4,12,16,40.690408,-73.819283,11419
50638,0,0,0,0,6,6,40.842609,-73.914971,10452
851520,0,0,0,4,12,16,40.643621,-73.887973,11236
117180,0,0,0,4,12,16,43.190375,-77.595822,14621
109035,16,22,83,13,0,134,43.128378,-77.360401,14502
276089,0,0,0,88,0,88,40.636006,-73.953247,11210
791639,0,0,27,0,0,27,42.565732,-76.249158,13045
878477,0,0,0,2,6,8,42.333747,-74.808433,13739
874166,0,0,0,2,6,8,40.820099,-73.888452,10474
424388,0,0,0,160,0,160,40.684975,-73.730071,11411
769549,0,0,0,4,12,16,40.872887,-73.876575,10467
668536,0,0,0,2,6,8,42.769777,-73.78495,12110
35644,0,0,0,2,6,8,43.149247,-77.643587,14611
754626,0,0,0,2,6,8,43.346109,-73.677804,12804
832543,0,0,0,2,6,8,40.644646,-73.996669,11232
336811,0,0,0,0,12,12,40.887374,-73.85342,10466
653997,16,22,42,24,0,104,42.855909,-78.742213,14224
873528,16,24,31,10,0,81,43.092212,-73.743073,12866
362345,0,0,0,2,6,8,43.12594,-75.673544,13054
871609,0,0,0,4,12,16,40.869264,-73.905134,10468
43637,0,0,0,100,0,100,40.760025,-73.32663,11729
591025,0,0,0,4,12,16,42.976217,-74.161364,12086
536822,0,0,0,0,12,12,40.696663,-73.847033,11418
39695,8,20,44,30,0,102,43.15137,-77.576524,14607
40272,0,20,32,0,0,52,42.141583,-77.053595,14830
399333,0,0,0,2,12,14,40.680957,-73.648001,11552
785477,0,0,0,4,12,16,40.762813,-73.921538,11106
782407,0,0,32,60,0,92,42.164507,-78.966681,14772
691326,0,0,0,137,0,137,40.832732,-73.866995,10472
802692,0,0,0,2,6,8,40.847342,-73.933536,10033
773173,0,0,0,4,12,16,40.711309,-73.995813,10002
872907,0,0,0,4,12,16,40.861366,-73.928939,10040
731319,0,0,0,4,12,16,43.166523,-77.569008,14609
870952,0,0,0,4,12,16,41.035973,-73.735529,10577
74155,0,0,0,220,0,220,40.74091,-73.918687,11377
196753,0,0,0,2,6,8,41.250868,-74.356235,10990
72830,0,0,0,180,0,180,40.858497,-73.887815,10458
515167,0,0,0,0,12,12,40.882537,-73.90374,10463
831810,0,0,0,4,12,16,40.860054,-73.865426,10467
243023,0,0,0,44,0,44,42.962996,-78.680167,14221
674129,0,0,0,4,12,16,40.639329,-73.982333,11218
742768,0,0,0,120,0,120,40.840654,-73.904257,10457
220949,0,0,0,4,12,16,40.714286,-73.698236,11001
820953,0,0,0,4,12,16,40.650525,-73.736641,11422
410322,8,24,21,0,0,53,41.389401,-73.545106,10509
42630,24,39,21,0,0,84,43.052188,-76.260953,13031
227795,8,24,29,24,0,85,41.327646,-73.860392,10547
231157,0,0,0,4,12,16,40.757664,-73.808901,11355
823443,0,0,21,0,0,21,43.4407,-73.2962,12849
364459,0,0,0,0,6,6,40.807085,-73.915662,10454
258528,0,0,79,0,0,79,42.798018,-73.964231,12306
873311,0,0,0,4,12,16,40.683421,-73.582782,11575
41536,0,0,120,0,0,120,43.079439,-75.210624,13501
813552,8,8,14,16,0,46,43.199314,-77.59999,14617
481946,0,0,0,2,6,8,44.693037,-73.558797,12962
775815,0,0,0,4,12,16,40.868211,-73.91824,10034
869801,0,0,0,59,0,59,41.281925,-73.567924,10590
795809,0,0,0,4,12,16,40.866556,-73.889953,10458
510751,0,0,0,4,12,16,40.668026,-73.735568,11422
345418,0,0,0,4,12,16,40.816503,-73.899966,10455
317934,0,0,0,4,12,16,40.594583,-73.775461,11691
339140,0,0,0,190,0,190,40.753248,-73.900297,11377
850869,0,0,0,4,12,16,40.825006,-73.895955,10459
842154,0,0,0,2,6,8,42.056178,-73.959951,12477
479325,0,0,0,4,12,16,40.599191,-73.75667,11691
839714,0,0,0,4,12,16,40.89623,-73.839427,10466
878617,0,0,0,4,12,16,40.850192,-73.919853,10453
310819,0,0,0,99,0,99,40.677915,-73.915729,11233
306787,0,0,0,2,6,8,41.369806,-73.729322,10541
870112,0,0,0,80,0,80,40.685936,-73.945302,11216
281427,0,0,0,4,12,16,40.690016,-73.908319,11207
472266,0,0,0,0,10,10,40.812156,-73.9212,10454
148055,0,0,0,4,12,16,40.831592,-72.895573,11967
714893,8,12,167,19,0,206,40.640931,-73.698942,11557
37469,0,0,0,4,12,16,42.637351,-77.598596,14560
799592,0,0,0,165,0,165,43.063769,-74.342804,12078
652723,0,0,0,30,0,30,40.906462,-73.839774,10550
709805,0,0,0,200,0,200,40.675123,-73.915349,11233
43985,0,0,0,115,0,115,40.870014,-73.629864,11542
602544,0,0,0,60,0,60,41.44064,-73.604631,10509
841123,0,0,0,4,12,16,41.098078,-74.123971,10901
666332,0,0,0,250,0,250,40.736166,-73.75333,11364
397140,0,0,0,4,12,16,40.771293,-73.904155,11105
759545,0,0,0,4,12,16,40.657662,-73.905882,11212
836776,0,0,0,4,12,16,40.845108,-73.938234,10033
73372,0,0,0,80,0,80,40.587651,-73.985682,11214
858866,0,0,0,2,6,8,42.826081,-78.691993,14059
45080,0,12,21,0,0,33,40.626921,-73.716796,11598
866650,0,0,0,4,12,16,40.730281,-73.486408,11714
106579,0,0,0,4,12,16,41.355998,-74.279718,10918
44606,0,0,18,80,0,98,42.79632,-76.110221,13159
578531,0,0,0,0,12,12,42.922945,-76.577912,13021
274529,0,0,0,4,12,16,42.626357,-75.173891,13810
364956,0,0,0,4,12,16,40.943814,-73.890888,10703
656437,0,0,0,4,12,16,40.812977,-73.914174,10455
863353,0,0,0,0,10,10,40.832698,-73.92809,10452
529831,0,0,0,4,12,16,40.695599,-73.618188,11550
817895,0,0,0,10,0,10,40.634161,-73.947459,11210
866810,0,0,36,0,0,36,42.33039,-75.977245,13862
824147,0,0,0,4,12,16,40.640974,-73.907109,11236
822804,0,0,0,2,6,8,42.829437,-75.438191,13355
767212,0,12,127,144,0,283,41.143079,-73.990038,10956
855693,0,0,0,4,12,16,43.302577,-73.581152,12839
52845,0,0,0,2,6,8,40.830942,-73.936236,10039
40568,0,24,169,0,0,193,41.013589,-73.738055,10605
356766,16,18,29,17,0,80,43.001404,-77.505936,14506
493888,0,0,0,4,12,16,40.702483,-73.787004,11433
709853,0,0,0,119,0,119,40.604927,-73.994549,11214
696228,0,0,0,4,12,16,40.866998,-73.856921,10469
541029,0,0,0,4,12,16,40.853976,-73.915266,10453
729748,0,0,0,4,12,16,40.846164,-73.935827,10033
44644,7,10,17,0,0,34,41.007721,-73.914071,10964
523806,0,0,0,126,0,126,43.010768,-78.761515,14221
880724,0,0,0,4,12,16,43.1303,-75.215343,13502
876860,8,24,18,13,0,63,40.676406,-73.588553,11575
401446,0,0,0,4,12,16,40.870339,-73.844702,10469
858659,0,0,0,2,6,8,43.03476,-76.168444,13204
352720,0,22,105,0,0,127,42.772193,-78.768585,14127
824348,0,0,0,4,12,16,40.701486,-73.920975,11237
203569,0,0,0,44,0,44,42.203604,-76.553707,14889
878984,0,0,0,139,0,139,40.749611,-73.764787,11364
40060,0,12,65,14,0,91,41.527936,-74.06919,12550
42391,0,24,32,0,0,56,42.867776,-77.241881,14424
5532,0,0,0,2,6,8,42.696332,-76.150262,13077
752789,0,0,0,68,0,68,40.698253,-73.940509,11206
239691,0,0,0,4,12,16,40.676353,-73.810453,11420
835792,0,0,0,4,12,16,40.674966,-73.664976,11565
797022,0,0,0,4,12,16,43.187547,-77.59562,14621
789079,0,0,0,0,12,12,40.805261,-73.914521,10454
149592,0,0,0,2,10,12,42.946968,-78.787758,14215
877332,0,0,0,16,0,16,40.669745,-73.939229,11213
70208,0,0,0,2,6,8,40.618706,-74.082574,10304
558414,0,0,0,4,12,16,40.674537,-73.997997,11231
56108,0,0,0,2,6,8,40.839921,-73.883853,10460
805145,0,0,0,4,12,16,40.820871,-73.927092,10451
180114,0,0,0,120,0,120,43.124302,-78.807379,14094
535817,0,0,51,0,0,51,40.95454,-73.796503,10804
675819,0,0,0,4,12,16,40.949299,-73.832409,10707
875322,0,0,0,2,6,8,43.219427,-77.609561,14617
845271,0,0,0,118,0,118,40.592513,-73.978713,11223
543812,0,0,0,4,12,16,42.902961,-76.85316,13165
132707,0,0,0,4,12,16,40.662105,-73.572866,11520
816997,4,8,12,18,0,42,42.060273,-76.16526,13732
814197,0,0,0,4,12,16,43.062214,-76.136184,13203
698356,24,24,56,0,0,104,41.027142,-73.758474,10605
690643,0,0,0,4,12,16,40.689972,-73.719786,11003
633293,0,0,0,4,12,16,40.965321,-73.70959,10528
839125,0,0,220,0,0,220,40.728041,-73.301972,11795
695372,0,0,0,4,12,16,40.698994,-73.742827,11411
350722,0,0,0,4,12,16,40.925828,-73.83474,10552
655068,0,0,0,2,6,8,40.736729,-73.848093,11375
798859,14,18,54,0,0,86,41.429825,-74.424485,10940
871375,0,0,0,200,0,200,40.880096,-73.826673,10475
329137,0,0,0,4,12,16,40.776185,-73.529959,11801
797800,0,0,0,0,6,6,40.818332,-73.896446,10459
868424,0,0,0,4,12,16,40.70417,-73.827289,11415
222119,0,0,0,4,12,16,43.962675,-75.903716,13601
672662,0,0,0,4,12,16,40.901574,-73.829947,10550
760977,0,0,0,2,6,8,43.196314,-77.653579,14615
41061,0,0,0,100,0,100,40.827835,-73.278263,11725
872925,23,32,75,0,0,130,40.965787,-73.780145,10804
736972,0,0,0,4,12,16,40.694153,-73.789864,11433
825719,0,0,0,4,12,16,40.948652,-73.889646,10703
72869,0,0,0,95,0,95,40.877507,-73.900545,10463
481995,0,0,0,4,12,16,40.640176,-74.081038,10301
109387,0,0,0,2,6,8,41.760575,-75.030139,12745
781813,0,0,0,2,6,8,42.636494,-73.782924,12209
275340,0,0,0,4,12,16,40.705296,-73.758252,11412
628159,0,0,0,4,12,16,40.734554,-73.851449,11375
667030,0,0,0,4,12,16,40.634927,-74.148846,10303
703136,0,0,0,4,12,16,40.741259,-73.562145,11590
826424,0,0,0,4,12,16,40.62097,-74.031567,11209
844428,0,0,0,4,12,16,41.854106,-73.874703,12580
390702,0,0,0,4,12,16,40.754274,-73.823693,11355
736348,0,0,0,0,10,10,40.829864,-73.89759,10459
128216,0,0,0,2,6,8,43.089165,-73.502196,12834
693925,0,0,0,4,12,16,40.677213,-73.893498,11207
788437,0,0,0,4,12,16,40.610691,-73.95751,11229
120091,0,0,0,2,6,8,42.331642,-77.65601,14843
755218,0,0,0,4,12,16,40.848237,-73.914401,10453
347375,0,0,0,4,12,16,40.64746,-73.903648,11236
44885,0,10,33,20,0,63,41.332612,-74.120251,10917
880304,0,0,0,4,12,16,40.854265,-73.899059,10457
731185,0,0,0,2,12,14,40.698297,-73.944805,11206
606056,0,0,0,4,12,16,40.855158,-73.929844,10040
856605,0,0,0,4,12,16,40.839223,-73.689873,11050
505765,0,0,0,4,12,16,40.87425,-73.835822,10469
730540,0,0,0,112,0,112,40.67479,-73.808003,11420
689611,0,0,0,100,0,100,40.799956,-73.947284,10026
252648,0,0,0,4,12,16,40.81665,-73.813315,10465
709524,0,0,0,114,0,114,40.713595,-73.986308,10002
842437,0,0,0,0,12,12,40.865326,-73.895335,10468
857233,0,0,0,4,12,16,40.858611,-73.896126,10458
228662,0,0,0,4,12,16,40.827436,-73.941256,10031
379472,0,0,30,0,0,30,41.77008,-73.909364,12538
158181,0,0,0,2,6,8,40.793974,-73.937106,10029
318268,0,0,0,4,12,16,40.647899,-73.724357,11581
646827,0,0,0,74,0,74,40.580684,-73.965153,11235
40817,0,0,0,70,0,70,42.189333,-76.814475,14845
601379,0,0,0,4,12,16,41.701917,-74.013914,12528
881370,0,0,0,0,10,10,42.664547,-73.7537,12210
873949,0,0,0,4,12,16,40.594685,-73.942588,11229
362442,0,0,0,4,12,16,41.922269,-73.993245,12401
612261,0,0,0,4,12,16,40.661734,-73.950057,11225
545765,0,0,0,2,6,8,43.086646,-75.347805,13323
44055,24,32,79,0,0,135,41.045938,-74.005418,10965
275965,0,0,0,4,12,16,40.814717,-73.908162,10455
212831,0,0,30,0,0,30,42.744092,-75.179105,13315
399373,0,0,0,2,12,14,40.665497,-73.957233,11225
265295,0,0,0,4,12,16,40.667711,-73.791301,11436
72823,0,0,0,180,0,180,40.855792,-73.896085,10457
848501,0,0,0,4,12,16,41.527796,-74.210976,12549
762476,32,60,129,110,0,331,42.6736,-73.7828,12206
877029,0,0,0,2,6,8,43.979366,-75.917353,13601
40600,0,12,73,0,0,85,41.127489,-73.690961,10504
113888,0,0,0,4,12,16,40.843267,-73.894892,10457
720401,0,0,0,4,12,16,40.84598,-73.919904,10452
867018,0,0,0,4,12,16,40.755017,-73.596946,11590
856488,0,0,0,4,12,16,40.691724,-73.622875,11550
329896,16,12,38,20,0,86,43.17695,-77.550333,14609
43143,0,0,0,60,0,60,40.730466,-73.504715,11756
792476,24,34,37,16,0,111,42.121201,-75.980349,13790
832046,0,0,0,2,6,8,40.711456,-73.957762,11211
762454,0,0,0,4,12,16,40.852962,-73.902755,10457
742635,0,0,0,4,12,16,41.123913,-74.020645,10956
701791,0,0,0,4,12,16,40.835069,-73.927308,10452
666501,0,0,0,4,12,16,40.724779,-73.801734,11366
793219,0,0,0,4,12,16,40.849419,-73.905561,10457
849130,0,0,0,2,6,8,44.925267,-73.738594,12959
102964,0,0,116,0,0,116,40.778557,-72.865333,11967
206070,0,0,0,4,12,16,42.050709,-76.339064,13812
563024,8,16,0,0,0,24,40.960271,-73.731806,10543
826291,0,0,0,4,12,16,40.982555,-73.779725,10583
661278,0,0,0,4,12,16,43.183223,-77.616049,14621
40457,8,12,34,0,0,54,41.855415,-74.130493,12484
879775,0,0,0,168,0,168,40.643479,-73.89623,11236
456816,0,0,0,83,0,83,40.834084,-73.876128,10472
845268,0,0,0,4,12,16,40.866307,-73.888578,10458
687951,0,0,0,4,12,16,40.915186,-73.825928,10553
730833,0,0,0,4,12,16,40.673837,-73.984016,11215
665653,0,0,0,2,12,14,40.833223,-73.912902,10456
454882,0,0,0,4,12,16,40.819016,-73.865989,10473
881254,0,0,0,4,12,16,40.710657,-73.957018,11211
736764,0,0,0,4,12,16,40.686259,-73.794511,11436
868613,0,0,0,4,12,16,43.01326,-76.141083,13205
509635,0,0,0,2,6,8,43.232556,-77.510211,14580
837857,0,0,0,4,12,16,40.852501,-73.895529,10457
724005,0,0,0,4,12,16,40.8199,-73.816705,10465
700186,0,0,0,4,12,16,40.671835,-73.98513,11215
227440,0,0,0,173,0,173,40.63544,-73.910885,11236
410702,0,0,0,4,12,16,42.763091,-73.59427,12180
639665,0,0,0,2,6,8,43.154447,-76.11294,13039
310179,0,0,0,0,5,5,40.828136,-73.872106,10472
599560,0,0,0,4,12,16,40.836797,-73.918267,10452
547390,0,0,0,44,0,44,42.689081,-73.56792,12140
875797,0,0,0,0,12,12,40.85441,-73.916174,10453
853136,0,0,0,4,12,16,40.599189,-73.756131,11691
711608,0,0,0,4,12,16,40.800777,-73.956244,10026
870212,0,0,0,4,12,16,40.637557,-74.167219,10303
821954,0,0,0,4,12,16,40.873822,-73.848959,10469
44649,0,0,0,40,0,40,42.66263,-73.750488,12207
882250,0,0,0,40,0,40,42.537738,-75.526443,13815
439500,0,0,0,4,12,16,40.858494,-73.897071,10458
681811,0,0,0,126,0,126,40.592749,-74.158632,10314
822219,0,0,0,40,0,40,40.815806,-73.31,11746
677759,31,24,94,25,0,174,41.096188,-73.986627,10994
45079,0,0,165,0,0,165,40.895125,-73.804938,10803
846196,0,0,0,4,12,16,40.780257,-73.842262,11356
868942,0,0,0,155,0,155,42.891081,-78.864256,14204
264149,0,0,0,4,12,16,43.440252,-73.307905,12849
756682,0,0,31,17,0,48,40.688965,-73.623546,11550
55302,0,0,0,2,6,8,40.846897,-73.895324,10457
818852,0,0,0,4,12,16,40.74731,-73.787528,11365
186355,0,0,0,4,12,16,40.6552,-73.923769,11203
443178,0,0,0,0,6,6,40.714771,-73.976955,10009
744766,0,0,0,37,0,37,40.708227,-73.960671,11211
474345,0,0,0,4,12,16,40.88011,-73.876115,10467
585568,0,0,0,4,12,16,40.666511,-73.888575,11207
203799,0,0,0,2,12,14,40.669913,-73.983992,11215
742771,0,0,0,220,0,220,40.823383,-73.9078,10456
821340,0,0,0,0,10,10,40.707602,-73.960395,11211
40382,0,0,53,0,0,53,40.763225,-72.962952,11772
135622,8,26,14,0,0,48,42.980579,-77.415578,14564
252880,0,0,0,144,0,144,40.881245,-73.905357,10463
162528,0,0,0,2,6,8,40.69823,-73.6692,11010
72279,0,0,0,4,12,16,40.894316,-73.853274,10466
138163,32,30,58,10,0,130,42.08984,-76.039133,13850
733562,0,0,0,4,12,16,40.677355,-73.615592,11510
43388,8,36,63,0,0,107,42.489611,-76.486578,14850
819340,0,0,0,2,6,8,43.161321,-77.55344,14609
396625,0,0,0,4,12,16,43.183843,-77.595242,14621
840675,0,0,0,4,12,16,40.667807,-73.763039,11413
512621,0,0,0,4,12,16,40.690286,-73.595923,11553
72485,0,0,0,4,12,16,40.638144,-73.914655,11236
769197,0,0,0,177,0,177,41.137032,-73.78416,10570
655521,0,0,0,4,12,16,40.737399,-73.860798,11368
657084,0,0,0,4,12,16,40.863299,-73.929787,10040
229790,0,0,18,0,0,18,42.875395,-73.769541,12065
42012,0,0,0,50,0,50,42.918812,-76.803132,13148
842539,0,0,0,2,6,8,40.670395,-73.390585,11726
781843,8,9,14,15,0,46,43.187493,-77.575367,14609
579157,0,0,0,2,12,14,40.821337,-73.901763,10459
107802,0,0,0,4,12,16,43.136403,-77.652976,14619
1689,0,0,0,2,6,8,43.092814,-77.687249,14623
794168,0,0,0,2,6,8,42.157204,-77.086832,14870
717354,0,0,0,0,10,10,40.859718,-73.895041,10458
618853,0,0,0,44,0,44,43.071646,-75.601044,13461
875099,0,0,0,4,12,16,42.422082,-76.222757,13784
818671,0,0,0,4,12,16,40.706855,-73.421441,11701
400181,0,0,0,2,6,8,40.891805,-73.844378,10466
388639,0,0,0,4,12,16,40.731045,-73.825844,11367
500947,0,0,0,4,12,16,43.178291,-77.604285,14621
291079,0,0,0,4,12,16,40.84114,-73.925758,10452
732856,0,0,0,4,12,16,40.767965,-73.740768,11363
445653,0,0,0,4,12,16,41.005178,-73.681607,10573
71551,0,0,0,2,12,14,40.822038,-73.948292,10031
774623,0,0,0,2,6,8,44.006814,-75.987579,13615
314506,0,0,70,0,0,70,41.208476,-73.884725,10520
72472,0,0,0,4,12,16,40.664736,-73.891275,11207
728381,0,0,16,194,0,210,40.749117,-73.888515,11372
830946,0,0,0,4,12,16,41.563011,-73.849006,12533
840239,0,0,0,2,6,8,44.192889,-75.968221,13656
869198,0,0,0,4,12,16,41.10351,-74.107469,10901
41008,0,0,0,40,0,40,43.302228,-73.656003,12801
432270,0,0,0,2,6,8,44.754886,-75.172866,13660
857432,0,0,0,50,0,50,42.093534,-76.079049,13760
860862,0,0,0,4,12,16,40.651118,-74.009402,11232
10704,0,0,0,2,10,12,42.979813,-77.350638,14425
841496,0,0,0,0,11,11,40.875774,-73.907436,10463
409238,0,0,155,0,0,155,40.969356,-73.881412,10701
405697,0,0,0,10,0,10,40.71424,-74.014235,10282
73476,0,0,0,61,0,61,40.720559,-73.990614,10002
824259,0,0,0,0,12,12,40.853415,-73.916617,10453
22654,0,0,0,4,12,16,43.219037,-77.642026,14616
43716,0,0,36,0,0,36,42.695639,-78.992193,14047
42845,0,22,69,0,0,91,43.002951,-78.146017,14020
44042,8,12,48,28,0,96,42.814624,-73.936274,12305
803039,0,0,18,0,0,18,43.251904,-73.654316,12828
223221,0,0,0,4,12,16,40.826205,-73.900723,10456
848977,0,0,0,2,6,8,43.267327,-73.719027,12831
458332,7,18,18,10,0,53,41.400254,-74.079058,10930
875256,0,0,0,4,12,16,40.810327,-73.954546,10027
546359,0,0,0,4,12,16,40.838333,-73.114957,11755
647852,0,0,0,112,0,112,40.952955,-73.847146,10710
744373,0,0,0,13,0,13,40.528663,-74.201959,10309
465323,0,0,0,2,12,14,40.614093,-74.068942,10305
74242,0,0,0,140,0,140,40.814104,-73.942564,10030
875246,8,22,14,0,0,44,42.973845,-77.86363,14423
830547,0,0,0,56,0,56,40.78461,-73.845912,11356
881173,0,0,0,80,0,80,40.809383,-73.917947,10454
607559,0,0,0,108,0,108,42.097785,-79.313025,14750
810394,0,0,0,4,12,16,42.104605,-75.962084,13790
788444,0,0,0,4,12,16,40.852495,-73.893618,10457
798968,0,0,0,4,12,16,40.856171,-73.933826,10040
112543,0,0,0,2,12,14,40.812352,-73.917056,10454
267977,0,0,0,4,12,16,40.665647,-73.910245,11212
866596,0,0,0,4,12,16,40.67091,-73.567704,11566
823212,0,0,0,460,0,460,40.760401,-73.818013,11355
847805,0,0,0,4,12,16,40.800322,-73.948167,10026
395490,0,0,0,2,12,14,40.829171,-73.896803,10459
275809,0,0,0,44,0,44,40.52995,-74.187684,10312
849219,0,0,0,4,12,16,40.677067,-73.80486,11420
254419,0,0,0,160,0,160,40.685085,-73.98263,11217
771371,0,0,0,4,12,16,40.918243,-73.85091,10704
845933,0,0,0,106,0,106,40.786943,-73.076441,11741
565250,0,0,0,40,0,40,40.743039,-73.649429,11501
262136,0,0,0,2,6,8,43.188378,-77.560031,14609
244117,0,0,0,4,12,16,40.658071,-73.893666,11207
43067,0,0,40,0,0,40,40.893813,-73.014158,11727
244430,0,23,39,0,0,62,40.790204,-73.504093,11791
867007,0,0,21,0,0,21,42.384613,-79.453063,14716
720230,32,48,50,13,0,143,41.00866,-73.695427,10577
375738,0,0,0,2,12,14,40.694771,-73.923695,11221
831150,0,0,0,2,6,8,43.192498,-77.642032,14615
735183,0,0,21,0,0,21,42.693483,-73.634384,12198
412725,0,0,0,120,0,120,40.676462,-73.977442,11215
104154,16,24,70,40,0,150,42.10624,-76.228517,13827
144745,0,0,0,60,0,60,40.929564,-73.846684,10708
878415,0,0,0,4,12,16,40.961807,-73.728192,10543
408446,0,0,0,4,12,16,40.703278,-73.909409,11385
422938,0,0,0,2,5,7,40.707118,-73.827442,11415
261277,0,12,160,16,0,188,41.02515,-73.745093,10605
792764,0,0,0,2,6,8,41.37056,-73.747386,10541
719538,0,0,0,0,12,12,40.838491,-73.914969,10452
709634,0,0,0,120,0,120,40.749291,-73.821547,11354
709683,0,0,0,280,0,280,40.824999,-73.873766,10472
768258,0,0,0,4,12,16,40.896385,-73.847072,10466
853625,0,0,0,4,12,16,40.850658,-73.863704,10462
610321,0,0,0,4,12,16,43.090152,-75.230734,13501
878616,0,0,0,2,6,8,40.849379,-73.898743,10457
853474,0,0,0,2,6,8,42.63989,-73.792991,12209
377996,0,0,0,10,0,10,40.673417,-73.882616,11208
582017,0,0,0,0,5,5,43.021657,-76.436181,13060
676249,0,0,20,0,0,20,44.82539,-74.521021,12916
787715,0,0,42,14,0,56,42.721719,-78.914902,14085
271801,0,0,0,2,6,8,43.299153,-76.48758,13074
755435,8,35,68,0,0,111,43.168273,-77.608163,14605
743308,0,0,0,4,12,16,43.021318,-74.690203,13452
39498,24,84,90,0,0,198,42.905111,-78.871518,14209
828768,0,0,0,2,6,8,40.808534,-73.913077,10454
40223,0,0,0,44,0,44,42.83316,-73.975385,12302
850127,0,0,0,4,12,16,40.691792,-73.619414,11550
819537,0,0,0,4,12,16,42.718527,-73.761137,12211
62256,0,0,0,2,6,8,40.663311,-73.884267,11207
770142,0,0,0,4,12,16,40.661426,-73.990209,11215
486731,0,0,0,298,0,298,40.848254,-73.693402,11050
296772,16,12,16,24,0,68,42.860081,-78.754342,14224
834562,0,0,0,4,12,16,40.880674,-73.848084,10469
525711,0,12,47,0,0,59,41.501683,-74.009209,12550
40352,0,0,0,81,0,81,40.791946,-73.529012,11753
659979,0,0,0,208,0,208,42.56999,-77.702644,14437
668742,0,0,0,4,12,16,40.879064,-73.862571,10467
257744,0,0,0,2,6,8,40.641831,-74.010338,11220
125397,8,12,18,0,0,38,40.825566,-73.683513,11050
709732,0,0,0,260,0,260,40.828504,-73.917559,10456
680394,0,0,0,89,0,89,40.752792,-73.093806,11782
250047,0,0,0,4,12,16,40.818337,-73.953362,10031
822559,0,0,0,43,0,43,40.812484,-73.95342,10027
652875,0,0,0,0,12,12,40.7577,-73.875459,11369
44995,0,0,21,0,0,21,41.931476,-73.91271,12572
278432,0,0,0,72,0,72,40.682541,-73.955329,11216
372189,0,0,0,141,0,141,40.863063,-73.846946,10469
738468,0,0,0,0,12,12,40.862344,-73.907711,10468
882103,0,0,0,4,12,16,40.635807,-73.996709,11219
529496,0,0,0,4,12,16,40.836053,-73.863031,10462
871607,0,0,0,2,6,8,42.425613,-75.612889,13830
831652,0,0,0,0,12,12,40.827863,-73.875049,10472
481275,8,12,7,0,0,27,42.998973,-78.738618,14221
40454,0,0,15,0,0,15,42.076773,-73.948543,12477
332369,0,0,0,4,12,16,40.661216,-73.887402,11207
874478,0,0,0,0,10,10,43.167217,-77.576117,14609
793224,16,36,41,0,0,93,42.927976,-78.837364,14214
597560,0,0,0,4,12,16,40.680801,-73.849628,11417
253604,0,0,0,2,12,14,40.853408,-73.929102,10040
311480,16,24,42,0,0,82,43.00097,-76.195643,13215
882579,0,0,0,4,12,16,42.464098,-78.927773,14070
19670,0,0,0,2,6,8,43.137825,-76.132786,13212
649105,0,0,0,4,12,16,40.60089,-73.765528,11691
882845,0,0,0,4,12,16,40.867772,-73.851516,10469
682327,8,10,26,0,0,44,40.9156,-73.14544,11790
39807,0,36,148,0,0,184,40.794781,-73.655042,11576
833970,0,0,30,0,0,30,41.601725,-74.298051,12566
803626,0,0,0,4,12,16,40.732044,-73.958469,11222
751698,0,0,0,4,12,16,40.668787,-73.835269,11417
266531,0,0,0,221,0,221,40.714515,-73.983172,10002
7002,0,0,0,0,7,7,40.697868,-73.612814,11550
864426,0,0,0,4,12,16,42.405849,-74.614062,12167
183778,0,0,0,352,0,352,40.869654,-73.879094,10467
749460,0,0,0,4,12,16,40.837035,-73.90582,10456
443640,0,0,0,4,12,16,40.797925,-73.948268,10029
400597,0,0,0,2,10,12,40.713342,-73.698166,11001
627317,0,0,0,150,0,150,40.834274,-73.887249,10460
42194,8,24,34,0,0,66,42.894235,-75.645248,13408
738189,0,0,0,4,12,16,40.842755,-73.893001,10457
230040,0,0,0,4,12,16,40.789333,-73.234393,11717
411435,0,0,0,4,12,16,40.590495,-73.789652,11692
762070,0,0,0,145,0,145,42.952417,-78.824879,14214
861112,0,0,0,4,12,16,40.843471,-73.939376,10032
876800,16,35,45,0,0,96,43.303138,-73.66087,12801
870417,16,36,58,28,0,138,40.708656,-73.502003,11793
462027,0,0,0,4,12,16,40.597642,-73.795816,11692
772979,0,12,93,86,0,191,42.669823,-77.055626,14527
316041,0,0,0,2,6,8,42.53231,-75.531085,13815
396851,0,0,0,120,0,120,40.704951,-73.965775,11211
861304,0,0,0,4,12,16,40.661755,-73.98463,11215
709767,0,0,0,127,0,127,40.662216,-73.937,11203
824765,0,0,0,0,10,10,40.834545,-73.913087,10456
709801,0,0,0,105,0,105,40.84489,-73.858149,10462
854059,24,40,67,0,0,131,43.343489,-73.65429,12804
869532,0,0,0,39,0,39,40.754131,-73.9768,10166
829643,0,0,0,0,6,6,40.793927,-73.94983,10029
808919,0,0,0,200,0,200,40.683985,-73.847499,11416
621637,0,0,0,4,12,16,40.814042,-73.909665,10455
430878,0,0,0,4,12,16,40.817534,-73.819974,10465
721769,0,0,0,2,12,14,40.834381,-73.925408,10452
484094,0,0,0,4,12,16,40.661669,-73.87808,11208
664084,0,0,0,4,12,16,40.70356,-73.89436,11385
787646,0,0,0,4,12,16,40.826532,-73.888989,10459
349952,0,0,0,59,0,59,40.899924,-73.791062,10805
41959,0,0,0,80,0,80,42.65383,-73.792136,12208
839505,0,0,0,0,12,12,40.846713,-73.909483,10453
657750,0,0,0,4,12,16,40.728285,-73.860426,11374
428201,0,0,0,225,0,225,40.869882,-73.629815,11545
300659,0,0,0,2,12,14,41.507792,-73.97146,12508
806156,0,0,0,141,0,141,40.840654,-73.904257,10457
672980,0,0,0,2,6,8,43.168713,-77.5866,14605
841914,0,0,0,2,6,8,40.712584,-73.962298,11211
689510,0,0,0,4,12,16,40.832187,-73.900514,10456
874677,0,0,0,2,6,8,43.136992,-76.133108,13212
882796,0,0,0,4,12,16,41.116051,-74.048853,10977
875468,0,0,0,4,12,16,40.766145,-73.565112,11590
44774,0,0,120,0,0,120,41.19264,-73.962081,10927
407314,0,0,0,2,6,8,40.673648,-73.817758,11420
780880,0,0,0,180,0,180,40.97301,-73.870879,10703
42944,0,0,0,50,0,50,42.136912,-75.895601,13901
733098,16,24,79,0,0,119,41.150717,-73.944342,10920
835573,14,12,33,0,0,59,40.929242,-73.763734,10538
722919,0,0,0,4,12,16,40.657612,-73.974934,11218
701062,0,0,0,0,12,12,40.853336,-73.916201,10453
73845,0,0,0,47,0,47,40.602452,-74.162775,10314
862281,0,0,0,4,12,16,40.881212,-73.903824,10463
255411,0,0,0,4,12,16,43.182308,-77.637324,14613
621024,0,0,0,4,12,16,40.834962,-73.857791,10462
797109,0,0,0,2,6,8,40.846481,-73.922701,10453
801704,0,0,0,2,6,8,43.100036,-79.034551,14301
256173,0,0,0,2,6,8,44.69625,-75.4857,13669
847577,0,0,0,2,12,14,43.070001,-76.104354,13206
663177,0,0,0,0,5,5,40.846083,-73.915286,10452
850526,0,0,0,4,12,16,40.660951,-73.596408,11520
280657,0,0,0,366,0,366,40.590671,-73.974905,11223
133778,0,24,32,0,0,56,41.723481,-73.906331,12601
784011,0,0,0,4,12,16,42.553006,-74.8385,12155
723195,0,0,0,4,12,16,40.854644,-73.898895,10457
214411,0,0,0,4,12,16,40.757123,-73.859288,11368
867266,16,36,100,96,0,248,41.158042,-73.865775,10562
802094,0,0,27,0,0,27,42.422189,-73.685041,12184
458899,0,0,0,4,12,16,43.22388,-75.459367,13440
299988,0,0,0,4,12,16,40.921046,-73.833468,10552
695519,0,0,0,4,12,16,40.853331,-73.883024,10458
862127,0,0,0,4,12,16,40.665505,-73.585532,11520
837606,0,0,0,4,12,16,40.873154,-73.899859,10468
709656,0,0,0,120,0,120,40.818766,-73.905816,10456
41806,8,20,19,19,0,66,41.515873,-73.959367,12508
246066,0,0,0,4,12,16,40.688802,-73.735539,11411
731887,0,0,0,4,12,16,40.679116,-73.834388,11417
71393,0,0,0,4,12,16,40.722555,-73.815567,11367
741987,0,0,0,457,0,457,40.73584,-73.980412,10003
848508,0,0,0,2,6,8,42.808684,-74.216403,12053
663226,0,0,0,2,6,8,40.787682,-73.972537,10024
713368,0,0,0,4,12,16,40.846766,-73.867667,10462
712805,0,0,0,2,12,14,40.820882,-73.862684,10473
316183,0,0,0,4,12,16,40.736317,-73.266952,11706
260402,0,0,0,4,12,16,40.659022,-73.735517,11422
29395,0,0,0,4,12,16,40.629974,-73.637519,11572
827396,0,0,0,149,0,149,40.631613,-74.156755,10303
39630,16,22,29,12,0,79,43.135493,-77.441289,14526
881852,0,0,0,2,6,8,40.69213,-73.980397,11201
327747,0,0,0,2,12,14,40.716809,-73.985242,10002
320318,0,0,0,4,12,16,42.704857,-78.449357,14145
814650,0,0,0,4,12,16,40.839451,-73.926419,10452
631691,0,0,0,4,12,16,40.659451,-73.912181,11212
376147,0,0,0,2,12,14,40.879333,-73.873196,10467
447244,0,0,0,2,12,14,41.51019,-74.009025,12550
855304,0,0,0,132,0,132,40.599979,-73.743994,11691
808453,0,0,0,4,12,16,40.955218,-73.870734,10701
747308,0,0,0,4,12,16,40.642192,-73.906126,11236
414815,0,0,0,2,6,8,40.851758,-73.908156,10453
413638,0,0,0,123,0,123,40.860044,-73.929415,10040
811565,0,0,0,35,0,35,41.085332,-73.862117,10591
117969,0,0,0,4,12,16,40.729946,-73.852453,11375
340205,0,0,0,2,6,8,40.792232,-73.936765,10029
704577,0,0,0,4,12,16,40.664585,-73.889967,11207
277106,0,0,0,2,12,14,40.6754,-73.910673,11233
459924,0,0,107,0,0,107,41.513008,-74.024703,12550
881813,0,0,0,4,12,16,40.63632,-73.940117,11210
344333,0,0,0,4,12,16,40.832388,-73.12042,11779
625102,0,0,0,4,12,16,40.727802,-73.881699,11379
863892,0,0,0,83,0,83,40.801685,-73.955244,10026
819592,0,0,0,4,12,16,40.645654,-73.953912,11226
848099,0,0,0,4,12,16,41.123062,-74.029918,10977
583733,0,0,0,4,12,16,40.709645,-73.744074,11429
716253,0,0,0,2,6,8,43.137101,-77.646653,14619
637411,0,0,0,2,6,8,40.769844,-73.925573,11102
822913,0,0,0,71,0,71,40.687022,-73.384746,11757
323173,0,0,19,0,0,19,43.134484,-73.850032,12833
863618,0,6,53,0,0,59,41.461605,-74.341703,10941
832571,0,0,0,4,12,16,40.867857,-73.920072,10034
842313,0,0,0,4,12,16,40.756403,-73.925625,11106
862636,0,0,65,0,0,65,41.483604,-74.075665,12553
217343,0,0,0,4,12,16,42.321546,-75.35731,13849
40516,0,10,61,0,0,71,41.040766,-73.714152,10577
233364,0,0,0,4,12,16,40.882709,-73.866036,10467
130586,0,0,0,4,12,16,40.826407,-72.861136,11950
431806,0,0,0,4,12,16,40.76637,-73.993477,10019
807349,0,0,0,102,0,102,40.802479,-73.954441,10026
324436,0,0,0,4,12,16,40.953635,-73.742957,10543
50605,0,0,0,2,6,8,40.847117,-73.921654,10453
812068,0,0,0,116,0,116,40.834971,-73.846518,10462
74092,0,0,0,47,0,47,40.756788,-73.977305,10017
759464,0,0,0,4,12,16,40.879921,-73.906266,10463
39536,0,0,0,170,0,170,42.905111,-78.871518,14209
711217,0,0,0,2,6,8,43.123461,-75.664729,13054
802828,0,0,0,107,0,107,40.708712,-73.798173,11432
704341,0,0,0,4,12,16,42.641234,-73.78428,12209
797804,0,0,0,4,12,16,40.605116,-73.953894,11229
871911,0,0,0,4,12,16,41.434253,-74.108675,12577
466057,0,0,0,17,0,17,40.839153,-73.901039,10457
203288,0,0,0,4,12,16,40.752381,-73.9026,11377
43631,4,8,24,29,0,65,41.605543,-73.832019,12590
355726,0,0,0,4,12,16,42.402041,-74.000001,12083
748495,0,0,0,0,12,12,43.069341,-76.118977,13206
816974,0,0,0,4,12,16,41.152033,-74.000679,10956
219796,0,0,0,2,12,14,40.607737,-73.990973,11214
673200,0,0,0,4,12,16,40.674526,-73.753626,11413
709747,0,0,0,240,0,240,40.885356,-73.877802,10467
844021,0,0,0,4,12,16,40.8957,-73.851245,10466
489154,0,18,59,21,0,98,40.802582,-72.788005,11934
454141,0,0,0,4,12,16,40.727429,-73.792659,11366
809160,0,0,0,4,12,16,42.952292,-77.059627,14532
339142,0,0,0,86,0,86,40.578451,-73.979779,11224
316288,30,72,215,0,0,317,40.780439,-73.493467,11803
470317,0,0,0,4,12,16,40.636179,-73.889311,11236
153517,0,0,0,4,12,16,42.931462,-78.824509,14215
629137,0,0,0,110,0,110,40.81138,-73.924608,10454
872322,0,0,0,2,12,14,40.831785,-73.926338,10452
709903,0,0,0,80,0,80,40.814836,-73.952035,10027
807318,0,0,0,4,12,16,40.646291,-73.949889,11226
675110,0,9,24,0,0,33,41.782054,-74.714866,12754
340574,0,0,0,0,10,10,40.755985,-73.829867,11355
613500,0,0,0,171,0,171,40.832694,-73.926603,10452
540087,0,0,0,2,6,8,40.86146,-73.903315,10468
71950,0,0,0,4,12,16,40.643185,-73.890874,11236
709787,0,0,0,229,0,229,40.68683,-73.910449,11207
699168,0,0,0,0,10,10,40.684357,-73.797898,11436
148071,0,0,0,4,12,16,42.914242,-76.554235,13021
273791,0,0,0,4,12,16,40.820579,-73.87982,10473
767497,0,0,0,4,12,16,41.010394,-73.676273,10573
14433,0,0,0,2,6,8,42.515604,-78.678903,14141
451697,0,0,0,4,12,16,43.172199,-77.341195,14502
503302,0,0,0,4,12,16,42.80985,-73.99387,12306
827206,0,0,0,119,0,119,40.67423,-73.913252,11233
250681,0,0,0,4,12,16,40.697914,-73.913492,11237
271246,0,0,0,2,12,14,40.671945,-73.777686,11434
851496,16,24,71,20,0,131,41.449305,-74.357824,10941
864336,0,0,0,4,12,16,40.820042,-73.955444,10031
44257,0,0,0,44,0,44,42.645436,-73.756276,12202
866921,0,0,0,2,6,8,43.239543,-77.649889,14616
865761,0,0,0,2,6,8,40.717812,-73.614029,11550
841180,0,0,0,2,6,8,43.098974,-79.044666,14301
858330,24,44,94,19,0,181,40.82446,-73.111983,11779
875844,0,0,0,4,12,16,43.177745,-77.614431,14621
603419,0,0,0,4,12,16,40.68784,-73.817621,11419
477308,16,24,30,0,0,70,40.847283,-73.37741,11746
817891,0,0,0,4,12,16,40.680253,-73.748118,11413
729632,0,0,0,38,0,38,40.868047,-73.882639,10458
137559,24,30,60,33,0,147,40.793905,-73.057745,11741
831745,0,0,0,4,12,16,40.687245,-73.396604,11726
854384,0,0,0,4,12,16,40.758431,-73.864555,11369
831800,0,0,0,72,0,72,42.811586,-77.805232,14454
37769,0,0,0,2,6,8,41.989247,-73.881039,12571
718152,16,17,46,11,0,90,41.561164,-73.595047,12564
40133,0,19,32,20,0,71,42.588212,-73.700964,12061
754239,24,24,37,0,0,85,40.900414,-72.400975,11968
671956,0,0,0,0,12,12,40.822448,-73.91182,10451
744779,0,0,0,60,0,60,40.794252,-73.948601,10029
42526,8,12,36,0,0,56,40.845564,-73.268134,11725
101477,0,0,0,260,0,260,40.705847,-73.902826,11385
40030,32,36,108,35,0,211,43.002855,-75.979581,13104
838571,0,0,0,4,12,16,40.719854,-73.742879,11428
820619,0,0,0,0,10,10,40.763597,-73.535612,11801
257067,0,0,0,4,12,16,40.756537,-72.865185,11967
813536,0,0,0,4,12,16,40.824983,-73.854022,10473
856331,0,0,0,148,0,148,40.828707,-73.90045,10456
644097,0,0,0,4,12,16,40.679358,-73.532951,11710
844829,0,0,0,4,12,16,40.740283,-73.805935,11365
834947,0,0,0,60,0,60,40.881427,-73.896704,10463
242061,0,0,0,1,6,7,40.83409,-73.918596,10452
877495,0,0,0,95,0,95,40.836082,-73.928784,10452
73105,0,0,0,75,0,75,40.70025,-73.928095,11221
12728,0,0,0,2,12,14,41.301356,-73.785806,10598
830810,0,0,0,4,12,16,43.087765,-77.52785,14534
134908,0,0,0,4,12,16,40.652541,-73.599349,11520
39762,0,0,0,90,0,90,43.090669,-77.4652,14450
25640,0,0,0,2,5,7,42.084249,-76.82674,14905
475911,0,0,0,2,12,14,43.139079,-77.625465,14608
855555,0,0,0,2,6,8,43.015456,-76.148503,13205
761939,14,10,15,0,0,39,41.002235,-73.674727,10573
255639,20,20,39,10,0,89,43.136364,-77.542008,14610
401497,0,12,44,19,0,75,41.577136,-73.909459,12590
251921,0,0,0,2,6,8,40.852592,-73.907397,10453
835919,0,0,0,120,0,120,40.821165,-73.952011,10031
589881,0,0,0,4,12,16,40.623822,-74.165808,10303
40687,0,0,0,38,0,38,42.5137,-73.6123,12123
880728,0,0,0,4,12,16,40.812157,-73.953316,10027
115279,0,0,15,55,0,70,42.034147,-78.331101,14770
824185,0,0,0,70,0,70,40.727493,-73.675042,11530
822827,0,0,0,80,0,80,40.597476,-73.948293,11229
709755,0,0,0,110,0,110,40.854554,-73.913138,10453
641744,0,0,0,4,12,16,40.852549,-73.917253,10453
696515,0,0,0,4,12,16,42.655449,-75.478345,13460
280929,0,0,0,208,0,208,40.742617,-73.862754,11368
262962,0,0,26,44,0,70,42.997986,-78.181136,14020
615519,0,0,0,4,12,16,40.837496,-73.944327,10032
728794,0,0,53,0,0,53,42.927019,-78.894608,14213
603878,0,0,0,4,12,16,40.736398,-73.89972,11377
44140,0,0,36,0,0,36,41.111485,-74.052405,10977
646526,0,0,0,4,12,16,43.145909,-77.656622,14611
568810,0,0,0,0,12,12,40.815606,-73.819614,10465
503196,0,0,0,4,12,16,40.658796,-73.950992,11225
744113,0,0,0,4,12,16,40.941037,-73.794775,10804
866198,0,0,0,4,12,16,40.684886,-73.561057,11566
151370,0,10,30,0,0,40,43.987529,-75.939799,13601
431395,0,18,77,0,0,95,40.723566,-73.245572,11706
51328,0,0,0,2,6,8,40.88006,-73.886156,10468
842754,0,0,72,82,0,154,40.681384,-73.697529,11580
117442,0,0,0,4,12,16,40.70888,-73.596137,11553
129992,0,0,0,80,0,80,40.789979,-73.944596,10029
872894,0,0,0,4,12,16,40.878813,-73.907349,10463
705792,0,0,0,4,12,16,40.645478,-74.015759,11220
460719,0,0,0,60,0,60,40.689813,-73.95078,11216
734612,16,44,61,0,0,121,42.776073,-78.745226,14127
778666,0,0,0,4,12,16,40.869152,-73.902893,10463
335131,0,0,0,4,12,16,42.806566,-73.940832,12307
876545,0,0,0,4,12,16,40.870046,-73.890606,10458
823472,0,0,0,218,0,218,40.870435,-73.877647,10467
635629,0,0,0,4,12,16,40.69994,-73.621419,11550
322897,0,0,0,4,12,16,40.959802,-73.735814,10543
757840,0,0,0,4,12,16,41.389731,-74.180016,10950
864714,0,0,0,4,12,16,40.710766,-73.784508,11432
193144,0,0,0,4,12,16,42.940975,-78.812157,14215
42837,0,0,0,40,0,40,41.308072,-74.175797,10950
119188,0,0,0,4,12,16,40.64843,-73.973818,11218
670605,0,0,0,4,12,16,40.611489,-73.977814,11204
651300,0,0,0,30,0,30,40.81314,-73.900055,10455
40751,0,0,0,62,0,62,42.161358,-77.068445,14830
741687,24,36,48,0,0,108,40.973665,-73.741588,10528
837159,0,0,0,0,12,12,40.823525,-73.905917,10456
42331,15,10,15,0,0,40,43.075898,-77.529637,14534
595919,0,0,0,4,12,16,42.487756,-79.323079,14048
742932,0,5,41,0,0,46,41.144307,-73.825183,10510
367302,0,0,0,4,12,16,40.860386,-73.926937,10040
513507,0,0,103,0,0,103,41.366696,-73.760169,10541
842136,0,0,0,4,12,16,40.634985,-73.604515,11510
283477,0,0,0,2,6,8,40.767644,-73.172665,11752
39947,16,20,30,15,0,81,43.082921,-75.268261,13501
586166,0,0,0,0,6,6,40.848168,-73.933518,10033
774516,0,0,0,4,12,16,40.665955,-73.894561,11207
847209,0,0,0,4,12,16,40.833735,-73.89184,10460
791773,0,0,0,4,12,16,40.652253,-73.97623,11218
807925,0,0,0,4,12,16,40.877553,-73.885657,10468
338018,0,0,0,0,10,10,40.824735,-73.879427,10472
171492,0,0,0,24,0,24,41.53761,-73.901183,12524
40295,8,24,99,0,0,131,40.832322,-72.92587,11980
879234,0,0,0,4,12,16,40.958358,-73.875275,10703
865601,8,16,15,0,0,39,42.732657,-73.702853,12189
846089,0,0,0,4,12,16,40.607367,-73.756527,11691
727002,0,0,0,66,0,66,40.705499,-73.331068,11702
703742,0,0,45,0,0,45,42.9014,-73.792,12065
202249,0,0,0,0,12,12,40.875427,-73.906598,10463
39796,0,51,117,0,0,168,40.668954,-73.576578,11520
807701,0,0,0,4,12,16,41.508814,-74.03189,12550
74138,0,0,0,33,0,33,40.666067,-73.953783,11225
71218,0,0,0,4,12,16,40.894881,-73.841776,10466
174797,0,0,0,61,0,61,40.833468,-73.623791,11545
448729,0,0,0,141,0,141,40.667003,-73.92329,11212
754353,16,42,74,24,0,156,41.42594,-74.428224,10940
631472,0,0,0,4,12,16,40.849636,-73.88399,10460
573595,0,0,0,4,12,16,40.639422,-74.088965,10301
473169,0,0,0,2,6,8,40.815962,-73.937661,10037
72583,0,0,0,4,12,16,40.627821,-74.121648,10310
801998,0,0,0,0,12,12,40.850094,-73.886922,10457
531458,0,0,0,4,12,16,42.91278,-75.14673,13491
478928,0,0,0,2,6,8,42.976882,-77.071469,14532
232415,0,24,120,0,0,144,40.974721,-73.676182,10580
197218,0,0,0,2,6,8,42.103818,-75.92854,13905
374091,0,0,0,4,12,16,40.826197,-73.907045,10456
725603,0,0,0,4,12,16,40.759063,-73.724694,11362
403565,0,0,0,2,12,14,40.840707,-73.926282,10452
41121,0,0,0,44,0,44,42.720225,-73.824652,12205
709675,0,0,0,71,0,71,40.82295,-73.923265,10451
847060,0,0,0,4,12,16,40.892498,-73.86112,10466
709777,0,0,0,102,0,102,40.663873,-73.959292,11225
110709,0,0,0,0,12,12,40.851947,-73.907978,10453
44570,0,0,0,25,0,25,40.945618,-73.886636,10703
42261,0,0,0,23,0,23,42.895546,-75.64512,13408
174213,0,0,0,20,0,20,42.262319,-77.611404,14823
345720,0,0,0,0,12,12,40.885416,-73.853431,10466
26637,0,0,0,2,6,8,43.183862,-77.59413,14621
43968,0,0,0,113,0,113,44.270622,-73.99326,12946
459618,0,0,0,4,12,16,40.833456,-73.91281,10456
761322,0,0,0,2,6,8,42.666343,-73.757821,12206
785541,0,0,0,160,0,160,40.845674,-73.886531,10460
353470,0,0,0,2,6,8,44.857575,-75.184594,13694
628344,0,0,0,40,0,40,40.792501,-73.971769,10025
709847,0,0,0,203,0,203,40.636303,-73.933393,11203
556820,0,0,0,0,10,10,40.870176,-73.902745,10468
856737,0,0,0,2,6,8,40.822091,-73.892743,10459
874486,0,11,64,20,0,95,41.482547,-74.064516,12553
245083,0,0,0,120,0,120,40.573914,-74.109079,10306
693595,0,0,0,4,12,16,43.043865,-73.827687,12866
265859,0,0,0,2,12,14,40.862672,-73.924747,10034
859756,0,0,0,200,0,200,40.663873,-73.959292,11225
71819,0,0,0,2,12,14,40.61282,-73.971794,11230
221334,0,0,0,4,12,16,40.762676,-73.237852,11717
15556,0,0,0,4,12,16,42.094673,-78.496785,14706
396346,0,23,67,10,0,100,41.266736,-73.542867,10590
779988,0,0,0,2,6,8,43.02415,-76.157058,13207
777134,0,0,0,4,12,16,40.878462,-73.842298,10469
170466,0,0,0,50,0,50,40.993927,-73.815127,10583
44374,0,0,0,79,0,79,40.821366,-73.494772,11791
706196,0,0,0,2,6,8,41.653826,-73.870076,12603
877666,0,0,21,21,0,42,42.812072,-78.701771,14224
869992,0,0,0,4,12,16,40.857262,-73.904813,10453
867430,0,0,0,4,12,16,40.834989,-73.915025,10456
308988,0,0,0,0,8,8,40.880402,-73.853292,10469
384696,0,0,0,4,12,16,40.662526,-73.915398,11212
157721,0,0,0,4,12,16,40.724018,-73.938684,11222
305329,0,0,0,100,0,100,42.664638,-73.79187,12208
43072,24,34,39,20,0,117,42.864316,-73.78681,12065
64934,0,0,0,2,5,7,40.796188,-73.938581,10029
192013,0,0,0,240,0,240,40.622751,-74.144874,10302
773454,0,0,0,4,12,16,40.683833,-73.617364,11550
830252,0,0,0,40,0,40,40.681144,-73.943791,11216
532274,0,0,0,4,12,16,40.918215,-73.793299,10801
707616,0,0,18,0,0,18,42.907159,-73.692009,12118
401719,0,0,0,4,12,16,40.657534,-73.913305,11212
201136,0,0,0,4,12,16,40.877604,-73.840536,10469
698255,0,0,0,4,12,16,40.82544,-73.881468,10472
815690,0,0,0,4,12,16,41.719827,-74.406108,12428
867780,0,0,0,4,12,16,40.871655,-73.899344,10468
73343,0,0,0,30,0,30,40.640606,-73.964453,11226
683254,0,0,0,226,0,226,40.874506,-73.868019,10467
45127,14,24,11,0,0,49,44.979126,-74.693324,13655
765099,0,0,0,4,12,16,40.889165,-73.856131,10466
838040,0,0,0,0,12,12,40.842681,-73.913565,10452
38095,0,0,0,4,12,16,40.913397,-73.842075,10550
270351,0,0,0,4,12,16,40.7511,-73.866655,11368
41803,8,0,0,0,0,8,42.140476,-77.050817,14830
813070,0,0,0,114,0,114,40.683747,-73.980453,11217
176687,0,0,0,44,0,44,42.878699,-78.652311,14086
71886,0,0,0,4,12,16,40.637324,-73.975494,11218
235025,0,0,0,180,0,180,40.857221,-73.634976,11542
583347,0,0,0,4,12,16,40.694912,-73.912307,11221
742496,0,0,0,111,0,111,40.626921,-73.989567,11204
799767,0,0,0,4,12,16,40.846232,-73.924006,10453
623501,0,0,0,0,12,12,40.837623,-73.913411,10456
848209,0,0,0,0,12,12,42.171425,-74.016254,12463
561066,8,19,24,10,0,61,42.975476,-78.00156,14482
569308,0,0,0,2,12,14,40.864476,-73.848893,10469
123973,0,0,0,4,12,16,40.82677,-73.925507,10451
770525,0,0,0,2,6,8,43.501985,-76.322226,13126
826876,0,0,0,4,12,16,42.339561,-75.761758,13778
150642,0,0,0,0,6,6,40.708609,-73.951351,11211
796374,0,0,0,52,0,52,40.748918,-73.776844,11364
237196,0,0,0,0,5,5,40.71148,-73.998687,10038
793650,0,0,0,0,12,12,40.840969,-73.911202,10457
736113,0,24,34,0,0,58,42.020101,-73.857351,12571
850951,0,0,0,4,12,16,40.847231,-73.9221,10453
877963,0,0,0,4,12,16,40.625574,-74.030388,11209
247312,0,0,0,367,0,367,40.731179,-73.871249,11373
106023,0,0,0,4,12,16,41.577989,-73.789264,12533
524153,0,0,0,0,12,12,40.848382,-73.890919,10457
882987,0,0,0,4,12,16,40.855517,-73.868559,10462
875728,0,0,0,4,12,16,40.686508,-73.92934,11221
417454,0,0,0,4,12,16,41.191901,-73.968259,10927
248773,0,0,0,108,0,108,40.74467,-73.766992,11364
772881,0,0,0,4,12,16,43.169908,-77.642809,14606
114395,0,0,0,2,6,8,42.720001,-73.690503,12180
789518,0,0,0,55,0,55,43.088276,-79.029998,14303
391114,0,0,0,2,6,8,40.682917,-73.730032,11422
41173,0,0,185,61,0,246,40.634173,-73.714624,11598
540618,0,0,0,4,12,16,40.655841,-73.919296,11212
258859,0,0,8,36,0,44,42.095268,-78.495071,14706
43824,7,7,9,15,0,38,41.022792,-73.724541,10604
857796,0,0,0,4,12,16,40.63808,-73.972587,11218
702561,0,0,0,60,0,60,40.943029,-73.023651,11766
348866,0,0,0,2,12,14,41.020333,-73.766268,10605
470618,8,11,14,10,0,43,42.727181,-78.837331,14075
881026,0,0,0,4,12,16,40.596394,-73.784505,11692
462723,0,0,0,4,12,16,40.68217,-73.921771,11233
876089,0,0,0,2,6,8,40.637252,-73.598658,11510
786149,0,0,0,2,12,14,40.830668,-73.896834,10459
268966,0,0,0,4,12,16,40.716323,-73.624179,11550
877189,0,0,0,4,12,16,40.871242,-73.904685,10463
695907,8,12,36,50,0,106,43.050689,-75.381743,13323
697105,0,0,0,2,12,14,40.836368,-73.866928,10460
831443,0,0,0,80,0,80,40.669733,-73.905137,11212
140474,0,0,0,4,12,16,40.641924,-73.958715,11226
450391,0,0,0,4,12,16,40.820464,-73.859822,10473
769688,0,0,0,4,12,16,40.699613,-73.625736,11550
359477,0,0,0,4,12,16,40.67951,-73.795828,11436
341236,0,0,0,2,6,8,43.13231,-77.645146,14619
854911,0,0,0,2,6,8,43.094901,-75.211131,13501
715118,0,0,66,0,0,66,43.098609,-76.198252,13088
748296,0,0,0,2,6,8,43.174539,-77.592784,14605
549173,0,0,0,44,0,44,43.096868,-73.497508,12834
737719,8,20,35,0,0,63,42.743193,-73.75951,12110
325495,0,0,0,4,12,16,40.720578,-73.801985,11432
834812,0,0,0,2,6,8,40.722232,-73.340243,11704
45043,0,0,21,50,0,71,43.044313,-74.851689,13365
230707,0,0,0,4,12,16,40.827492,-73.938723,10039
73515,0,0,0,472,0,472,40.861008,-73.930129,10040
523374,0,0,0,4,12,16,41.391225,-73.925051,10524
74075,0,0,0,111,0,111,40.637738,-73.947974,11210
870839,0,0,0,4,12,16,40.853776,-73.8659,10462
752382,0,0,0,4,12,16,40.824655,-73.876206,10472
557416,0,0,0,4,12,16,40.873416,-73.883974,10458
709918,0,0,0,181,0,181,40.849267,-73.9314,10033
601505,0,0,0,4,12,16,40.818757,-73.889474,10474
764275,0,0,0,4,12,16,40.950689,-73.813593,10709
783753,0,0,0,4,12,16,44.895463,-74.294256,12953
215129,0,0,0,4,12,16,40.678094,-73.823441,11420
833195,0,0,0,2,12,14,40.829817,-73.920656,10451
51708,0,0,0,2,6,8,40.866521,-73.918557,10034
354045,0,0,0,240,0,240,40.880447,-73.875532,10467
397311,0,0,0,4,12,16,40.856613,-73.894419,10458
782900,0,0,0,4,12,16,40.886729,-73.834089,10466
372061,0,0,0,4,12,16,40.678061,-73.716673,11580
709544,0,0,0,209,0,209,40.761455,-73.988372,10036
40334,0,0,0,72,0,72,40.913556,-73.327421,11765
843708,0,0,0,4,12,16,40.646798,-73.588881,11520
343696,0,0,0,4,12,16,40.680691,-73.893789,11207
44851,0,0,0,40,0,40,41.318925,-74.129429,10917
40806,16,18,21,15,0,70,43.008032,-78.944879,14072
243186,0,0,0,4,12,16,40.649873,-73.598925,11520
499579,0,0,0,4,12,16,40.703929,-73.92874,11237
847680,0,0,0,2,6,8,42.075626,-79.303663,14750
776670,0,0,0,136,0,136,40.686413,-73.940982,11221
42754,0,12,65,0,0,77,41.084969,-73.918582,10960
868976,0,0,0,2,6,8,44.621784,-75.546053,13669
467617,0,0,0,4,12,16,40.697772,-73.949304,11206
41565,0,0,0,83,0,83,42.868635,-73.808407,12065
265034,0,0,0,2,6,8,40.796937,-73.940168,10029
880087,0,0,0,4,12,16,40.665797,-73.576584,11520
861824,0,0,0,4,12,16,40.690869,-73.79514,11433
366438,0,0,0,2,6,8,43.037499,-75.864703,13037
64496,0,0,0,2,6,8,40.799966,-73.966307,10025
230827,0,0,64,15,0,79,41.454306,-73.552767,10509
875113,0,0,0,146,0,146,40.751645,-73.81783,11355
833629,0,0,0,0,10,10,40.65999,-73.9509,11225
104500,0,0,0,100,0,100,40.756978,-73.295156,11706
703396,0,0,0,4,12,16,40.891464,-73.853992,10466
658976,0,0,0,4,12,16,40.872299,-73.885121,10458
874277,0,0,0,4,12,16,40.621255,-74.085842,10304
774132,0,0,0,4,12,16,40.648598,-73.715868,11581
703312,0,0,0,40,0,40,41.697322,-73.894226,12603
665773,0,0,0,4,12,16,40.827291,-73.87124,10472
810158,0,0,0,4,12,16,40.758898,-73.348696,11729
42762,0,0,0,40,0,40,41.258909,-73.947806,10511
647184,0,0,0,4,12,16,40.807855,-73.954949,10027
39869,0,55,44,0,0,99,40.797527,-73.737037,11023
878636,0,0,0,50,0,50,43.451924,-76.525065,13126
880275,0,0,0,4,12,16,43.082219,-75.229348,13501
166605,0,0,0,4,12,16,43.009819,-75.952926,13104
184793,0,0,0,50,0,50,40.661181,-73.947065,11225
168307,0,0,0,2,12,14,40.77427,-73.930657,11102
611118,0,0,0,4,12,16,40.684251,-73.852461,11416
760748,0,0,0,4,12,16,40.684588,-73.994657,11201
698848,0,0,0,180,0,180,40.716354,-74.01252,10007
878095,0,0,0,4,12,16,40.69672,-73.892692,11385
187428,0,0,0,2,6,8,40.645782,-74.014175,11220
207322,0,0,0,2,6,8,42.981234,-76.590033,13021
34340,0,0,0,2,6,8,43.165941,-77.570989,14609
482980,0,16,0,0,0,16,42.5887,-76.1798,13045
702700,0,0,0,2,6,8,40.667684,-73.930532,11213
747023,0,0,0,0,7,7,40.830428,-73.913874,10456
72130,0,0,0,4,12,16,40.672513,-73.935753,11213
53806,0,0,0,2,6,8,40.834525,-73.925594,10452
42287,8,24,54,0,0,86,40.786609,-73.263165,11717
877295,0,0,0,4,12,16,40.827661,-73.850348,10472
818388,0,0,0,260,0,260,40.775556,-73.904737,11102
667589,0,0,0,2,6,8,44.25687,-74.492793,12986
155357,0,0,0,2,5,7,42.082805,-76.807905,14904
41073,0,0,0,279,0,279,40.631182,-73.60609,11510
815816,0,0,0,2,12,14,43.008807,-76.145388,13205
328419,7,9,19,22,0,57,43.220654,-78.390342,14103
100394,0,0,0,4,12,16,40.628473,-73.920356,11234
789556,8,20,46,0,0,74,40.91698,-73.072935,11776
846562,0,0,0,4,12,16,40.818309,-73.13368,11779
358757,0,0,16,0,0,16,42.092351,-79.215949,14701
253947,0,0,0,2,6,8,40.651325,-74.008238,11232
351914,0,0,0,100,0,100,41.9549,-75.2793,13783
688240,0,0,0,2,6,8,40.786247,-73.94232,10029
858560,0,0,0,4,12,16,40.635509,-73.912291,11236
800624,0,0,0,4,12,16,40.637963,-74.135869,10302
74001,0,0,0,222,0,222,40.838123,-73.853405,10462
253850,0,0,0,4,12,16,40.879824,-73.876261,10467
551320,0,0,0,4,12,16,40.92577,-73.775036,10801
876943,0,12,21,0,0,33,40.836471,-73.414613,11746
836683,0,0,0,2,12,14,40.836891,-73.888875,10460
874920,0,0,0,4,12,16,40.664699,-73.940278,11213
679014,0,0,0,2,6,8,40.703826,-73.765561,11412
188638,0,0,0,2,6,8,40.715118,-73.607566,11550
455495,0,0,0,4,12,16,40.841788,-73.938111,10032
840788,0,0,0,2,6,8,44.506213,-75.275112,13630
180842,0,0,0,140,0,140,40.709095,-73.803887,11432
764799,0,0,0,4,12,16,40.814816,-73.828086,10465
362057,0,0,0,4,12,16,40.700244,-73.685912,11003
731742,0,0,0,4,12,16,43.044449,-74.867329,13365
694511,0,0,0,2,6,8,42.534308,-77.05595,14837
128606,8,24,50,0,0,82,43.016378,-78.475887,14001
804638,0,0,0,4,12,16,40.671828,-73.733056,11422
461151,0,0,0,4,12,16,40.660123,-73.891505,11207
881256,0,0,0,4,12,16,40.849636,-73.88399,10460
160975,31,41,67,0,0,139,41.133256,-73.791924,10570
517764,0,0,0,4,12,16,40.771401,-73.812418,11354
209602,0,0,0,2,12,14,40.679383,-73.583991,11575
730929,0,0,0,4,12,16,40.871999,-73.880128,10467
874880,0,0,0,60,0,60,42.961839,-77.137846,14432
395084,0,0,0,2,12,14,40.827794,-73.890175,10459
568029,0,0,0,2,6,8,40.855865,-73.869737,10462
643458,0,0,0,110,0,110,40.628411,-74.107287,10310
766616,0,0,0,82,0,82,40.814875,-72.693999,11960
708529,0,12,125,0,0,137,42.522819,-73.709787,12033
799959,0,0,0,4,12,16,40.837932,-73.912863,10456
710135,0,0,0,4,12,16,40.674664,-73.851629,11417
228580,0,0,0,2,12,14,40.872651,-73.903329,10463
32973,0,0,0,4,12,16,40.750019,-73.482377,11714
437184,0,0,0,0,12,12,40.73823,-73.303352,11795
685184,0,0,0,0,12,12,40.700664,-73.761312,11412
43459,0,0,0,60,0,60,41.164389,-73.999164,10956
709705,0,0,0,122,0,122,40.742869,-73.959373,11101
225747,0,0,0,4,12,16,40.693393,-73.819234,11419
4645,0,0,0,4,12,16,40.946027,-73.861924,10701
463602,0,0,0,4,12,16,40.630153,-73.958704,11230
72501,0,0,0,4,12,16,40.843274,-73.936146,10032
541517,0,0,0,4,12,16,40.661538,-73.907499,11212
847713,0,0,0,36,0,36,40.86854,-73.867455,10467
869933,0,0,14,0,0,14,42.159825,-77.06023,14830
617601,0,0,0,2,6,8,40.829232,-73.92101,10451
533013,0,0,123,0,0,123,41.121963,-74.066374,10952
865378,0,0,0,4,12,16,40.744103,-73.872469,11373
72214,0,0,0,4,12,16,40.631356,-73.898876,11236
689828,0,0,0,216,0,216,40.710005,-73.813217,11435
463684,32,32,0,0,0,64,41.338723,-74.161638,10950
780480,0,0,0,4,12,16,40.852571,-73.887911,10458
313724,0,0,0,271,0,271,40.748858,-73.866395,11368
410996,0,0,0,4,12,16,40.67936,-73.911216,11233
42608,0,64,73,0,0,137,40.787617,-73.373223,11747
793924,0,0,0,2,12,14,40.827949,-73.899511,10459
43747,0,8,36,0,0,44,42.444751,-75.088704,13820
825623,0,0,0,4,12,16,40.847178,-73.938913,10033
878096,0,0,0,4,12,16,40.659525,-73.957804,11225
29886,0,0,0,2,6,8,41.58417,-74.072696,12589
721507,0,0,0,188,0,188,40.647057,-73.88145,11239
775370,0,0,0,4,12,16,40.834519,-73.90406,10456
21092,0,0,0,2,6,8,42.112848,-76.020588,13760
40593,0,28,49,37,0,114,41.059858,-73.853961,10591
563599,0,0,0,4,12,16,42.704458,-76.559033,13071
766000,0,0,0,4,12,16,40.697396,-73.915653,11221
879799,0,0,0,2,12,14,40.863553,-73.868553,10467
851111,0,0,0,4,12,16,40.864147,-73.894105,10458
709858,0,0,0,121,0,121,40.582219,-73.972739,11224
36803,0,0,0,4,12,16,43.134204,-77.63446,14611
868540,0,0,0,60,0,60,41.786925,-73.935641,12538
854479,0,0,0,4,12,16,40.78338,-73.791976,11360
307824,0,0,0,2,12,14,40.813307,-73.948513,10027
860525,7,8,15,16,0,46,43.056539,-76.140294,13203
759383,0,0,0,0,12,12,40.823229,-73.910097,10451
880903,0,0,0,4,12,16,40.63905,-73.95767,11226
574466,0,0,0,4,12,16,40.859699,-73.90582,10468
311900,0,0,66,0,0,66,42.437338,-79.338662,14063
397755,0,0,0,2,6,8,41.345696,-74.115102,10930
251637,0,0,0,2,6,8,43.042593,-76.143803,13202
700756,0,0,0,4,12,16,40.806743,-73.953885,10026
717632,0,0,0,140,0,140,40.704764,-73.939004,11206
803413,0,0,0,4,12,16,40.830824,-73.034497,11738
289702,0,0,0,4,12,16,40.617892,-74.075004,10304
39161,11,22,38,30,0,101,42.686967,-73.861292,12203
388354,0,0,0,4,12,16,40.905233,-73.901745,10471
446419,0,0,0,4,12,16,40.657134,-73.728418,11422
806115,0,0,0,2,6,8,40.852747,-73.898772,10457
250208,0,0,0,4,12,16,40.634155,-74.110279,10310
840397,0,0,0,2,6,8,40.812833,-73.908098,10455
850331,0,0,0,4,12,16,40.723513,-73.81626,11367
821754,0,0,0,4,12,16,40.706489,-73.836625,11418
468303,0,0,22,181,0,203,40.773001,-73.914841,11105
480528,0,0,0,4,12,16,40.641811,-73.932497,11203
73917,0,0,0,252,0,252,40.799329,-73.933192,10035
275263,0,0,0,4,12,16,40.764518,-73.864361,11369
817399,0,0,0,4,12,16,40.639239,-74.082702,10301
383359,0,0,0,4,12,16,40.655105,-73.95678,11226
640808,0,0,0,4,12,16,40.881191,-73.903785,10463
106947,0,0,0,2,6,8,40.689277,-73.906813,11207
881865,0,0,0,0,12,12,40.870406,-73.891122,10468
642699,0,7,14,13,0,34,42.881503,-73.928035,12302
619253,0,0,0,143,0,143,40.714096,-73.797828,11432
794393,0,0,49,0,0,49,42.656592,-73.762114,12210
700017,8,21,21,9,0,59,41.717486,-73.928188,12601
565612,0,0,0,4,12,16,42.661636,-73.758738,12210
782895,0,0,0,4,12,16,40.847731,-73.92186,10453
853432,0,0,0,4,12,16,40.68534,-73.749961,11413
854006,8,24,32,19,0,83,41.351081,-73.752158,10541
355075,0,0,0,2,6,8,43.809025,-76.014818,13605
8541,0,0,0,2,6,8,42.627327,-74.747003,12197
546763,16,41,84,0,0,141,40.98709,-73.862926,10706
144412,0,0,144,0,0,144,41.508256,-74.013804,12550
712414,8,8,21,30,0,67,43.213538,-77.72075,14626
858797,0,0,0,4,12,16,40.85413,-73.914426,10453
345893,0,0,0,4,12,16,40.86752,-73.90073,10468
16618,0,0,0,4,12,16,41.384542,-73.782228,10541
824949,0,0,0,4,12,16,40.635904,-73.601193,11510
876355,0,0,0,2,6,8,42.769141,-77.50022,14471
40527,0,0,0,60,0,60,41.154075,-73.757582,10514
876832,0,0,18,0,0,18,42.694338,-73.647976,12198
709625,0,0,0,240,0,240,40.735847,-73.823582,11367
860184,0,0,0,4,12,16,40.636235,-73.99234,11219
263715,14,10,77,30,0,131,42.128188,-77.957365,14895
120862,0,0,51,0,0,51,42.672354,-73.783006,12206
874179,16,32,74,32,0,154,40.946088,-72.825566,11792
881642,8,0,18,0,0,26,42.337542,-79.090393,14138
869083,0,0,0,4,12,16,40.679067,-73.797638,11436
39202,16,58,65,0,0,139,42.656191,-73.805859,12208
798501,0,0,0,4,12,16,40.854384,-73.908138,10453
422385,0,0,461,0,0,461,40.774401,-73.246076,11717
679262,0,0,0,4,12,16,40.686881,-73.867334,11208
709613,0,0,0,171,0,171,40.733304,-73.877829,11373
795550,0,0,44,0,0,44,43.050608,-74.357575,12078
853061,0,0,0,4,12,16,40.834772,-73.906991,10456
339132,0,0,0,375,0,375,40.883154,-73.830669,10475
232106,0,0,0,2,12,14,41.765033,-73.806488,12569
292591,0,0,0,2,6,8,40.814766,-73.9236,10451
22339,0,0,0,2,6,8,42.97567,-77.409227,14564
750412,0,0,0,44,0,44,42.82073,-73.907934,12308
213345,0,0,0,144,0,144,42.959629,-78.913344,14207
330694,0,0,0,198,0,198,40.716475,-73.903878,11378
846801,0,0,0,4,12,16,40.688846,-73.557746,11566
805441,0,0,16,0,0,16,43.055129,-76.131825,13203
19266,0,0,0,2,12,14,43.456452,-76.341786,13114
266336,0,0,0,0,8,8,40.685585,-73.876225,11208
829347,0,0,0,4,12,16,41.686057,-73.762996,12540
44796,32,28,42,16,0,118,43.11543,-77.627959,14620
569839,0,0,0,2,6,8,40.83535,-73.922553,10452
613915,0,0,0,4,12,16,40.812112,-73.942633,10037
517884,0,0,0,4,12,16,40.829279,-73.630391,11545
246366,0,0,0,2,6,8,42.175493,-75.133212,13856
877935,24,60,81,18,0,183,40.761228,-73.423586,11747
733322,0,0,0,4,12,16,44.22025,-74.464575,12986
385308,0,24,89,0,0,113,40.808617,-72.646145,11978
879049,0,0,0,0,8,8,40.72584,-73.522537,11756
837321,0,0,0,80,0,80,42.94216,-78.871978,14216
332123,32,48,115,24,0,219,41.110066,-73.726128,10504
440201,0,0,0,80,0,80,40.818047,-73.868859,10473
800628,0,0,25,0,0,25,44.683596,-73.445685,12903
527243,0,0,0,4,12,16,40.598522,-73.945204,11229
547793,0,0,0,82,0,82,43.06903,-76.076726,13057
72655,0,0,0,4,12,16,40.630553,-73.924844,11234
466983,0,0,0,4,12,16,40.925058,-73.862921,10704
844505,0,0,0,0,10,10,40.866534,-73.894396,10468
714388,16,20,37,62,0,135,43.178607,-77.614784,14621
160423,0,0,57,29,0,86,40.671003,-73.385373,11726
365732,0,0,0,4,12,16,42.946836,-78.813064,14215
306808,0,0,0,4,12,16,40.762768,-73.234175,11717
39323,0,0,19,0,0,19,41.965326,-75.173441,13774
848386,0,0,0,0,12,12,40.695937,-73.811995,11435
276404,0,0,0,4,12,16,40.82346,-72.779363,11934
714023,0,0,0,87,0,87,41.52561,-74.122801,12550
494300,0,0,0,170,0,170,40.812515,-73.914188,10455
824561,0,0,0,101,0,101,40.799056,-73.96488,10025
866880,0,23,23,71,0,117,41.457659,-74.341246,10941
41340,16,20,34,0,0,70,41.268104,-73.647732,10536
714792,0,0,0,4,12,16,40.830953,-73.899024,10459
529770,0,0,0,4,12,16,40.883288,-73.879476,10467
311794,0,29,120,0,0,149,41.434454,-73.572752,10509
296048,0,0,0,4,12,16,40.635484,-73.897121,11236
485176,0,0,0,4,12,16,43.050192,-74.870857,13365
770034,0,0,0,4,12,16,40.805591,-73.95111,10026
798235,0,0,0,4,12,16,41.285902,-73.914526,10566
694770,0,0,0,125,0,125,40.649496,-73.958256,11226
41314,0,0,36,0,0,36,41.711002,-74.385445,12428
585586,0,0,0,2,12,14,40.877434,-73.909068,10463
507416,0,0,0,4,12,16,40.628917,-74.156803,10303
832764,0,0,0,2,6,8,40.647301,-73.955879,11226
348683,0,0,0,4,12,16,40.790846,-72.846047,11950
764673,0,0,0,4,12,16,43.301283,-73.565406,12839
794872,0,0,0,189,0,189,40.795031,-73.973632,10025
869287,0,0,0,4,12,16,43.012772,-73.783167,12020
856809,0,0,0,2,6,8,40.8379,-73.8515,10462
225103,0,0,0,4,12,16,41.116438,-74.016769,10954
210884,0,0,0,4,12,16,43.070633,-76.063342,13057
357719,32,48,47,0,0,127,41.010718,-73.726224,10604
873044,0,0,0,4,12,16,40.65263,-73.9103,11236
859381,0,0,0,2,6,8,43.217013,-78.17066,14411
701662,0,0,0,4,12,16,43.01373,-73.856804,12020
871245,24,34,76,24,0,158,42.855226,-73.770703,12065
872240,0,0,0,0,8,8,40.89623,-73.839427,10466
4304,0,0,0,4,12,16,43.332705,-73.701738,12804
852298,0,0,0,4,12,16,42.480976,-74.614396,12093
42968,0,0,0,80,0,80,41.135153,-74.006897,10956
816650,0,0,0,2,6,8,40.84576,-73.918108,10452
497364,0,0,0,4,12,16,40.681758,-73.811642,11420
840550,24,40,60,30,0,154,43.003127,-78.145598,14020
834174,0,0,21,0,0,21,40.915815,-73.807621,10803
73164,0,0,0,100,0,100,40.716363,-73.9466,11211
260935,0,0,0,2,6,8,44.657507,-75.497933,13669
777719,0,6,10,9,0,25,41.100507,-74.054481,10977
801432,0,0,0,4,12,16,40.870827,-73.893294,10468
848649,0,0,0,2,12,14,40.882745,-73.855442,10469
810729,0,0,0,4,12,16,40.789801,-73.256632,11717
163488,11,17,31,0,0,59,40.670047,-73.426296,11758
182884,0,0,0,4,12,16,40.677003,-73.940251,11213
843923,0,0,0,4,12,16,40.642123,-73.952371,11226
843188,0,0,0,4,12,16,42.107237,-74.034877,12477
434718,0,0,0,4,12,16,40.680073,-73.766195,11434
597738,0,0,0,4,12,16,42.910189,-78.820474,14211
686467,0,0,0,4,12,16,40.69039,-73.909126,11207
762115,0,0,0,4,12,16,40.82444,-73.91554,10451
412014,0,0,0,4,12,16,40.67884,-73.968636,11238
882781,0,0,0,4,12,16,40.741393,-73.928403,11101
771971,0,0,0,4,12,16,40.864876,-73.89233,10458
629569,0,0,0,63,0,63,43.257782,-76.019065,13044
668611,0,0,0,4,12,16,40.837327,-73.919042,10452
816251,0,0,0,70,0,70,40.869344,-73.033289,11784
852615,0,0,0,39,0,39,44.324825,-74.135902,12983
273010,0,0,0,4,12,16,41.694957,-73.88115,12603
839959,14,16,14,40,0,84,42.730179,-73.693274,12180
814467,0,0,0,4,12,16,40.643184,-74.017419,11220
473956,0,0,0,2,6,8,40.829934,-73.940681,10032
730251,0,0,0,4,12,16,40.650089,-73.553652,11566
216054,0,0,0,0,5,5,40.735017,-73.862586,11368
261600,0,0,0,4,12,16,40.668459,-73.947705,11213
799476,0,0,0,135,0,135,40.662621,-73.679921,11563
874537,0,0,0,4,12,16,40.903986,-73.845507,10466
142056,0,0,0,4,12,16,40.846196,-73.939052,10033
878213,0,0,0,4,12,16,40.905428,-73.851376,10470
857384,0,15,9,0,0,24,41.673323,-74.784796,12762
403403,0,0,0,4,12,16,40.727357,-73.857844,11374
620576,0,0,0,4,12,16,40.691343,-73.612447,11550
735631,0,0,0,137,0,137,43.089048,-75.189531,13501
803776,0,0,0,4,12,16,43.187313,-77.634455,14613
887,0,0,0,2,6,8,44.270826,-73.985119,12946
121820,0,0,0,4,12,16,40.684647,-73.814286,11420
864832,0,0,36,0,0,36,42.255673,-79.269966,14782
748751,0,0,0,4,12,16,41.086475,-73.861038,10591
680834,0,0,0,4,12,16,40.670591,-73.986059,11215
867914,0,0,0,4,12,16,40.711375,-73.40587,11701
774252,0,0,0,55,0,55,40.777164,-73.250771,11717
43203,0,29,33,22,0,84,40.756812,-73.117456,11716
634886,0,0,0,2,6,8,40.618679,-73.92602,11234
262636,0,0,0,4,12,16,43.201506,-76.36162,13027
660943,0,0,0,4,12,16,40.90583,-73.850162,10470
790832,0,0,0,2,12,14,40.841857,-73.926232,10452
72356,0,0,0,4,12,16,40.865438,-73.892236,10458
877121,16,48,58,23,0,145,40.882267,-72.940272,11953
101578,0,0,0,4,12,16,40.838049,-73.940412,10032
380295,0,0,0,60,0,60,43.079805,-76.00113,13116
842008,0,0,0,4,12,16,42.282687,-74.93182,13753
837881,0,0,0,2,6,8,40.864963,-73.892372,10458
855761,0,0,0,4,12,16,40.817226,-73.885997,10474
556504,0,0,0,4,12,16,41.460813,-73.631305,12563
847511,0,0,0,2,12,14,40.845743,-73.880062,10460
833465,0,0,42,0,0,42,41.41279,-73.660816,10512
151982,0,0,0,4,12,16,40.852911,-73.892736,10457
778321,0,0,0,4,12,16,40.813105,-73.887849,10474
873511,0,0,0,4,12,16,42.48902,-76.299772,13053
282281,0,0,0,0,10,10,40.805503,-73.919122,10454
207007,0,0,0,4,12,16,40.779721,-73.21389,11722
219345,0,0,0,280,0,280,40.674229,-73.951321,11216
724447,0,0,0,40,0,40,41.787263,-73.692834,12545
790043,0,0,0,2,12,14,40.845596,-73.904904,10457
489607,0,0,0,4,12,16,40.85834,-73.931585,10040
350579,0,0,0,4,12,16,40.734406,-73.850577,11375
881656,0,0,0,2,6,8,43.458925,-73.384435,12821
880639,0,0,0,0,9,9,40.80801,-73.923455,10454
248092,0,0,0,4,12,16,41.019185,-73.869462,10522
841462,0,0,0,60,0,60,40.841229,-73.111347,11755
821689,0,0,0,4,12,16,40.703426,-73.703101,11003
453958,0,0,0,4,12,16,40.855266,-73.903877,10453
40203,0,0,0,44,0,44,43.082957,-73.77831,12866
784565,0,0,0,4,12,16,43.095122,-77.796203,14624
306073,0,0,0,4,12,16,43.135593,-77.640474,14619
760021,16,44,65,17,0,142,40.858218,-73.153567,11767
842904,0,0,0,240,0,240,40.730738,-73.852885,11374
664490,0,0,0,4,12,16,42.424286,-76.512101,14850
459763,0,0,0,4,12,16,41.383644,-74.678212,12771
825247,0,0,0,0,12,12,40.798621,-73.947746,10029
779094,0,0,53,0,0,53,43.102804,-75.660278,13421
31851,0,0,0,2,6,8,41.819057,-73.982903,12561
538099,0,0,0,4,12,16,40.64352,-74.083541,10301
8967,0,0,0,2,6,8,42.843167,-77.689894,14487
42430,0,0,0,20,0,20,44.015616,-75.798532,13612
38511,0,0,0,2,6,8,42.931943,-78.799227,14215
673663,0,0,0,242,0,242,40.719618,-73.977504,10002
538009,0,0,0,4,12,16,42.694435,-78.426145,14145
809473,0,0,0,4,12,16,40.698671,-73.895013,11385
415150,0,0,0,2,6,8,40.795097,-72.951155,11713
572140,0,0,0,2,6,8,40.662983,-73.910137,11212
718989,0,0,0,4,12,16,40.840321,-73.924473,10452
725243,0,0,0,2,6,8,43.073901,-76.103444,13206
849909,0,0,0,4,12,16,40.818169,-73.865233,10473
866310,0,0,0,4,12,16,40.691321,-73.858465,11421
833025,0,0,0,304,0,304,40.778406,-73.842922,11356
671038,0,0,0,2,6,8,40.824019,-73.937659,10039
877742,0,12,39,34,0,85,40.658065,-73.598909,11520
506706,0,0,0,0,12,12,40.837778,-73.917054,10452
589229,0,0,0,4,12,16,40.577884,-73.967661,11235
259458,0,0,0,4,12,16,41.56449,-74.209976,12586
418953,0,0,0,4,12,16,41.033791,-73.830383,10607
828691,0,12,136,132,0,280,43.097002,-75.239696,13501
208482,0,0,0,2,6,8,42.733623,-73.710221,12189
146531,0,0,0,0,6,6,40.823097,-73.88929,10459
678331,0,0,0,4,12,16,40.795961,-73.937058,10029
882505,0,0,0,2,6,8,40.850191,-73.896118,10457
654570,0,0,0,4,12,16,40.874233,-73.879183,10467
831835,0,0,0,4,12,16,40.639067,-73.930219,11203
402227,0,0,0,2,6,8,43.206612,-75.461628,13440
330153,0,0,0,2,12,14,40.683463,-73.851585,11416
736229,0,0,0,2,6,8,40.814809,-73.900162,10455
39433,12,25,36,40,0,113,43.015447,-78.873787,14150
400754,0,0,0,4,12,16,40.840196,-73.909716,10457
367965,0,0,0,4,12,16,40.65075,-73.916526,11236
806720,0,0,0,51,0,51,40.664534,-73.929299,11213
785434,0,0,0,4,12,16,40.705618,-73.948361,11206
841120,16,24,32,18,0,90,43.029589,-73.919781,12020
663470,0,0,24,88,0,112,40.602363,-74.091162,10304
406925,0,0,0,64,0,64,40.693869,-73.792188,11433
826712,0,0,0,4,12,16,40.685581,-73.398017,11726
39844,0,0,95,0,0,95,40.716814,-73.62,11550
364266,0,0,0,0,6,6,40.828755,-73.941044,10031
790464,0,0,0,4,12,16,40.603943,-73.758056,11691
235663,0,0,0,4,12,16,40.653823,-73.940096,11203
340219,0,0,0,4,12,16,41.77527,-73.701226,12545
839618,0,0,0,0,10,10,40.846999,-73.891772,10457
319571,0,0,0,4,12,16,43.505003,-76.128596,13142
649726,0,0,0,0,12,12,40.832653,-73.879951,10472
822911,0,0,0,45,0,45,40.679852,-73.379339,11787
110264,0,0,0,4,12,16,40.684569,-73.918197,11233
607850,0,0,0,4,12,16,40.696079,-73.764574,11412
451819,0,0,0,4,12,16,40.851979,-73.937682,10033
839676,0,0,0,4,12,16,40.639094,-73.708104,11557
475744,0,0,0,0,10,10,43.183372,-77.613509,14621
836434,12,11,17,12,0,52,43.138715,-77.629375,14611
775586,0,0,0,4,12,16,40.806468,-73.919137,10454
795882,0,0,0,2,6,8,43.0943,-77.4563,14450
684218,0,0,0,4,12,16,40.841364,-73.891609,10457
642091,16,24,60,26,0,126,42.111633,-76.040504,13760
795704,0,0,0,84,0,84,42.879994,-76.963973,14456
298000,0,0,0,4,12,16,40.597841,-73.763077,11691
880685,0,0,0,4,12,16,42.851418,-73.800944,12065
40662,0,0,46,0,0,46,43.225602,-76.845644,14590
477980,0,0,0,4,12,16,44.793624,-74.304847,12953
415708,0,0,0,2,6,8,43.116014,-77.746076,14624
644465,0,12,34,100,0,146,43.343593,-73.684987,12804
341945,0,0,0,4,12,16,40.800255,-73.948012,10026
824049,0,0,0,4,12,16,40.751245,-73.891693,11372
729368,0,0,53,0,0,53,41.558355,-74.187841,12586
863336,0,0,0,4,12,16,43.13384,-77.646986,14619
781010,0,0,0,4,12,16,40.732157,-73.529839,11756
45158,0,0,61,7,0,68,41.917324,-74.051306,12443
530732,0,0,0,2,6,8,43.792674,-75.482068,13367
877466,0,0,0,2,12,14,40.857349,-73.908236,10453
765494,0,0,0,126,0,126,40.799056,-73.96488,10025
217982,6,10,0,0,0,16,41.681528,-73.893728,12603
521465,0,0,40,0,0,40,42.642414,-79.032553,14006
621325,0,0,0,301,0,301,40.706449,-73.803865,11432
71701,0,0,0,0,10,10,40.632228,-74.097354,10301
874730,0,0,16,0,0,16,42.814575,-73.936292,12305
709928,0,0,0,325,0,325,40.862661,-73.864677,10467
753272,12,12,44,0,0,68,40.907129,-73.783515,10805
519753,0,0,0,4,12,16,40.755676,-73.538691,11801
42517,0,0,0,80,0,80,43.790195,-75.492324,13367
880354,0,0,0,92,0,92,40.661204,-73.886411,11207
878908,0,0,0,254,0,254,40.755542,-73.855412,11368
277784,0,0,0,4,12,16,40.883142,-73.849698,10466
787097,0,0,0,4,12,16,40.649073,-73.973267,11218
881051,0,0,0,2,6,8,43.21149,-77.64751,14616
198989,0,0,0,40,0,40,40.816536,-73.899539,10456
45319,8,25,54,8,0,95,42.891323,-78.848546,14212
861765,0,0,0,2,6,8,43.196054,-77.609855,14621
817993,0,0,0,4,12,16,40.820025,-73.943688,10030
572182,0,0,0,65,0,65,40.779843,-73.55581,11753
877741,32,43,67,0,0,142,42.86708,-73.820585,12065
733961,0,0,0,2,6,8,42.743418,-73.67384,12180
369892,0,0,0,2,6,8,43.484861,-75.338141,13309
875443,8,24,94,18,0,144,40.717768,-73.575067,11554
172167,0,0,0,4,12,16,43.177135,-77.590995,14621
427977,0,0,0,4,12,16,40.679039,-73.799551,11436
875998,0,0,0,0,10,10,40.836821,-73.915875,10452
827584,0,0,0,0,5,5,40.789238,-73.946184,10029
229697,0,0,0,4,12,16,40.84829333,-73.93609667,10033
437818,0,0,0,2,6,8,42.640245,-73.768446,12202
845591,0,0,48,0,0,48,43.117967,-77.615001,14620
150335,0,0,0,30,0,30,40.668956,-73.948628,11225
734685,0,0,0,0,10,10,40.849792,-73.904595,10457
672364,0,0,0,4,12,16,40.750021,-73.326959,11729
876618,0,0,0,4,12,16,40.897061,-73.854108,10466
333833,0,0,0,4,12,16,43.172841,-77.599699,14605
103349,0,0,0,4,12,16,40.594842,-73.943555,11229
608389,0,0,0,140,0,140,40.604164,-73.749474,11691
681450,0,0,0,2,12,14,40.885009,-73.899737,10463
44421,0,0,33,0,0,33,43.193163,-77.648569,14615
43568,12,15,0,0,0,27,44.323307,-74.122046,12983
349581,0,0,0,4,12,16,40.830636,-73.889459,10459
716797,0,0,0,2,6,8,40.831614,-73.921635,10452
39738,16,40,58,20,0,134,43.194149,-77.708645,14626
204130,0,0,0,0,10,10,40.836319,-73.886086,10460
662689,0,0,0,2,6,8,40.852421,-73.922232,10453
840924,0,0,0,60,0,60,43.103856,-79.050126,14305
165704,0,0,0,2,12,14,43.114161,-76.160814,13088
592071,0,0,0,0,12,12,40.88182,-73.884465,10467
595105,0,0,0,4,12,16,40.802023,-73.952371,10026
646106,0,0,0,4,12,16,40.648539,-73.593238,11520
873763,0,0,0,4,12,16,40.71368,-73.817747,11435
786132,0,0,0,0,10,10,40.829313,-73.918681,10456
872790,0,0,0,4,12,16,41.019316,-73.829037,10502
761278,0,0,0,2,6,8,42.754338,-73.879244,12304
800941,0,0,0,4,12,16,40.617503,-74.081784,10304
359154,0,0,0,4,12,16,40.678297,-73.800374,11436
240673,0,0,0,233,0,233,40.780245,-73.91612,11105
823552,0,0,0,2,6,8,40.684042,-73.948931,11216
44548,0,0,0,106,0,106,41.478938,-73.632631,12563
843596,0,0,18,0,0,18,42.086943,-75.919547,13903
770745,0,0,0,148,0,148,40.672812,-73.770586,11434
815179,0,0,0,2,6,8,43.192514,-77.640883,14615
686569,0,0,0,4,12,16,40.758825,-73.813405,11355
73691,0,0,0,88,0,88,40.736153,-73.850148,11375
41125,0,0,0,44,0,44,42.704107,-73.813133,12205
429608,0,0,0,2,6,8,40.838566,-73.915733,10452
682814,0,0,0,2,6,8,40.837019,-73.890128,10460
828307,0,0,0,4,12,16,40.717221,-73.372902,11704
30776,0,0,0,4,12,16,42.99694,-74.106258,12086
709889,0,0,0,80,0,80,40.795555,-73.944602,10029
660539,0,0,0,70,0,70,40.801134,-73.52423,11791
844242,0,0,0,4,12,16,40.781159,-72.831909,11951
854993,0,0,0,4,12,16,40.95301,-73.888188,10703
868298,0,0,0,0,10,10,40.917221,-73.83868,10550
524533,0,0,0,2,6,8,43.645861,-76.078275,13145
309275,0,0,0,41,0,41,40.719173,-73.733554,11428
38754,0,0,0,4,12,16,42.101079,-78.497473,14706
624476,0,0,0,4,12,16,40.628198,-73.945937,11210
383384,0,0,0,240,0,240,40.669569,-73.979111,11215
72541,0,0,0,4,12,16,40.653221,-74.005879,11232
653269,0,0,0,4,12,16,40.647284,-73.968862,11218
879278,16,50,68,0,0,134,40.634273,-73.640796,11572
858419,0,0,0,4,12,16,40.850218,-73.896441,10457
612559,0,0,0,0,8,8,40.679444,-73.794498,11436
534942,0,0,0,4,12,16,43.225067,-75.338467,13440
740693,0,0,44,0,0,44,40.8771,-72.530177,11946
763704,0,0,0,4,12,16,40.826424,-73.909806,10456
42295,0,0,0,90,0,90,42.533099,-75.523758,13815
836598,0,0,0,4,12,16,41.201719,-73.979167,10927
74170,0,0,0,135,0,135,40.872394,-73.883649,10467
807565,0,0,0,4,12,16,42.72299,-73.823119,12205
258517,0,0,0,4,12,16,40.683295,-73.765545,11434
159141,16,24,32,0,0,72,43.786726,-75.474806,13367
831711,0,0,0,117,0,117,40.837046,-73.887717,10460
739751,0,0,0,2,6,8,42.473887,-73.817622,12143
531852,0,0,0,4,12,16,40.80892,-73.920723,10454
543942,0,0,0,4,12,16,42.803558,-78.734531,14127
154962,0,0,0,2,6,8,41.995013,-73.911851,12571
392858,0,0,0,2,6,8,40.847342,-73.933536,10033
870737,0,0,0,2,6,8,40.839818,-73.880463,10460
670469,0,0,0,4,12,16,40.683357,-73.845305,11416
41693,0,14,69,0,0,83,41.061432,-73.957238,10913
597140,0,0,0,4,12,16,40.679281,-73.997009,11231
434192,14,20,42,0,0,76,43.969473,-75.912216,13601
40726,16,24,16,0,0,56,40.820578,-73.219359,11788
817539,0,0,0,4,12,16,40.702912,-73.751816,11412
867739,0,0,0,4,12,16,40.674208,-73.723349,11580
685390,0,0,24,0,0,24,42.695663,-73.64024,12198
798473,0,0,0,4,12,16,40.765763,-73.86663,11369
587459,0,0,0,164,0,164,40.659869,-73.885443,11207
177338,0,0,0,20,0,20,40.655679,-73.91718,11212
36482,0,0,0,2,6,8,42.616257,-79.101615,14006
127701,0,0,61,0,0,61,42.907431,-76.806745,13148
189511,0,0,0,116,0,116,40.835547,-73.825825,10461
145691,0,0,0,16,0,16,40.623907,-74.032316,11209
45328,16,21,106,12,0,155,43.130446,-77.609218,14620
346818,0,0,0,2,6,8,42.812763,-77.659188,14487
778913,0,0,0,4,12,16,40.858165,-73.89045,10458
742501,0,0,0,103,0,103,40.714833,-73.963129,11249
605794,0,0,0,4,12,16,40.825156,-73.818868,10465
820038,0,0,0,4,12,16,40.927368,-73.899521,10701
880569,0,0,28,0,0,28,43.125601,-75.317625,13492
821929,0,0,0,4,12,16,40.875755,-73.886887,10468
820853,0,0,0,194,0,194,40.655712,-73.906989,11212
878859,0,0,0,4,12,16,40.751245,-73.891693,11372
844701,0,0,0,0,12,12,40.8517,-73.914494,10453
874941,0,0,0,4,12,16,40.828025,-73.890727,10459
838996,16,24,48,11,0,99,43.152625,-78.662039,14094
532511,0,0,0,0,10,10,40.727802,-73.881699,11379
871807,6,24,18,15,0,63,42.382465,-76.871802,14891
195366,0,0,0,2,12,14,42.011131,-76.538046,14892
846552,0,0,0,4,12,16,40.842378,-73.892947,10457
882544,0,0,0,0,12,12,40.855289,-73.881319,10458
244680,0,0,0,2,6,8,43.025145,-76.137918,13210
40082,0,0,194,0,0,194,41.337821,-74.161498,10950
396056,0,0,0,4,12,16,43.160296,-77.561294,14609
221580,0,0,0,0,6,6,40.851936,-73.907683,10453
71786,0,0,0,4,12,16,40.728112,-73.864246,11374
675054,16,21,47,0,0,84,41.414831,-73.684403,10512
734414,0,0,0,4,12,16,43.07778,-76.07902,13057
450333,0,0,0,70,0,70,40.800926,-73.727371,11023
706431,0,0,0,40,0,40,42.085168,-76.795241,14904
877541,0,0,0,2,6,8,40.745683,-73.558945,11590
712399,0,0,16,0,0,16,42.232654,-76.185244,13811
882361,0,0,0,4,12,16,40.642103,-73.59616,11520
541925,0,0,0,4,12,16,40.852767,-73.917033,10453
875703,0,0,0,4,12,16,40.875057,-73.854104,10469
71708,0,0,0,4,12,16,40.684037,-73.951126,11216
757199,0,0,0,4,12,16,40.658431,-73.678888,11563
493422,0,0,0,2,6,8,43.067254,-76.383758,13112
260018,0,0,0,4,12,16,40.780155,-73.028721,11772
426880,0,0,0,4,12,16,40.653734,-73.928221,11203
836277,0,0,0,4,12,16,43.012659,-76.148048,13205
876168,0,0,0,4,12,16,40.636993,-73.948251,11210
233237,15,20,29,20,0,84,42.867297,-73.806351,12065
851229,0,0,18,0,0,18,42.162552,-77.082533,14870
816253,0,0,0,84,0,84,40.878069,-73.066334,11720
355904,0,0,14,46,0,60,43.026724,-75.992617,13066
831337,0,0,0,2,6,8,40.842924,-73.904631,10457
791385,0,0,0,4,12,16,40.648296,-73.898313,11236
140098,0,0,0,2,6,8,42.047488,-73.781908,12571
416578,0,0,0,4,12,16,40.775082,-73.23265,11717
541724,0,0,0,4,12,16,41.154305,-74.031689,10956
878260,0,0,0,4,12,16,40.883622,-73.030771,11727
608776,0,0,0,2,6,8,40.928569,-73.082657,11733
338489,0,0,0,399,0,399,40.846059,-73.887018,10457
679618,0,0,0,4,12,16,40.813127,-73.907287,10455
879465,0,0,0,0,10,10,40.93197,-73.888472,10701
500596,0,0,0,4,12,16,40.815053,-73.888407,10474
715410,0,0,0,4,12,16,42.09468,-75.933376,13905
386810,0,0,0,72,0,72,40.5971,-73.936322,11229
561436,0,0,0,4,12,16,40.930994,-73.886094,10701
716606,0,0,0,2,6,8,40.759326,-73.934926,11106
247673,0,0,0,141,0,141,40.664622,-73.759123,11413
40021,16,36,84,20,0,156,43.087311,-76.183237,13088
143061,0,0,0,4,12,16,40.784983,-73.253616,11717
455962,0,11,48,14,0,73,40.688647,-73.667708,11552
837633,0,0,0,4,12,16,40.87148,-73.887392,10458
798069,0,0,0,4,12,16,40.919103,-73.903224,10705
873500,0,0,0,61,0,61,40.652762,-73.608466,11510
656152,0,0,0,4,12,16,43.241418,-77.741876,14468
12103,0,0,0,4,12,16,41.611024,-73.791835,12533
808229,0,0,0,4,12,16,40.57955,-73.954201,11235
823904,16,48,65,0,0,129,42.970421,-73.806555,12020
821230,0,0,0,4,12,16,40.853665,-73.917085,10453
822576,0,0,0,4,12,16,40.849626,-73.890237,10457
43328,7,7,44,21,0,79,40.644765,-73.591351,11520
624206,0,0,0,2,6,8,40.650745,-73.629128,11572
867525,8,10,26,0,0,44,40.693039,-73.567808,11566
40896,15,19,54,0,0,88,43.177208,-76.271347,13027
866779,0,0,0,4,12,16,42.917186,-78.848657,14208
553770,0,0,0,4,12,16,40.679257,-73.97266,11217
713043,0,0,0,260,0,260,40.719132,-73.979369,10002
819465,0,0,0,4,12,16,40.66059,-73.588871,11520
827693,0,0,20,100,0,120,42.965119,-78.817862,14226
44166,0,26,99,44,0,169,41.319869,-73.857472,10547
318513,0,0,72,0,0,72,43.075941,-78.96601,14304
73806,0,0,0,12,0,12,40.713497,-73.737061,11429
211479,0,0,0,4,12,16,43.187454,-77.587489,14621
41478,24,20,66,0,0,110,42.683288,-73.76585,12211
31677,0,0,0,2,6,8,42.965554,-78.741012,14221
43921,0,0,0,149,0,149,41.04748,-73.764365,10604
383378,0,0,0,2,6,8,43.152954,-77.637803,14611
128993,0,20,286,0,0,306,40.808545,-73.278764,11725
141446,0,0,0,4,12,16,40.655226,-73.592113,11520
880263,0,0,0,2,6,8,43.17861,-77.647985,14613
872649,0,0,0,4,12,16,40.751302,-73.31148,11729
162378,0,0,0,269,0,269,40.854755,-73.905095,10453
695413,0,0,0,4,12,16,40.687994,-73.966655,11238
313347,0,0,0,2,12,14,40.814796,-73.923019,10451
822156,0,0,0,4,12,16,43.072429,-76.086542,13057
709651,0,0,0,233,0,233,40.661177,-73.988882,11215
260772,0,0,0,4,12,16,40.755085,-73.858195,11368
159495,0,12,57,0,0,69,41.35165,-73.762194,10541
541086,0,0,0,0,12,12,40.823178,-73.878087,10473
175373,0,0,0,4,12,16,40.675434,-74.0064,11231
397706,0,0,0,2,6,8,40.663643,-73.947872,11225
181991,16,20,31,0,0,67,42.955409,-78.677002,14221
43997,16,12,234,25,0,287,43.168108,-77.625129,14608
783164,0,0,0,195,0,195,40.693956,-73.940768,11206
20486,0,0,0,2,6,8,41.642285,-73.886348,12603
523041,0,0,0,4,12,16,42.880767,-78.865609,14204
622776,0,0,0,4,12,16,40.635119,-74.118771,10310
205319,0,0,0,268,0,268,40.710898,-73.689832,11003
494151,0,0,0,4,12,16,40.671617,-73.749997,11413
872103,0,0,0,111,0,111,40.651089,-73.609714,11510
866507,0,0,0,2,6,8,43.049356,-76.07306,13214
710352,0,0,0,4,12,16,40.859349,-73.893799,10458
836886,0,0,0,2,12,14,40.849379,-73.898743,10457
32608,0,0,0,2,6,8,42.492532,-79.323616,14048
771743,0,0,0,4,12,16,42.218969,-78.274669,14727
764238,8,9,18,0,0,35,40.666598,-73.477142,11758
388165,0,0,0,4,12,16,43.185231,-77.622092,14621
721302,0,0,0,306,0,306,40.688329,-73.92447,11221
54665,0,0,0,2,5,7,40.816568,-73.903561,10455
42988,24,47,92,19,0,182,41.098151,-73.775298,10595
188513,0,0,0,4,12,16,40.861204,-73.928205,10040
818576,0,0,0,53,0,53,40.811673,-73.946034,10027
40487,16,16,21,0,0,53,43.231312,-77.201647,14589
564296,0,0,0,4,12,16,40.803391,-73.012207,11763
712400,0,0,16,0,0,16,42.011704,-76.531572,14892
74020,0,0,0,240,0,240,40.743842,-73.709607,11004
857438,0,0,0,4,12,16,40.901684,-73.797967,10801
155903,0,0,0,2,6,8,41.115038,-74.035503,10954
741583,0,0,0,4,12,16,42.941468,-78.831422,14214
41093,0,48,123,0,0,171,40.825669,-73.506154,11791
606446,0,0,0,70,0,70,42.708502,-73.662347,12180
827956,0,0,0,4,12,16,40.658903,-73.620431,11510
499923,0,0,0,4,12,16,41.115665,-73.763681,10594
645407,0,0,0,4,12,16,40.664628,-73.925634,11212
878023,0,0,0,2,6,8,40.776786,-73.22626,11717
879326,0,0,0,201,0,201,40.771763,-73.987283,10023
782220,0,0,0,28,0,28,40.827673,-73.937387,10039
72536,0,0,0,4,12,16,40.711624,-73.853703,11375
876527,0,0,0,4,12,16,43.110055,-73.857237,12833
191359,0,8,17,12,0,37,41.356276,-73.835919,10579
517878,0,0,0,4,12,16,40.645993,-73.928936,11203
223761,0,0,0,168,0,168,40.647067,-73.920709,11203
481043,16,44,99,58,0,217,40.775163,-73.557443,11590
666186,0,0,0,94,0,94,40.805932,-73.17639,11749
240770,16,24,21,10,0,71,43.007214,-76.153309,13207
39508,0,0,18,0,0,18,42.464811,-78.933122,14070
776074,0,0,0,4,12,16,40.82028,-73.865709,10473
816273,0,0,0,198,0,198,40.661829,-73.94014,11203
734953,0,0,0,0,12,12,40.864198,-73.889638,10458
611234,0,0,0,100,0,100,40.671873,-73.924382,11233
861856,14,46,69,0,0,129,40.936463,-73.013904,11766
765875,0,0,0,34,0,34,40.739198,-73.978487,10010
769547,0,0,0,4,12,16,40.843676,-73.917725,10452
810845,0,0,0,4,12,16,44.641079,-75.433981,13669
351518,0,0,0,4,12,16,40.632437,-73.956787,11210
105143,0,0,0,40,0,40,40.660294,-73.914984,11212
45060,0,0,21,46,0,67,43.05219,-76.260954,13031
714866,0,0,58,0,0,58,41.041372,-73.767163,10603
385602,0,0,0,4,12,16,40.864131,-73.838728,10469
73350,0,0,0,28,0,28,40.649916,-73.965296,11226
135826,0,0,0,280,0,280,40.674461,-73.775971,11434
396891,0,0,0,47,0,47,40.710634,-73.986425,10002
532578,0,0,0,4,12,16,40.696731,-73.738517,11411
437437,0,0,0,44,0,44,40.65652,-73.953254,11225
656319,0,0,0,2,6,8,42.152304,-76.057143,13760
429398,0,0,0,167,0,167,40.697626,-73.947721,11206
709887,0,0,0,56,0,56,40.79748,-73.941356,10029
464202,0,0,0,4,12,16,40.863706,-73.861456,10469
731354,0,11,48,0,0,59,40.849263,-73.315576,11731
709727,0,0,0,120,0,120,40.827477,-73.918732,10451
768059,0,0,0,4,12,16,40.848929,-73.921994,10453
207070,0,0,0,2,6,8,40.709553,-73.962497,11211
467167,0,0,0,4,12,16,44.046556,-75.868181,13637
804767,0,0,0,4,12,16,40.732304,-73.36175,11704
365970,0,0,0,2,6,8,40.819568,-73.916921,10455
461954,0,0,0,4,12,16,40.8859,-73.846124,10466
100942,0,0,20,140,0,160,40.707865,-73.456502,11758
358298,0,0,0,4,12,16,40.722632,-73.978762,10009
869884,0,0,0,0,12,12,43.008095,-75.041869,13357
331345,0,0,0,4,12,16,41.429669,-74.443295,10940
598571,0,0,0,2,12,14,40.875285,-73.856445,10469
745065,0,0,0,4,12,16,43.051807,-76.441747,13080
754020,0,0,0,2,6,8,42.846842,-73.813755,12065
163842,0,0,0,4,12,16,43.182194,-77.58564,14621
836749,0,0,0,44,0,44,42.768733,-73.708689,12047
849076,0,10,34,0,0,44,42.910508,-77.296282,14424
427361,0,0,0,4,12,16,40.669529,-73.880418,11208
636592,0,0,0,103,0,103,40.695892,-73.599858,11553
181351,0,0,0,4,12,16,40.692305,-73.838188,11418
709822,0,0,0,160,0,160,40.822075,-73.894037,10459
292364,0,0,0,4,12,16,40.845878,-73.942069,10032
861310,0,0,0,4,12,16,40.711215,-73.61387,11550
641342,0,0,0,4,12,16,40.862888,-73.918789,10034
760416,0,0,0,4,12,16,40.80947,-73.941247,10027
694717,0,0,0,168,0,168,40.920036,-73.903019,10706
818144,0,0,0,4,12,16,40.678471,-73.862359,11417
840041,0,0,0,2,6,8,42.538382,-74.87703,12116
301188,0,0,0,2,12,14,40.812021,-73.901247,10455
425120,0,0,0,4,12,16,40.850402,-73.905758,10453
846648,0,0,0,2,6,8,40.762106,-73.539643,11801
39415,16,12,39,18,0,85,42.673668,-79.024601,14047
789783,0,0,0,4,12,16,40.846185,-73.883617,10460
383976,0,0,0,4,12,16,40.76085,-73.882741,11369
715775,0,0,0,2,6,8,40.849447,-73.890701,10457
674382,0,0,0,4,12,16,40.686286,-73.993173,11201
702997,0,0,0,60,0,60,41.372496,-74.27672,10918
371546,0,0,0,2,6,8,42.719903,-75.886875,13052
617447,0,0,0,2,6,8,41.449737,-73.661665,10512
874322,0,0,0,0,12,12,40.681191,-73.866035,11208
774982,0,0,0,4,12,16,41.450503,-74.418565,10940
41696,0,0,42,0,0,42,41.197829,-73.963112,10927
773971,15,34,20,17,0,86,41.345962,-74.356886,10921
700659,0,0,0,4,12,16,41.748624,-73.911738,12538
39262,8,24,74,0,0,106,42.099047,-79.238513,14701
483244,0,0,0,2,6,8,40.680484,-73.790391,11434
6354,0,0,0,4,12,16,42.823102,-73.32826,12138
42793,0,0,0,120,0,120,40.730611,-73.54244,11554
264610,0,0,0,4,12,16,40.765172,-73.923741,11102
863055,0,0,0,4,12,16,40.909449,-73.844595,10550
882839,0,0,0,4,12,16,40.851453,-73.905712,10453
739169,0,0,0,60,0,60,41.931714,-74.033531,12401
243836,0,0,0,220,0,220,40.597476,-73.948293,11229
411236,0,0,0,44,0,44,41.381669,-73.714243,10541
42628,16,27,39,20,0,102,42.892504,-78.687433,14043
43730,0,0,0,135,0,135,40.601189,-73.657942,11558
517361,0,0,0,4,12,16,43.205867,-75.436353,13440
354484,0,0,0,4,12,16,42.761641,-73.918548,12303
21945,0,0,0,2,12,14,42.920244,-78.805159,14215
872160,0,0,0,4,12,16,43.231799,-76.292557,13135
41738,0,0,0,70,0,70,41.123138,-74.121796,10901
30032,0,0,0,4,12,16,42.948751,-78.809744,14215
837305,0,0,0,2,6,8,43.186525,-77.619285,14621
722583,0,0,0,177,0,177,40.665835,-73.918238,11212
230290,0,0,0,4,12,16,40.633782,-73.892307,11236
799507,0,0,0,4,12,16,40.866577,-73.92616,10034
753105,0,0,0,4,12,16,40.663642,-73.983227,11215
716680,0,0,0,40,0,40,41.520069,-74.242382,12549
550192,0,0,0,44,0,44,42.921723,-78.746126,14225
20120,0,0,0,4,12,16,41.034309,-73.786838,10607
44700,0,12,18,0,0,30,40.894705,-72.380774,11968
342091,0,0,0,2,6,8,44.216914,-75.798706,13691
835420,0,0,0,2,6,8,42.964365,-73.668651,12170
879232,0,0,0,0,10,10,40.832952,-73.908518,10456
684922,30,36,53,0,0,119,42.702831,-73.860883,12203
177729,0,0,0,40,0,40,42.26344,-78.679326,14731
717959,0,0,0,4,12,16,40.826498,-73.893144,10459
780704,0,0,0,85,0,85,40.722577,-73.976275,10009
833323,0,0,0,4,12,16,40.874138,-73.904792,10463
761144,0,0,0,4,12,16,40.625608,-73.936481,11210
880191,0,0,0,4,12,16,40.663374,-73.990532,11215
786809,0,0,16,11,0,27,42.062684,-74.306765,12464
747940,0,0,0,4,12,16,40.639606,-73.904954,11236
840494,0,0,0,4,12,16,40.848129,-73.935989,10033
821044,0,0,0,4,12,16,40.856617,-73.903993,10453
878132,0,0,0,4,12,16,40.929221,-72.680627,11901
453399,0,0,0,4,12,16,40.821518,-73.906164,10456
858421,0,0,0,4,12,16,40.643958,-73.582915,11520
369681,0,0,0,180,0,180,40.841587,-73.875175,10460
650897,0,0,0,158,0,158,40.688182,-73.932453,11221
800070,0,0,0,2,12,14,40.826917,-73.90554,10456
842954,16,10,14,10,0,50,43.235732,-76.308421,13135
72887,0,0,0,140,0,140,40.903208,-73.903822,10471
805891,8,24,19,38,0,89,42.941785,-74.16814,12010
592633,0,0,0,40,0,40,43.118777,-73.750759,12866
709653,0,0,0,120,0,120,40.675644,-73.816953,11420
368452,0,0,0,2,6,8,40.829853,-73.922667,10452
668998,0,0,0,2,12,14,40.874994,-73.875197,10467
724756,0,0,0,4,12,16,40.659645,-73.589,11520
66789,0,0,0,2,5,7,40.831194,-73.936061,10039
8291,0,0,0,4,12,16,44.713975,-73.565663,12962
546887,0,0,0,4,12,16,40.665125,-73.881696,11208
759022,0,0,0,4,12,16,40.839581,-73.912138,10457
849744,0,0,0,4,12,16,40.831114,-73.918343,10456
73895,0,0,0,105,0,105,40.736707,-73.77805,11365
382596,0,0,0,120,0,120,40.827038,-73.818645,10465
41574,0,0,0,44,0,44,42.887249,-73.921674,12302
876405,0,0,0,4,12,16,40.767885,-73.804224,11358
881987,0,0,0,4,12,16,40.827183,-73.881002,10472
854094,0,0,0,4,12,16,40.841476,-73.84626,10461
297829,0,0,0,2,6,8,40.742405,-73.249892,11706
590388,0,0,0,2,6,8,41.121596,-74.068971,10952
853986,0,0,0,4,12,16,40.705788,-73.594513,11553
816757,0,0,0,2,12,14,40.823883,-73.890354,10459
468567,0,0,0,21,0,21,43.023817,-74.034481,12074
644946,12,12,33,0,0,57,41.289424,-73.839897,10567
879898,0,0,0,4,12,16,43.044173,-76.085382,13214
224300,0,0,0,2,12,14,40.822333,-73.893671,10459
274823,0,0,0,120,0,120,40.676462,-73.977442,11217
312387,0,0,0,4,12,16,40.603482,-73.965323,11223
73540,0,0,0,199,0,199,40.797597,-73.963776,10025
738245,0,0,0,4,12,16,40.864546,-73.888966,10458
363716,0,0,0,4,12,16,40.865541,-73.920224,10034
564252,0,0,0,2,12,14,40.834017,-73.904693,10456
325307,0,0,0,4,12,16,40.64746,-73.903648,11236
64214,0,0,0,2,6,8,40.718079,-73.979263,10002
231546,0,0,0,4,12,16,40.707842,-73.335006,11702
751070,0,0,0,4,12,16,40.712414,-73.582835,11553
853195,0,0,0,4,12,16,40.867672,-73.892056,10458
262390,0,0,0,4,12,16,40.645713,-73.949825,11226
827065,0,0,0,2,12,14,44.686099,-75.499268,13669
873594,0,0,0,4,12,16,40.891997,-73.857498,10466
709909,0,0,0,240,0,240,40.824195,-73.936879,10039
614435,0,0,0,0,12,12,40.862063,-73.900664,10468
525144,0,0,108,54,0,162,41.398082,-73.616061,10509
39211,16,36,35,0,0,87,42.681864,-73.808047,12240
798675,0,0,0,4,12,16,40.658431,-73.678888,11563
444540,0,0,18,0,0,18,44.241245,-74.486406,12986
879731,0,0,0,2,6,8,43.325743,-78.551564,14012
659439,0,0,0,44,0,44,42.866223,-73.792649,12065
487630,0,0,0,2,6,8,40.759074,-73.934395,11106
332538,0,0,0,162,0,162,40.724525,-73.777169,11423
755829,0,0,0,23,0,23,40.676832,-73.790586,11434
125236,0,0,0,222,0,222,40.770187,-73.894004,11370
250533,0,0,0,2,6,8,40.861227,-73.900902,10468
805656,0,44,61,0,0,105,40.701258,-73.343107,11704
675683,0,0,0,4,12,16,40.88161,-73.866568,10467
881554,0,0,0,4,12,16,40.698088,-73.911445,11237
244588,0,0,0,160,0,160,40.749291,-73.821547,11355
480074,0,0,0,4,12,16,40.594975,-73.962247,11223
714430,0,0,0,2,6,8,40.933685,-73.886799,10701
41894,0,0,0,60,0,60,40.712564,-73.531866,11554
24470,0,0,0,2,6,8,43.782985,-75.485169,13367
141972,0,0,20,20,0,40,42.919996,-77.612084,14485
45277,0,0,0,30,0,30,42.661726,-73.75751,12210
487315,0,0,0,4,12,16,40.639547,-74.080818,10301
139435,0,0,0,2,6,8,43.00165,-74.363736,12095
859480,0,0,0,4,12,16,40.800299,-73.943874,10035
358976,0,0,0,2,12,14,40.830918,-73.92714,10452
798420,0,0,24,0,0,24,42.652432,-73.696741,12144
588004,0,12,202,70,0,284,43.137881,-77.735239,14624
72754,0,0,0,4,12,16,40.623265,-74.163876,10303
626469,0,0,0,4,12,16,40.697205,-73.930417,11221
308223,0,0,0,2,12,14,40.855713,-73.902112,10453
2896,0,0,0,2,6,8,42.446601,-75.078074,13820
44095,0,0,0,40,0,40,40.9175,-73.8086,10803
100092,0,0,0,2,12,14,40.688383,-73.937161,11221
39341,16,20,55,29,0,120,41.502969,-73.981297,12508
693275,0,0,0,4,12,16,40.625055,-74.003406,11219
582844,0,0,0,192,0,192,40.674501,-73.960582,11238
276211,0,0,0,4,12,16,40.695404,-73.612969,11550
566092,0,0,0,2,6,8,42.71301,-73.673329,12180
44838,0,0,0,75,0,75,40.799346,-73.505195,11791
875145,0,0,0,4,12,16,40.58626,-73.961047,11235
41379,0,21,38,0,0,59,41.039038,-73.696234,10577
679086,0,0,0,0,10,10,40.820856,-73.858169,10473
709555,0,0,0,111,0,111,40.732424,-73.982633,10003
588591,0,0,0,2,6,8,42.10913,-75.952478,13790
855853,0,0,0,4,12,16,40.665399,-73.61513,11510
148919,0,0,0,2,6,8,40.67076,-73.726977,11580
793482,0,0,0,2,6,8,43.104614,-79.03095,14305
42084,0,41,109,11,0,161,40.877997,-73.641684,11542
811814,0,0,0,4,12,16,41.011964,-73.665086,10573
597804,0,0,0,4,12,16,40.610971,-74.141745,10314
440155,0,0,0,4,12,16,41.516998,-74.240042,12549
781410,0,0,0,4,12,16,40.596765,-73.746028,11691
723857,24,30,75,0,0,129,43.060283,-77.46734,14534
821350,0,0,0,4,12,16,40.755541,-73.911021,11377
869029,0,0,0,4,12,16,40.617436,-73.978374,11204
30896,0,0,0,4,12,16,41.199478,-73.966628,10927
652188,0,0,0,114,0,114,42.571174,-77.704855,14437
876649,0,0,0,2,12,14,43.079768,-76.126727,13208
816243,0,0,0,60,0,60,40.845013,-73.084805,11720
425121,0,0,0,272,0,272,43.10005,-77.568226,14618
852531,0,0,0,33,0,33,40.680087,-73.841393,11417
330126,0,0,0,2,12,14,40.668547,-73.761464,11413
794077,0,0,0,4,12,16,40.830935,-73.912827,10456
450921,0,0,0,4,12,16,40.66181,-73.89702,11207
874249,0,0,0,4,12,16,40.83991,-73.709015,11050
494854,0,0,0,58,0,58,40.887992,-73.253272,11754
867061,0,0,0,2,12,14,40.893145,-73.858701,10466
720759,0,0,0,180,0,180,40.862178,-73.919041,10034
840640,0,0,0,2,12,14,40.850241,-73.868462,10462
833903,0,0,0,4,12,16,40.697104,-73.944075,11206
878290,0,0,0,4,12,16,40.828089,-73.877305,10472
518452,0,0,0,4,12,16,40.853786,-73.929201,10040
246812,0,9,109,0,0,118,42.902399,-78.867215,14203
42043,8,10,29,0,0,47,42.119017,-75.906628,13902
350352,0,0,0,70,0,70,42.609961,-73.859221,12054
658283,0,0,0,4,12,16,40.693797,-73.613824,11550
72210,0,0,0,4,12,16,40.6935,-73.830731,11418
686217,0,0,0,0,12,12,40.836155,-73.917135,10452
843257,0,0,0,4,12,16,40.893801,-73.84766,10466
812321,0,0,0,2,6,8,43.244474,-77.645878,14616
825128,0,0,0,60,0,60,43.050689,-75.381743,13323
453450,0,0,0,2,6,8,44.002815,-75.988722,13615
880971,8,22,12,0,0,42,40.663814,-73.549713,11566
790050,8,10,37,0,0,55,41.599507,-73.919194,12590
548008,0,0,0,4,12,16,40.832137,-73.900549,10456
879384,0,0,0,4,12,16,40.868107,-73.894493,10468
829545,0,0,0,120,0,120,43.054972,-74.327946,12078
882697,0,0,0,4,12,16,40.84863,-73.94035,10033
837691,16,20,30,29,0,95,42.909958,-77.699316,14414
858204,0,0,0,20,0,20,42.201753,-76.056652,13802
832874,0,0,0,0,12,12,40.826095,-73.917077,10451
848891,0,0,0,4,12,16,40.867896,-73.895484,10468
821441,0,0,0,4,12,16,40.686821,-73.756307,11412
570638,0,0,0,4,12,16,40.652009,-73.728895,11422
426433,8,46,35,0,0,89,43.028372,-78.821684,14228
877892,16,21,32,14,0,83,42.906893,-78.854361,14208
613980,0,0,0,57,0,57,40.732402,-74.003147,10014
843748,0,0,0,4,12,16,43.096847,-73.584242,12871
841467,0,0,0,114,0,114,40.788722,-73.06909,11741
285268,0,0,0,248,0,248,40.84654,-73.935534,10033
38352,0,0,0,2,6,8,43.134259,-76.122001,13212
435191,0,0,0,4,12,16,40.864007,-73.924383,10034
40389,8,12,24,0,0,44,40.845952,-73.053645,11784
629941,0,0,0,4,12,16,40.688378,-73.778045,11434
784496,0,0,0,4,12,16,40.595002,-73.761715,11691
669309,0,0,15,140,0,155,42.91086,-78.754439,14225
270917,0,0,0,4,12,16,40.707825,-73.81014,11435
806970,0,0,0,29,0,29,40.69005,-73.959668,11205
700497,0,0,0,4,12,16,40.861045,-73.050231,11784
847327,0,0,0,4,12,16,40.959025,-73.876379,10703
41025,24,15,39,30,0,108,42.570064,-79.101639,14081
764489,0,0,0,180,0,180,40.813965,-73.900255,10455
794988,0,0,0,4,12,16,44.280375,-73.984295,12946
869245,0,0,0,4,12,16,42.015655,-73.99593,12449
687867,0,0,0,4,12,16,40.756036,-73.94489,11101
801213,16,24,93,38,0,171,42.99383,-75.956884,13104
326283,0,0,0,4,12,16,40.834494,-73.853052,10462
521691,0,0,0,4,12,16,40.624478,-74.005417,11219
280088,0,0,0,4,12,16,40.650831,-73.928153,11203
40171,0,0,96,0,0,96,41.121337,-73.937027,10989
593241,0,0,0,4,12,16,40.612405,-73.750339,11096
303463,0,0,0,2,12,14,40.808924,-73.914027,10454
832875,0,0,0,2,12,14,40.827093,-73.874219,10472
380963,0,0,0,4,12,16,43.024165,-76.163196,13207
794862,0,0,0,4,12,16,40.887365,-73.862153,10466
361964,16,12,32,4,0,64,42.986717,-78.47685,14001
277324,0,0,0,2,12,14,40.831614,-73.921635,10452
234169,0,0,0,4,12,16,40.643259,-74.084183,10301
267166,0,0,0,62,0,62,40.843684,-73.784915,10464
672359,0,0,0,4,12,16,40.670415,-73.880089,11208
32982,0,0,0,2,6,8,42.591693,-76.089606,13101
852948,0,0,0,4,12,16,41.453192,-74.416719,10940
608390,0,0,0,4,12,16,40.65849,-73.938389,11203
730105,0,0,0,2,6,8,40.675379,-73.60631,11510
872462,0,46,14,0,0,60,43.170439,-77.541453,14609
860222,0,0,0,98,0,98,40.809383,-73.917947,10454
792289,0,0,0,4,12,16,40.7308,-73.349879,11704
752032,0,0,0,144,0,144,43.216977,-77.428402,14580
754889,0,0,0,2,12,14,40.811909,-73.901647,10455
71652,0,0,0,2,12,14,40.869899,-73.887003,10458
682531,0,0,0,245,0,245,40.796508,-73.930218,10035
121797,0,0,0,143,0,143,40.636827,-74.117345,10310
26270,0,0,0,0,12,12,42.521703,-75.522771,13815
735573,0,0,0,4,12,16,40.726029,-73.465612,11735
400261,0,0,0,4,12,16,40.594544,-73.758546,11691
845680,0,0,0,4,12,16,40.851898,-73.93397,10033
249447,0,0,0,4,12,16,40.595488,-73.943151,11229
800752,0,0,0,4,12,16,40.830677,-73.874701,10472
34773,0,0,0,2,6,8,40.813005,-72.873257,11967
15689,0,0,0,4,12,16,40.794257,-72.872603,11967
377176,0,0,0,2,12,14,40.650316,-73.96267,11226
387188,0,0,0,4,12,16,40.70791,-73.603626,11550
802214,0,0,0,2,6,8,43.24821,-77.711602,14612
870974,0,0,0,2,6,8,43.049296,-74.329409,12078
843545,0,0,0,4,12,16,40.640177,-74.011613,11220
402847,0,0,0,4,12,16,40.608629,-74.065755,10305
844525,0,0,0,4,12,16,40.82994,-73.426991,11743
720105,0,0,0,2,6,8,40.721996,-73.974857,10009
306638,0,0,0,4,12,16,40.631471,-73.90768,11236
759574,0,0,0,80,0,80,40.618962,-73.924553,11234
689579,0,0,0,240,0,240,40.821615,-73.919321,10451
28622,0,0,0,4,12,16,40.944071,-73.88985,10703
28901,0,0,0,2,6,8,43.097218,-77.440528,14450
503,0,0,0,2,10,12,42.592069,-76.094354,13101
825205,0,0,0,84,0,84,40.730401,-73.618357,11530
879992,0,0,0,4,12,16,40.825081,-73.939711,10039
32190,0,0,0,4,12,16,40.74582,-73.535614,11801
416162,0,0,0,100,0,100,40.65739,-73.501048,11783
369930,0,0,0,4,12,16,40.681913,-73.75072,11413
172956,0,0,0,4,12,16,40.643063,-74.084025,10301
17820,0,0,0,4,12,16,41.094026,-73.917924,10960
42434,0,0,0,40,0,40,43.96223,-75.905567,13601
41484,0,0,0,77,0,77,42.142128,-76.930053,14814
450045,0,0,0,4,12,16,40.67733,-73.980512,11217
478379,0,0,0,2,6,8,42.442583,-76.505631,14850
139799,0,0,0,44,0,44,42.619105,-73.69502,12061
19082,0,0,0,2,6,8,42.321327,-79.58417,14787
389649,0,0,0,220,0,220,40.775113,-73.818499,11354
786148,0,0,0,2,6,8,44.219621,-75.710078,13673
865817,0,0,0,4,12,16,42.146567,-75.942386,13905
842809,16,24,42,0,0,82,42.503346,-76.291039,13053
555836,0,0,0,4,12,16,40.576891,-74.001893,11224
795988,0,0,0,4,12,16,40.752488,-73.50949,11801
57240,0,0,0,2,6,8,40.869296,-73.903124,10468
50302,0,0,0,0,6,6,40.753385,-73.827644,11355
839878,16,24,36,113,0,189,43.0874,-77.5453,14534
653620,0,0,0,4,12,16,40.832205,-73.929048,10452
873553,16,48,56,24,0,144,40.738698,-73.47744,11714
537300,0,0,0,2,6,8,40.860698,-73.900533,10468
873332,16,19,24,10,0,69,41.327474,-73.685623,10589
867968,0,0,0,4,12,16,40.646235,-73.90373,11236
741995,0,0,0,250,0,250,40.705791,-74.013095,10004
35968,0,0,0,2,6,8,41.464995,-74.178769,12575
423771,0,0,0,2,12,14,40.847774,-73.902773,10457
791451,16,24,98,15,0,153,41.195675,-73.881862,10520
115052,0,8,21,15,0,44,41.596979,-73.912382,12590
72399,0,0,0,4,12,16,40.552821,-74.168312,10312
475384,0,0,0,225,0,225,40.820073,-73.944798,10030
571597,8,19,0,0,0,27,40.696831,-73.326157,11702
850752,0,0,0,40,0,40,43.153223,-76.329969,13027
74153,0,0,0,380,0,380,40.652819,-74.004684,11232
528295,0,0,0,4,12,16,43.186407,-77.636002,14613
718817,0,0,0,4,12,16,40.813298,-73.88732,10474
836300,0,0,0,2,6,8,41.68249,-73.926387,12601
775973,0,0,0,0,12,12,40.834687,-73.867475,10472
510595,0,9,28,0,0,37,40.887865,-73.79181,10803
663830,0,0,0,4,12,16,40.68552,-73.948866,11216
199442,0,0,0,4,12,16,40.689235,-73.920204,11221
881028,0,0,0,0,12,12,40.821367,-73.899492,10459
339131,0,0,0,288,0,288,40.821852,-73.862932,10473
877801,0,0,0,4,12,16,40.85701,-73.902735,10453
609487,0,0,0,108,0,108,40.672907,-73.878417,11208
495929,0,0,0,4,12,16,40.694339,-73.928755,11221
170155,0,0,0,4,12,16,41.046781,-73.787589,10603
414060,0,27,112,0,0,139,40.694361,-73.564563,11566
861604,0,0,0,4,12,16,40.682277,-73.912106,11233
308990,0,0,0,4,12,16,40.649792,-73.632342,11572
649517,12,10,31,0,0,53,40.673805,-73.507246,11793
799044,0,0,0,4,12,16,40.634542,-73.985671,11219
414418,0,0,0,4,12,16,40.812304,-73.908243,10455
873240,0,12,24,0,0,36,41.41776,-73.955963,10516
881718,0,12,40,0,0,52,40.99393,-73.877424,10706
299331,0,0,0,2,6,8,43.066355,-76.122578,13206
875407,0,0,0,4,12,16,40.689662,-73.866241,11421
865748,0,0,0,4,12,16,40.614205,-74.006861,11228
784751,0,0,0,4,12,16,40.8882,-73.8344,10466
339128,0,0,0,228,0,228,40.755886,-73.924032,11106
638201,0,0,15,146,0,161,40.784765,-73.972549,10024
406505,0,0,18,0,0,18,41.198104,-73.963138,10927
819520,0,0,0,4,12,16,40.621485,-74.029859,11209
39837,0,0,0,80,0,80,40.68579,-73.485219,11783
30579,0,0,0,2,6,8,42.278909,-77.216643,14879
553918,0,0,0,2,6,8,40.848929,-73.921994,10453
457996,0,0,0,4,12,16,40.68273,-73.927699,11233
37436,0,0,0,2,6,8,42.681336,-77.07367,14527
41520,0,0,0,60,0,60,42.855232,-73.790586,12065
767186,0,0,0,2,6,8,42.949489,-77.349632,14425
681425,0,0,0,4,12,16,40.806576,-73.954009,10026
281855,0,0,0,4,12,16,40.785302,-73.81624,11357
851976,0,0,0,2,10,12,43.186955,-77.600538,14621
359860,0,0,0,2,6,8,43.165713,-76.14982,13041
679008,0,0,0,115,0,115,40.766196,-73.930338,11106
882521,0,0,0,20,0,20,40.648158,-73.892733,11236
791040,0,0,0,2,6,8,40.756184,-73.368833,11798
842138,0,0,0,4,12,16,40.877851,-73.860136,10467
815336,0,0,0,4,12,16,40.850197,-73.91391,10453
367588,0,0,0,4,12,16,40.690841,-73.858028,11421
24895,0,0,0,2,6,8,40.73755667,-73.36336,11704
431993,0,0,0,4,12,16,40.696181,-73.915716,11221
437504,0,0,0,2,12,14,40.859535,-73.894457,10458
827667,0,0,0,4,12,16,40.812335,-73.952637,10027
855425,0,0,0,4,12,16,40.845716,-73.866518,10462
876143,0,0,52,0,0,52,40.716841,-73.524292,11756
507343,0,0,0,2,6,8,41.149216,-74.196486,10974
384716,0,0,0,2,6,8,44.772101,-73.487002,12901
777754,0,0,0,4,12,16,40.638986,-73.591993,11520
697785,0,0,0,4,12,16,40.85065,-73.931111,10033
792966,0,0,0,4,12,16,40.838616,-73.870333,10460
878510,0,0,0,40,0,40,40.816417,-73.869801,10473
529776,0,0,0,20,0,20,42.724158,-73.690764,12180
245127,16,22,14,27,0,79,42.940544,-78.838222,14214
690122,0,0,0,4,12,16,40.676116,-73.924076,11233
39462,16,34,50,30,0,130,42.883023,-78.708393,14043
400876,0,0,0,2,6,8,42.218682,-78.271731,14727
52794,0,0,0,2,6,8,40.861077,-73.908728,10468
835843,8,15,21,0,0,44,41.691901,-73.920823,12601
806610,0,0,0,4,12,16,40.67683,-73.657067,11552
102071,0,0,0,4,12,16,40.832471,-73.402315,11746
518899,0,0,0,2,12,14,40.842097,-73.925132,10452
819478,0,0,0,4,12,16,40.705076,-73.915893,11237
394141,0,0,0,4,12,16,40.84401,-73.91821,10452
880386,0,0,0,4,12,16,40.831102,-73.904393,10456
621236,0,0,0,4,12,16,41.041359,-73.752001,10604
803945,0,0,44,0,0,44,43.248262,-75.458624,13440
386679,0,0,0,2,12,14,40.81395,-73.949502,10027
787299,0,0,0,4,12,16,40.669277,-73.877875,11208
150605,0,0,0,4,12,16,40.786264,-73.211831,11722
352734,0,0,0,4,12,16,41.046122,-73.760776,10603
877116,0,0,0,4,12,16,40.842722,-73.871111,10460
229433,0,0,0,88,0,88,40.748836,-73.99981,10001
684506,0,0,0,4,12,16,40.664133,-73.890771,11207
809714,0,0,0,4,12,16,40.640487,-73.996371,11219
572486,0,0,0,0,10,10,40.80507,-73.918274,10454
580437,0,0,0,2,6,8,43.0821,-78.999749,14304
877735,0,0,0,4,12,16,40.692564,-73.948362,11206
364833,0,0,0,2,6,8,40.670682,-73.935801,11213
877387,0,0,16,0,0,16,42.181617,-75.622417,13787
73206,0,0,0,210,0,210,40.656279,-73.951479,11226
696093,0,0,0,4,12,16,40.707608,-73.713228,11003
243057,0,0,0,4,12,16,40.925769,-73.799245,10801
44220,0,0,0,82,0,82,40.669031,-73.4726,11758
42290,0,0,0,76,0,76,40.707081,-73.651571,11552
39707,16,48,63,55,0,182,43.20996,-77.952143,14420
327761,0,0,0,4,12,16,40.657298,-73.908713,11212
841074,0,0,0,4,12,16,40.76002,-73.872941,11369
71149,0,0,0,4,12,16,40.733141,-73.791231,11365
687009,0,0,0,4,12,16,40.640248,-73.9905,11219
594442,0,0,0,4,12,16,40.84432,-73.911911,10452
612658,0,0,0,2,12,14,40.840878,-73.914067,10452
41129,0,0,0,130,0,130,42.755193,-73.861815,12205
785687,0,0,0,4,12,16,40.861654,-73.928316,10040
768576,0,0,0,4,12,16,43.048475,-76.125153,13210
838515,0,0,0,94,0,94,40.612663,-73.951736,11210
819714,0,0,0,2,6,8,40.849494,-73.886033,10457
872540,0,0,0,4,12,16,40.642237,-74.018879,11220
791252,0,0,0,2,6,8,43.110484,-75.161931,13502
878749,0,0,0,4,12,16,40.698884,-73.60916,11550
737294,0,0,0,2,6,8,42.599501,-73.720831,12144
854614,0,0,0,154,0,154,40.622114,-74.078513,10304
43430,0,0,0,125,0,125,41.327947,-73.688502,10589
577001,0,0,0,2,12,14,40.830395,-73.894495,10459
111790,0,0,0,20,0,20,42.455125,-76.03784,13803
40641,0,12,36,0,0,48,43.010232,-78.637532,14032
697242,0,0,0,4,12,16,40.838315,-73.903355,10457
204460,15,12,16,63,0,106,41.113992,-74.141958,10901
726087,0,0,0,4,12,16,40.591337,-73.956693,11235
820456,0,0,0,4,12,16,43.18486,-77.600302,14621
663268,0,0,0,4,12,16,40.826503,-73.823713,10465
873812,0,0,0,50,0,50,43.151248,-76.195433,13090
562237,0,0,0,4,12,16,42.434988,-79.346211,14063
868247,0,0,0,36,0,36,40.678543,-73.77367,11434
661000,0,0,0,2,6,8,43.182324,-77.64411,14613
43212,0,24,64,0,0,88,42.814278,-73.91984,12304
699678,0,0,0,4,12,16,43.18745,-77.587661,14621
834740,0,0,0,4,12,16,40.848938,-73.919761,10453
873502,0,0,0,2,6,8,43.189353,-77.596173,14621
263049,0,0,0,4,12,16,43.052494,-77.58968,14467
45122,0,10,30,0,0,40,43.031241,-73.365925,12816
103452,0,0,0,2,12,14,40.676995,-73.73916,11413
779425,0,0,91,363,0,454,41.085755,-74.005965,10954
39197,0,0,0,70,0,70,42.701502,-73.901406,12084
44433,0,0,0,44,0,44,43.16554,-78.675866,14094
259483,0,0,0,4,12,16,40.79656,-73.947532,10029
154383,0,0,0,2,6,8,40.8309,-73.94578,10031
870643,0,0,0,4,12,16,40.628406,-74.156447,10303
670082,0,0,0,4,12,16,40.614249,-73.954477,11230
209460,0,0,0,4,12,16,40.64601,-73.908962,11236
597016,0,0,0,4,12,16,40.605055,-73.997082,11214
708264,8,12,143,75,0,238,40.7352,-73.5019,11756
874951,0,10,92,0,0,102,41.00663,-73.763094,10605
766177,0,0,0,2,6,8,40.820713,-73.893996,10459
817710,0,0,0,4,12,16,40.8882,-73.8344,10466
305818,0,0,0,4,12,16,43.110272,-75.277075,13495
726271,0,0,0,4,12,16,40.880001,-73.850875,10469
624426,0,0,18,0,0,18,43.664411,-73.784536,12817
243326,0,0,0,2,12,14,40.86705,-73.918893,10034
284379,0,24,304,0,0,328,40.852706,-73.376906,11743
319122,0,0,0,4,12,16,40.689892,-73.846547,11421
847957,0,0,34,0,0,34,41.37434,-74.684926,12771
734097,0,0,0,4,12,16,41.041367,-73.971267,10962
548501,0,0,0,4,12,16,42.051834,-78.356316,14760
127130,0,0,0,4,12,16,40.687468,-73.729172,11411
521239,0,0,0,0,12,12,40.840085,-73.914233,10452
492541,0,0,0,4,12,16,40.845389,-73.884105,10460
268478,8,12,122,80,0,222,42.258969,-79.511742,14757
567292,0,0,0,52,0,52,40.678213,-73.398163,11726
41658,0,0,0,44,0,44,42.555338,-73.808281,12158
879073,0,0,0,4,12,16,40.964369,-73.869522,10710
433540,0,0,0,4,12,16,40.683028,-73.822814,11419
387481,0,0,0,2,10,12,43.185882,-77.61311,14621
836504,0,0,0,2,12,14,40.855037,-73.868574,10462
356355,0,0,0,4,12,16,40.657662,-73.905882,11212
778931,0,0,0,4,12,16,40.632249,-73.609349,11510
823468,0,0,0,4,12,16,40.683627,-73.776819,11434
763189,32,62,97,0,0,191,40.641582,-73.666243,11518
176401,0,0,0,2,6,8,42.865649,-78.742807,14227
42728,24,20,46,40,0,130,43.005663,-76.144667,13205
880634,0,0,0,2,6,8,40.825435,-73.878565,10472
694058,0,0,0,4,12,16,40.730543,-73.849327,11375
40542,0,38,74,0,0,112,40.920697,-73.793272,10801
249096,0,0,0,4,12,16,40.758371,-73.336125,11729
72082,0,0,0,4,12,16,40.661845,-73.768979,11434
346022,0,0,0,2,12,14,40.835556,-73.917113,10452
545201,0,0,0,2,6,8,40.833549,-73.90075,10456
880590,0,0,0,4,12,16,40.828135,-73.852427,10472
602999,0,0,0,0,12,12,40.75366,-73.873254,11372
757348,0,0,0,70,0,70,40.981741,-73.818937,10583
671066,0,0,0,4,12,16,40.85055,-73.919557,10453
795862,0,0,85,0,0,85,43.050608,-74.357575,12078
866711,0,0,0,4,12,16,40.86611,-73.901802,10468
876227,0,0,0,4,12,16,41.700569,-73.90925,12601
404589,0,0,0,104,0,104,40.612238,-74.0008,11214
232925,0,0,83,0,0,83,40.76406,-73.01562,11772
838785,0,0,0,2,6,8,41.486591,-74.056247,12553
869697,0,0,0,2,6,8,40.870995,-73.898479,10468
318928,0,0,0,4,12,16,40.740238,-73.352739,11704
499485,0,0,0,4,12,16,40.830138,-73.877766,10472
688576,0,0,0,0,12,12,40.863907,-73.923638,10034
39998,8,26,30,0,0,64,43.017223,-76.116605,13244
670794,0,0,0,4,12,16,40.846043,-73.910429,10453
43467,24,36,32,21,0,113,42.865457,-76.981709,14456
837412,0,0,0,2,12,14,40.884255,-73.898071,10463
146381,0,0,0,40,0,40,43.980343,-75.655599,13619
40779,0,0,39,0,0,39,42.505677,-78.48009,14042
873416,8,11,24,10,0,53,43.074047,-73.764354,12866
871471,0,0,0,4,12,16,40.930339,-73.797128,10804
643928,0,0,0,4,12,16,40.572456,-74.096868,10306
709657,0,0,0,360,0,360,40.697083,-73.78693,11433
840185,0,0,0,0,10,10,40.82972,-73.886684,10459
820233,0,0,0,4,12,16,40.849732,-73.917014,10453
877267,0,0,0,60,0,60,44.085333,-75.807646,13637
40933,0,0,0,46,0,46,43.130629,-77.550099,14610
200916,0,0,0,57,0,57,40.657237,-73.608681,11510
878848,0,0,0,2,12,14,40.87339,-73.905362,10463
818992,0,0,0,4,12,16,40.694437,-73.912781,11221
859163,0,0,0,4,12,16,40.760669,-73.535278,11801
238856,8,0,67,38,0,113,43.164833,-77.580271,14609
44194,0,0,0,60,0,60,40.773549,-73.344963,11746
727449,16,12,26,14,0,68,40.894111,-73.006039,11727
709699,0,0,0,126,0,126,40.70767,-73.785549,11433
801927,0,0,0,170,0,170,40.740838,-73.85419,11368
269202,0,0,0,150,0,150,40.814883,-73.380244,11746
834466,0,0,0,33,0,33,40.550599,-74.211314,10309
797994,0,0,0,4,12,16,40.538306,-74.184656,10312
330856,0,0,0,4,12,16,42.93471,-78.819267,14215
823943,0,0,0,4,12,16,40.864754,-73.889221,10458
539742,0,0,0,2,12,14,40.86877,-73.893963,10468
813167,0,0,0,4,12,16,40.669679,-73.878581,11208
823374,0,0,0,4,12,16,42.202918,-75.870857,13901
364144,0,0,0,105,0,105,40.782276,-73.233238,11717
880678,0,0,0,2,6,8,40.883105,-73.885047,10467
855025,32,40,62,30,0,164,43.239025,-77.694799,14616
542628,0,0,0,4,12,16,40.614507,-73.962025,11230
42689,0,48,103,0,0,151,40.823733,-73.479988,11797
881077,0,0,0,4,12,16,40.878464,-73.88121,10467
828426,0,0,0,4,12,16,43.212474,-77.587658,14617
851135,0,0,0,2,6,8,43.058254,-76.217987,13209
349274,0,0,0,2,12,14,40.665727,-73.864416,11208
553050,0,0,0,4,12,16,40.924068,-73.893524,10705
662156,0,0,0,4,12,16,40.817534,-73.819974,10465
143712,0,0,0,2,6,8,40.822702,-73.939889,10039
559257,0,0,0,4,12,16,40.835022,-73.913237,10456
54378,0,0,0,0,6,6,40.850402,-73.905758,10453
73711,0,0,0,150,0,150,40.76112,-73.723237,11362
664775,0,0,0,2,6,8,41.6601,-74.5977,12738
841580,0,0,0,2,6,8,42.087925,-79.22393,14701
530741,0,0,0,2,6,8,43.19497,-76.101423,13039
14079,0,0,0,2,5,7,42.340582,-79.307198,14718
359950,0,0,0,2,6,8,43.207961,-77.71257,14626
822730,0,0,0,2,6,8,40.591114,-73.800165,11692
576937,0,0,0,0,10,10,40.797588,-73.947387,10029
874019,0,0,0,4,12,16,40.833139,-73.904975,10456
882311,0,0,0,240,0,240,40.808019,-73.925811,10454
236010,0,0,0,4,12,16,40.66949,-73.889331,11207
875648,0,0,0,4,12,16,43.144108,-73.417114,12865
682837,0,0,0,4,12,16,40.856117,-73.928184,10040
247931,0,0,0,202,0,202,40.699424,-73.903804,11385
871753,0,24,42,0,0,66,42.862536,-73.794394,12065
746578,25,40,86,0,0,151,40.809201,-73.515766,11791
41415,8,9,20,7,0,44,41.649664,-73.934689,12601
748955,0,0,0,4,12,16,40.880634,-73.017099,11727
864932,14,24,36,9,0,83,40.786159,-73.458918,11803
847709,0,0,15,131,0,146,40.771206,-73.738827,11363
559350,0,0,0,4,12,16,40.878588,-73.868345,10467
740114,0,0,0,4,12,16,41.718754,-74.393198,12428
418260,0,0,0,2,6,8,42.632007,-73.768224,12202
868737,0,0,0,2,6,8,43.063896,-77.588843,14534
874574,0,0,50,0,0,50,43.0345,-76.020674,13066
42247,0,0,0,95,0,95,43.093001,-78.95251,14304
758088,0,30,0,0,0,30,40.954052,-73.783347,10804
106833,0,0,0,2,6,8,40.700208,-73.914056,11237
662023,0,0,0,4,12,16,40.680944,-73.999649,11231
679832,0,0,0,4,12,16,40.695277,-73.896685,11385
228270,0,0,0,4,12,16,40.90304,-73.840877,10550
712173,0,0,0,4,12,16,40.672146,-73.805091,11420
42514,0,0,0,40,0,40,42.104794,-75.939699,13905
777570,0,0,36,0,0,36,43.98196,-75.910336,13601
844319,0,0,0,4,12,16,40.650996,-73.58153,11520
39312,0,0,30,0,0,30,42.218888,-73.810614,12534
43710,16,22,27,4,0,69,43.118204,-78.697636,14094
817109,0,0,0,2,6,8,40.816405,-73.938873,10037
132476,0,0,0,155,0,155,40.655016,-73.525233,11710
824251,0,0,0,4,12,16,40.808883,-73.940589,10027
39183,16,24,45,0,0,85,42.657373,-73.756005,12220
691459,0,0,0,2,6,8,40.838464,-73.917555,10452
668233,0,0,0,4,12,16,40.68337,-73.876669,11208
40510,0,28,65,0,0,93,40.945063,-73.842812,10708
203448,8,24,64,0,0,96,43.108111,-77.407869,14450
41791,0,0,0,40,0,40,43.178108,-73.735003,12831
862373,0,9,28,0,0,37,40.925557,-73.835698,10552
551631,0,0,0,4,12,16,40.853336,-73.916201,10453
762720,0,0,0,4,12,16,40.830472,-73.902734,10456
882289,0,0,0,45,0,45,40.651334,-73.913936,11236
796838,0,0,0,4,12,16,40.782146,-73.221845,11717
706703,0,0,0,4,12,16,40.848121,-73.919288,10453
821335,0,0,0,4,12,16,40.877013,-73.885812,10468
827830,0,0,0,189,0,189,40.886035,-73.840575,10466
797482,0,0,0,125,0,125,44.193677,-75.965238,13656
41009,0,0,0,33,0,33,43.323113,-73.639524,12801
873904,0,0,21,0,0,21,41.499233,-73.960647,12508
500442,0,0,0,4,12,16,43.186527,-77.619755,14621
294571,0,0,0,0,12,12,40.875966,-73.85424,10469
41047,0,0,0,130,0,130,40.709037,-73.572901,11554
44758,0,0,119,0,0,119,43.312219,-73.641337,12801
222233,0,0,0,4,12,16,40.704619,-73.884792,11385
700018,0,0,48,0,0,48,41.511338,-73.958833,12508
868452,0,12,14,6,0,32,43.163799,-77.582859,14609
178839,6,14,36,0,0,56,41.021342,-73.74016,10605
721091,0,0,0,2,6,8,40.838214,-73.916333,10452
867194,0,0,0,4,12,16,40.695328,-73.62055,11550
42929,16,24,43,0,0,83,40.789219,-73.536707,11753
632558,0,0,0,115,0,115,40.784381,-73.706075,11030
655336,0,0,0,2,6,8,40.827939,-73.878873,10472
584976,0,0,0,4,12,16,40.819887,-73.910033,10455
160349,0,0,0,4,12,16,40.64042,-73.95392,11226
489057,0,0,0,4,12,16,40.683811,-73.647074,11552
822091,16,58,70,0,0,144,40.839219,-73.320127,11731
788767,0,0,0,4,12,16,40.766968,-73.223679,11717
164861,0,0,0,4,12,16,40.668884,-73.918961,11212
741087,0,0,0,4,12,16,40.751005,-73.31252,11729
651282,0,0,0,4,12,16,40.731063,-73.825783,11367
311056,0,0,0,4,12,16,40.840573,-73.864416,10462
837036,0,0,0,4,12,16,40.839818,-73.880463,10460
822320,0,0,0,0,12,12,40.838509,-73.925118,10452
250169,0,0,0,4,12,16,42.592925,-76.099875,13101
55282,0,0,0,1,6,7,40.855352,-73.897897,10457
244519,0,0,0,120,0,120,40.693874,-73.915154,11221
881183,0,0,0,4,12,16,40.692964,-73.905949,11237
39624,0,0,20,20,0,40,43.136916,-77.560289,14618
543415,0,0,0,4,12,16,40.831657,-73.88812,10460
276124,0,0,0,4,12,16,41.031398,-73.780962,10606
399045,0,0,0,4,12,16,40.640217,-73.953446,11226
818440,0,0,0,4,12,16,40.614249,-73.954477,11230
117157,0,0,0,140,0,140,40.689247,-73.917312,11221
875822,0,0,0,4,12,16,40.876459,-73.873918,10467
769339,0,0,20,0,0,20,43.280757,-76.069608,13167
138600,8,21,21,13,0,63,42.253276,-77.790593,14802
836870,0,0,0,2,6,8,42.839646,-77.572716,14485
838010,0,0,0,2,6,8,43.191112,-77.62835,14613
35276,0,0,0,4,12,16,40.689271,-73.58687,11575
43980,16,10,58,20,0,104,42.945156,-76.396993,13152
617788,16,16,0,0,0,32,41.109471,-74.046032,10977
857157,0,0,0,4,12,16,40.673888,-73.984121,11215
379597,0,0,0,203,0,203,40.523303,-74.185923,10312
776271,0,0,0,126,0,126,40.691959,-73.852963,11421
268079,0,0,0,2,12,14,40.884678,-73.860571,10467
853273,0,0,0,4,12,16,40.686021,-73.868839,11208
116967,0,0,0,200,0,200,40.621975,-73.995165,11204
761017,0,0,0,100,0,100,40.709807,-73.94391,11206
44917,0,0,0,80,0,80,40.703015,-73.330505,11702
872896,0,0,0,4,12,16,40.847484,-73.908899,10453
263465,0,0,0,4,12,16,40.683192,-73.949612,11216
731344,0,0,0,4,12,16,40.844471,-73.910185,10457
665569,0,10,53,0,0,63,40.811404,-73.343154,11746
213247,0,0,0,4,12,16,40.882342,-73.862019,10467
698748,0,0,0,4,12,16,40.841537,-73.911252,10457
648667,0,0,0,2,6,8,40.805476,-73.950561,10026
782467,0,0,0,4,12,16,40.900034,-73.786765,10805
336705,0,0,0,4,12,16,40.637765,-73.948346,11210
44941,16,31,10,0,0,57,40.865758,-73.595442,11560
866479,0,0,0,4,12,16,42.096499,-76.795052,14901
811210,0,0,0,4,12,16,40.697323,-73.910656,11237
765750,0,0,0,4,12,16,42.468914,-74.896542,13750
40257,14,11,31,20,0,76,42.911836,-76.796261,13148
351001,0,0,0,2,6,8,42.641017,-73.77596,12209
730628,0,0,0,4,12,16,40.656537,-73.910499,11212
857592,0,0,0,4,12,16,43.179041,-75.562916,13478
874172,0,0,0,4,12,16,42.806112,-73.941074,12307
788162,0,0,0,0,12,12,40.834466,-73.900943,10456
881524,0,0,0,4,12,16,40.655845,-73.954761,11226
805017,0,0,0,4,12,16,40.628361,-73.949906,11210
44104,0,0,0,60,0,60,42.64195,-73.756539,12202
39375,0,15,41,0,0,56,41.689008,-73.890421,12604
536585,0,0,0,2,6,8,40.81815,-73.917068,10455
605547,0,0,0,4,12,16,40.738964,-73.869186,11373
270497,0,0,0,4,12,16,41.699808,-73.971762,12528
652385,32,40,47,0,0,119,42.866189,-73.773145,12065
872238,0,0,0,0,10,10,40.843193,-73.918122,10452
249594,0,0,0,4,12,16,42.74217,-78.893828,14075
410362,0,0,0,4,12,16,40.836764,-72.87649,11967
832357,0,0,0,2,6,8,42.877708,-77.009848,14456
742769,0,0,0,160,0,160,40.825116,-73.905919,10456
72809,0,0,0,100,0,100,40.640824,-74.000648,11220
702279,0,0,0,2,6,8,42.576223,-76.239483,13045
722322,0,0,0,145,0,145,40.696767,-73.897239,11385
41997,0,0,0,44,0,44,42.98259,-78.863603,14223
842753,0,0,0,148,0,148,40.679734,-73.689957,11580
481938,0,0,0,4,12,16,40.593106,-73.945149,11235
878449,0,0,0,4,12,16,43.087314,-77.437754,14450
253357,0,0,0,4,12,16,40.672119,-73.818178,11420
231300,0,0,0,190,0,190,40.712559,-73.962233,11211
258312,0,0,0,4,12,16,42.719017,-78.00859,14530
618265,0,0,0,4,12,16,40.86608,-73.891185,10458
427478,0,0,0,4,12,16,40.84279,-73.906506,10457
339149,0,0,0,294,0,294,40.63491,-73.89736,11236
64447,0,0,0,2,6,8,40.801245,-73.961999,10025
342654,16,24,20,40,0,100,42.965941,-78.830143,14223
220873,0,0,0,4,12,16,40.593524,-73.773449,11691
739040,0,0,0,0,12,12,40.846158,-73.932726,10033
72829,0,0,0,88,0,88,40.85467,-73.852866,10461
507913,0,0,0,2,6,8,40.841406,-73.936001,10032
534342,0,0,0,4,12,16,40.871241,-73.898752,10468
880832,0,0,0,4,12,16,42.945866,-78.865111,14216
762331,0,0,0,119,0,119,40.815358,-73.944209,10030
810561,0,0,0,160,0,160,40.736492,-73.851844,11375
674062,0,0,0,4,12,16,40.660789,-73.898334,11207
310950,0,0,0,4,12,16,41.361519,-74.115628,10930
870153,0,0,0,0,10,10,43.011576,-76.159484,13207
795799,14,32,54,20,0,120,40.651936,-73.571838,11520
879587,0,0,0,4,12,16,40.697203,-73.893846,11385
40354,0,0,0,72,0,72,40.820845,-73.145588,11779
64053,0,0,0,2,6,8,40.718973,-73.992404,10002
880453,0,12,106,0,0,118,41.420756,-73.576821,10509
602478,0,0,0,4,12,16,40.707825,-73.81014,11435
73422,0,0,0,77,0,77,40.713158,-73.991349,10002
183741,0,0,0,2,6,8,42.926349,-76.556441,13021
397188,0,0,0,4,12,16,40.823722,-73.864128,10473
366856,0,0,0,4,12,16,40.711973,-73.772644,11423
868854,0,0,0,20,0,20,40.693329,-73.755759,11412
709804,0,0,0,359,0,359,40.84932,-73.858871,10462
43114,16,36,73,20,0,145,42.890328,-77.286384,14424
875384,0,0,0,4,12,16,40.951056,-73.78953,10804
767835,0,0,0,4,12,16,40.856066,-73.883667,10458
825379,0,0,0,140,0,140,40.739097,-73.985452,10010
596891,0,0,0,2,6,8,40.59622,-73.764092,11691
39972,0,10,39,38,0,87,43.03041,-76.002441,13066
656649,0,0,0,0,12,12,40.698542,-73.795575,11433
695057,0,0,0,4,12,16,40.641499,-73.948372,11226
218472,0,0,0,2,6,8,41.921255,-74.235521,12461
876861,12,20,42,20,0,94,41.988257,-73.995311,12449
669871,0,0,0,4,12,16,40.836966,-73.919221,10452
356810,0,0,0,2,12,14,40.672551,-73.905507,11212
523804,0,0,16,84,0,100,42.967482,-78.759541,14221
670250,0,0,0,4,12,16,40.661296,-73.914562,11212
493975,0,0,0,2,6,8,41.12286,-74.036733,10977
799638,0,0,0,0,8,8,40.831048,-73.922718,10452
826422,0,0,0,2,6,8,40.881689,-73.013222,11727
138540,0,0,0,2,12,14,40.795238,-73.943095,10029
40570,0,20,67,0,0,87,41.279128,-73.78923,10598
770454,0,0,0,4,12,16,40.82327,-73.91598,10451
636927,0,0,0,4,12,16,40.849138,-73.864823,10462
73081,0,0,0,26,0,26,40.667128,-73.951829,11225
656363,0,0,0,0,12,12,40.829855,-73.906587,10456
512250,0,0,0,4,12,16,40.838315,-73.903355,10457
736456,0,0,0,4,12,16,40.878138,-72.996614,11727
55992,0,0,0,2,5,7,40.823663,-73.890335,10459
441684,0,0,0,0,12,12,41.109191,-74.035671,10954
39606,16,22,30,30,0,98,42.920637,-75.812036,13035
676539,0,0,0,2,6,8,43.180842,-77.58405,14621
820954,0,0,0,4,12,16,40.894227,-73.831866,10550
839174,0,0,0,4,12,16,40.768007,-73.823843,11354
229996,8,12,14,7,0,41,42.7723,-74.0924,12056
711933,0,0,0,100,0,100,41.515049,-74.390347,10919
296984,0,0,0,4,12,16,40.619781,-74.082967,10304
391560,0,0,0,2,6,8,40.835187,-73.918927,10452
438603,0,24,120,20,0,164,40.766482,-73.022955,11772
752823,0,0,0,4,12,16,40.826296,-73.905818,10456
828973,0,0,0,60,0,60,42.986652,-78.181212,14020
552402,0,0,0,4,12,16,40.844707,-73.942288,10032
42396,24,60,114,0,0,198,42.153321,-77.055463,14830
758579,0,0,0,281,0,281,40.822076,-73.907219,10456
862225,0,0,0,4,12,16,40.91392,-73.846764,10550
824361,0,0,0,4,12,16,40.9528,-73.881717,10703
834264,0,0,0,4,12,16,40.708185,-73.442257,11735
329194,0,0,0,4,12,16,40.67536656,-73.93669416,11213
42957,16,36,46,0,0,98,41.070087,-73.784366,10595
744669,0,0,0,2,12,14,40.840878,-73.914067,10452
361146,0,0,0,4,12,16,40.64042,-73.95392,11226
72444,0,0,0,4,12,16,40.734879,-73.854208,11375
676472,0,0,0,4,12,16,40.715155,-73.590772,11553
709919,0,0,0,218,0,218,40.839427,-73.935913,10032
378664,0,0,0,58,0,58,42.614357,-76.189157,13045
814819,0,0,0,0,10,10,40.825269,-73.85191,10473
131465,24,36,60,0,0,120,42.72293,-73.936175,12303
294785,0,12,21,0,0,33,42.486407,-76.576786,14850
40945,0,0,0,141,0,141,43.143014,-77.527938,14625
606920,0,0,0,4,12,16,42.887824,-77.289944,14424
852758,0,0,0,4,12,16,40.846419,-73.850787,10461
523803,0,0,0,130,0,130,43.032939,-78.728327,14051
798863,0,0,0,2,6,8,40.846586,-73.915633,10453
822955,0,0,18,0,0,18,42.780963,-73.671535,12182
267316,0,0,0,300,0,300,40.612328,-73.986868,11204
410015,0,0,0,2,10,12,40.672362,-73.759175,11413
659169,0,0,0,4,12,16,40.726041,-73.464486,11735
41627,0,0,0,100,0,100,41.148977,-73.983851,10956
733429,0,0,0,4,12,16,42.539407,-73.939422,12067
738312,0,11,48,0,0,59,41.001946,-73.880292,10706
486296,0,0,0,134,0,134,40.749943,-73.885164,11372
816996,0,0,0,4,12,16,43.01942,-75.037226,13357
750921,0,0,0,4,12,16,42.457416,-76.425758,14850
222726,0,0,0,4,12,16,40.632706,-73.911249,11236
732481,0,0,0,4,12,16,42.037591,-74.268625,12457
647710,0,0,0,35,0,35,44.683223,-73.454429,12901
814292,8,20,37,13,0,78,42.912808,-78.696456,14043
634366,0,0,0,148,0,148,40.662488,-73.945888,11225
315059,0,0,0,2,6,8,43.47744,-76.358714,13126
874737,0,0,0,350,0,350,40.64203,-74.019034,11220
18594,0,0,0,2,6,8,42.792791,-73.991765,12306
787823,8,12,32,0,0,52,40.66913,-73.529501,11710
614885,0,0,0,154,0,154,40.764875,-73.871148,11369
709904,0,0,0,136,0,136,40.819312,-73.956843,10027
600933,0,0,0,4,12,16,42.703873,-73.968044,12009
7656,0,0,0,4,12,16,41.017103,-73.767935,10606
849470,0,0,0,4,12,16,40.705521,-73.598687,11553
667862,0,0,0,4,12,16,44.629104,-73.557838,12985
408910,0,0,0,4,12,16,43.196365,-77.640787,14615
866639,0,0,0,2,6,8,43.014377,-77.401687,14564
876923,0,0,36,0,0,36,43.100552,-76.149186,13211
522442,0,0,0,4,12,16,40.873107,-73.902905,10463
687390,0,0,0,4,12,16,40.673825,-73.581717,11575
406334,0,0,0,153,0,153,43.155853,-77.483644,14526
753905,0,0,0,4,12,16,42.849128,-73.691119,12188
843104,24,60,84,30,0,198,43.164083,-76.197045,13041
876256,0,0,0,4,12,16,40.704217,-73.601938,11550
876874,0,0,0,4,12,16,43.205861,-77.637585,14615
839306,0,0,0,4,12,16,40.835992,-73.94133,10032
872929,0,0,0,4,12,16,40.67481,-73.888804,11207
615249,0,0,0,0,12,12,41.083329,-73.864745,10591
460899,0,0,0,4,12,16,40.902102,-73.855084,10470
336171,0,0,0,4,12,16,40.830701,-73.948426,10031
848999,0,0,0,2,6,8,43.193477,-77.626449,14615
131746,0,0,0,2,6,8,43.441148,-76.551637,13126
467916,16,16,68,0,0,100,42.945024,-78.795262,14215
675331,0,0,0,2,12,14,40.841636,-73.915666,10452
368946,0,0,0,40,0,40,40.642348,-73.906252,11236
755232,0,0,18,26,0,44,42.892742,-78.688193,14043
841740,0,0,0,2,6,8,40.85366,-73.927045,10040
876757,0,0,0,2,6,8,42.91484,-78.897171,14213
744759,0,0,0,60,0,60,40.815118,-73.909727,10455
830964,15,22,28,18,0,83,42.68141,-78.564252,14080
547314,8,24,38,0,0,70,42.519482,-73.617351,12123
788606,0,0,0,4,12,16,40.88079,-73.862318,10467
841386,0,0,0,4,12,16,40.80306,-73.9504,10026
712712,0,0,0,0,6,6,40.817086,-73.905346,10455
620046,0,0,0,4,12,16,40.828558,-73.899254,10459
866959,0,0,0,4,12,16,40.889857,-73.852832,10466
875047,0,0,0,4,12,16,40.682021,-73.828918,11419
845170,0,0,16,110,0,126,40.794541,-73.969043,10025
756198,0,0,0,4,12,16,40.762414,-73.933814,11106
792635,0,0,0,4,12,16,40.633533,-73.958147,11230
845788,0,0,0,4,12,16,40.867857,-73.920072,10034
850255,0,0,0,4,12,16,40.644455,-73.612525,11510
856595,16,36,63,44,0,159,40.886398,-72.921974,11953
502212,0,0,0,2,6,8,40.802898,-73.951374,10026
793944,0,0,0,4,12,16,40.84501,-73.879617,10460
649096,0,0,0,4,12,16,40.825748,-73.951276,10031
853721,0,0,0,4,12,16,40.842379,-73.87124,10460
21553,0,0,0,2,6,8,43.174984,-75.193571,13502
429103,0,0,0,2,12,14,40.682375,-73.773888,11434
545513,0,0,0,2,6,8,40.860734,-73.868264,10467
860035,0,0,0,4,12,16,40.788608,-73.97083,10024
420095,0,0,0,30,0,30,40.857076,-73.909951,10453
375497,0,0,0,224,0,224,40.614061,-74.00655,11228
226972,0,0,0,4,12,16,40.662814,-73.893329,11207
725021,0,0,0,4,12,16,40.871999,-73.880128,10467
41866,0,0,36,0,0,36,43.084829,-76.857566,14433
735460,0,0,0,4,12,16,40.610593,-73.76774,11691
797080,0,0,0,2,6,8,40.854946,-73.896145,10457
103677,0,0,0,2,6,8,40.708593,-73.391225,11757
627131,0,0,0,4,12,16,43.179926,-77.613284,14621
564171,0,0,0,2,6,8,43.024514,-74.99305,13350
841470,0,0,0,77,0,77,40.8096,-73.0439,11742
773169,0,0,0,4,12,16,40.83238,-73.921183,10452
73559,0,0,0,202,0,202,40.714323,-73.995529,10002
800204,0,0,0,4,12,16,41.033403,-73.780631,10606
849307,0,0,0,4,12,16,40.81061,-73.85314,10473
241405,0,17,51,8,0,76,40.694405,-73.691224,11003
254740,0,0,0,2,6,8,40.760893,-73.526722,11801
42857,0,0,18,0,0,18,42.662743,-73.754711,12210
9171,0,0,0,2,10,12,41.109273,-73.928166,10989
125388,0,0,0,2,6,8,41.855023,-74.101538,12419
71586,0,0,0,2,12,14,40.855713,-73.902112,10453
43034,0,0,0,116,0,116,41.323757,-73.860019,10547
882928,0,0,0,4,12,16,40.911216,-73.899402,10471
821523,0,0,0,4,12,16,40.830935,-73.922774,10452
504436,0,0,0,4,12,16,40.601771,-74.003353,11214
822393,0,0,0,0,10,10,40.854998,-73.914936,10453
386082,0,0,0,4,12,16,40.723955,-73.818486,11367
864675,0,0,0,2,6,8,42.106434,-79.241121,14701
749903,0,0,62,89,0,151,42.93925,-73.653825,12170
22987,0,0,0,2,6,8,44.841671,-74.289641,12953
829833,0,0,0,4,12,16,40.817633,-73.814202,10465
45212,0,0,0,60,0,60,42.643618,-73.742093,12144
812142,0,0,0,4,12,16,40.652481,-73.91851,11236
857060,0,0,0,4,12,16,40.73688,-73.862549,11368
272259,0,0,0,4,12,16,41.1352,-74.057,10977
825892,0,0,0,4,12,16,40.641511,-73.930125,11203
392386,0,0,0,0,12,12,40.827535,-73.887839,10459
275675,0,0,0,4,12,16,40.637785,-74.130433,10302
709615,0,0,0,350,0,350,40.711581,-73.871468,11379
31169,0,0,0,4,12,16,42.176111,-77.067246,14830
128506,0,0,0,2,5,7,40.810951,-73.945502,10027
567083,0,0,0,0,5,5,40.790886,-73.969188,10025
882618,0,24,20,18,0,62,42.811025,-73.892939,12309
315370,0,0,0,90,0,90,43.085091,-78.989497,14304
40754,0,0,0,214,0,214,42.153032,-77.063922,14830
837813,0,0,0,4,12,16,40.554342,-74.168656,10312
700402,0,0,0,2,6,8,42.806993,-73.937908,12307
718134,0,0,0,4,12,16,40.788345,-73.978066,10024
220496,0,0,0,160,0,160,42.959601,-74.366354,12068
125864,0,0,0,310,0,310,40.836126,-73.904558,10456
657811,0,0,0,4,12,16,40.66038,-73.991536,11215
464873,0,0,0,0,12,12,40.848011,-73.906045,10457
242574,0,0,0,4,12,16,40.665307,-73.921655,11212
837682,0,0,0,4,12,16,41.105602,-74.114942,10901
804183,0,0,0,4,12,16,42.919867,-78.811318,14215
360544,0,0,0,4,12,16,40.723784,-73.871079,11379
875196,0,0,0,4,12,16,40.712571,-73.95661,11211
683782,0,0,0,4,12,16,40.701966,-73.886524,11385
793414,0,0,0,0,12,12,43.034125,-76.162232,13204
39486,6,10,11,7,0,34,42.95314,-78.905843,14207
882047,29,65,104,0,0,198,40.912794,-73.780741,10801
603270,0,0,0,4,12,16,40.821838,-73.956389,10031
872115,0,0,0,4,12,16,40.914839,-73.88937,10705
787388,0,0,0,0,10,10,40.871739,-73.877187,10467
423107,0,0,0,4,12,16,40.845906,-73.880308,10460
42109,16,24,39,15,0,94,43.130817,-76.206083,13090
781121,0,0,0,4,12,16,40.634113,-73.948174,11210
724036,0,0,0,2,12,14,40.846975,-73.895217,10457
864099,0,0,0,2,6,8,42.677517,-74.494966,12043
650464,0,0,0,4,12,16,42.92878,-77.384572,14564
441260,0,0,0,2,6,8,40.82929,-73.894792,10459
829640,0,0,0,4,12,16,40.695556,-73.621169,11550
806393,0,0,0,120,0,120,40.708754,-73.939801,11206
858094,0,0,0,2,6,8,41.170878,-74.188292,10974
728089,0,0,0,4,12,16,40.637557,-74.167219,10303
72477,0,0,0,4,12,16,40.690857,-73.754632,11412
67012,0,0,0,0,5,5,40.845641,-73.934402,10033
412930,0,0,0,109,0,109,43.014227,-78.784751,14068
730553,0,0,0,4,12,16,43.182746,-77.5763,14621
878399,0,0,0,2,10,12,43.17326,-77.64637,14606
372917,16,12,26,20,0,74,44.929038,-74.89253,13662
184327,0,0,0,4,12,16,40.788218,-73.641048,11577
73863,0,0,0,290,0,290,40.63104,-74.126953,10310
701340,0,0,0,2,6,8,42.082588,-79.239364,14701
394751,0,0,0,0,6,6,40.819795,-73.918434,10451
723614,0,0,0,4,12,16,40.827127,-73.878684,10472
877052,5,12,37,8,0,62,40.694725,-73.604812,11553
43925,0,0,0,200,0,200,41.041202,-73.771631,10603
882833,0,0,0,4,12,16,40.713527,-73.616196,11550
875561,0,0,0,2,6,8,42.764801,-73.944511,12303
742375,0,0,0,4,12,16,40.633199,-73.92574,11234
848777,0,0,0,4,12,16,44.6409,-75.413874,13654
407368,0,0,0,4,12,16,40.705115,-73.907546,11385
39827,0,0,0,147,0,147,40.689322,-73.530024,11710
426265,0,0,0,4,12,16,40.75271,-73.478558,11714
803514,0,0,0,4,12,16,40.813228,-73.937072,10037
582422,0,0,0,4,12,16,40.865054,-73.893138,10458
691786,0,0,0,4,12,16,41.53373,-73.728487,12582
205210,0,0,15,0,0,15,42.69248,-74.932032,13326
733566,0,0,0,4,12,16,40.822911,-73.878028,10473
808596,0,0,0,4,12,16,40.823459,-73.902656,10456
622288,0,0,0,4,12,16,42.831666,-78.725682,14224
869606,0,0,0,4,12,16,41.172127,-73.86538,10562
876322,0,0,0,112,0,112,40.952446,-73.816291,10709
880926,0,0,0,4,12,16,40.653783,-73.747276,11422
874426,0,0,0,4,12,16,40.833044,-73.910967,10456
38121,0,0,0,4,12,16,42.076795,-78.446742,14760
40407,4,5,11,12,0,32,41.775232,-74.708329,12754
562794,0,0,0,4,12,16,40.665028,-73.889875,11207
790160,0,0,44,0,0,44,40.653828,-73.628441,11572
161375,0,0,0,2,6,8,42.839034,-73.971511,12302
308598,0,0,0,2,10,12,42.811176,-78.843607,14218
673152,0,0,0,4,12,16,40.677898,-73.978133,11217
462266,0,0,0,4,12,16,40.772787,-73.232623,11717
874618,0,0,0,2,6,8,43.150265,-77.626085,14608
355564,0,0,0,4,12,16,40.82009,-73.893478,10459
445407,0,0,0,2,12,14,40.684601,-73.939678,11221
370781,0,0,0,4,12,16,40.851781,-73.915732,10453
13342,0,0,0,2,6,8,42.989336,-76.110545,13078
16349,0,0,0,2,6,8,43.13019,-75.224584,13502
266935,0,0,0,4,12,16,41.704359,-74.078967,12561
333506,0,0,0,4,12,16,40.857716,-73.909275,10453
377839,0,0,0,0,10,10,40.870304,-73.850332,10469
828625,0,0,0,4,12,16,40.697442,-73.847027,11418
797244,0,0,0,0,12,12,40.853767,-73.898663,10457
719706,0,0,0,4,12,16,40.626144,-74.020496,11209
713549,0,0,0,4,12,16,40.872651,-73.885312,10458
828277,0,0,0,4,10,14,43.183972,-77.589882,14621
52405,0,0,0,2,6,8,40.727939,-73.99838,10012
843471,0,0,0,4,12,16,40.93272,-73.888469,10701
761664,0,0,0,2,6,8,40.896072,-73.835456,10550
29794,0,0,0,2,6,8,43.017234,-75.052833,13357
27477,0,0,0,2,5,7,40.948367,-73.88386,10703
73671,0,0,0,267,0,267,40.758676,-73.824384,11355
327330,8,12,18,0,0,38,42.829145,-78.765026,14224
706053,0,0,0,4,12,16,40.636909,-73.973398,11218
838195,0,31,33,0,0,64,40.676751,-73.669883,11565
861942,0,0,0,52,0,52,40.837603,-73.927985,10452
852317,0,0,0,4,12,16,40.766502,-73.563626,11590
852156,0,0,0,4,12,16,41.268055,-73.944732,10511
816858,0,0,0,4,12,16,40.771347,-73.814646,11354
333806,0,12,39,0,0,51,41.018918,-73.870218,10522
245779,0,0,0,332,0,332,40.855004,-73.903508,10453
421370,0,0,0,4,12,16,40.765172,-73.923741,11102
539309,0,0,0,4,12,16,40.85354,-73.902287,10457
837631,0,0,0,4,12,16,40.824356,-73.845454,10473
800712,0,0,0,116,0,116,40.726536,-73.807074,11366
485666,0,0,0,2,12,14,40.842716,-73.892266,10457
774519,0,0,0,4,12,16,40.859913,-73.907287,10468
741692,0,0,0,4,12,16,40.852285,-73.886023,10458
663859,0,0,0,2,6,8,40.844029,-73.86829,10460
39773,16,20,60,0,0,96,43.100297,-77.613983,14623
807528,0,0,0,20,0,20,42.591466,-76.100756,13101
879183,0,0,0,2,6,8,40.852358,-73.902144,10457
460503,0,0,0,4,12,16,40.878545,-72.999231,11727
239475,0,0,0,2,6,8,42.341295,-77.314099,14810
256426,0,0,0,4,12,16,40.723862,-73.818786,11367
234451,0,0,0,4,12,16,40.635232,-73.906926,11236
840921,0,0,0,177,0,177,40.681265,-73.956958,11238
631889,0,0,0,0,6,6,40.839973,-73.91472,10452
41495,16,33,69,0,0,118,42.733325,-73.846026,12205
321176,0,0,0,2,6,8,40.664324,-73.928791,11212
537007,16,25,36,32,0,109,42.750065,-78.896817,14075
376529,0,0,0,4,12,16,40.766781,-73.872024,11369
741989,0,0,0,235,0,235,40.770415,-73.950906,10075
478767,0,0,0,4,12,16,40.677405,-73.845338,11417
520641,0,0,0,4,12,16,40.836275,-73.946914,10032
844241,0,0,0,4,12,16,40.838241,-73.944744,10032
867811,0,0,0,4,12,16,41.219378,-73.996671,10980
854929,0,0,0,4,12,16,40.608135,-73.954471,11229
732314,0,0,0,82,0,82,40.815413,-73.888451,10474
339619,0,0,0,144,0,144,40.755974,-73.868754,11368
325027,0,0,0,2,12,14,40.819004,-73.939162,10030
51275,0,0,0,2,5,7,40.852688,-73.93046,10033
625654,0,0,0,2,12,14,40.846873,-73.915531,10453
797925,0,0,182,0,0,182,42.851287,-73.759218,12065
597224,0,0,0,4,12,16,40.639061,-73.957114,11226
628824,0,0,0,4,12,16,40.87603,-73.903146,10463
653958,0,0,0,240,0,240,40.601343,-73.985859,11223
855189,0,0,0,4,12,16,40.665126,-73.754719,11413
524583,0,0,0,4,12,16,40.869951,-73.884988,10458
709739,0,0,0,240,0,240,40.842601,-73.916238,10452
755023,0,0,0,2,12,14,40.701926,-73.931614,11206
35596,0,0,0,2,6,8,43.188391,-76.375488,13027
862538,0,0,0,40,0,40,40.658636,-73.928569,11203
444354,0,0,0,4,12,16,40.668697,-73.953539,11225
791548,0,0,0,4,12,16,40.866452,-73.922951,10034
413145,0,0,0,60,0,60,40.938085,-72.940287,11778
871129,16,40,65,0,0,121,42.910092,-78.875529,14222
196731,0,0,0,4,12,16,40.846759,-73.923743,10453
459435,0,0,0,4,12,16,40.834655,-73.080416,11779
74123,0,0,0,15,0,15,40.695271,-73.987306,11201
291187,0,0,0,4,12,16,44.601737,-75.169579,13617
865955,0,0,0,4,12,16,40.669791,-73.743523,11413
39692,8,12,120,39,0,179,43.136929,-77.607212,14620
134369,0,0,0,229,0,229,40.806809,-73.955706,10026
466686,0,0,0,4,12,16,40.693305,-73.995298,11201
58733,0,0,0,0,6,6,40.833462,-73.921587,10452
874535,0,0,0,0,12,12,40.81548,-73.924625,10451
590981,0,0,0,4,12,16,40.828135,-73.852427,10472
42562,0,0,32,12,0,44,40.683572,-73.379474,11757
809944,0,0,0,4,12,16,40.632742,-74.01917,11220
844924,0,0,0,4,12,16,40.837991,-73.848734,10462
792875,0,0,0,2,6,8,43.084199,-75.256817,13501
807226,0,0,0,4,12,16,42.945618,-78.810678,14215
451367,0,0,0,2,12,14,40.710539,-73.757288,11423
854354,0,0,0,0,12,12,40.663133,-73.990053,11215
137178,0,0,0,0,12,12,40.591446,-73.659431,11561
846975,0,0,0,60,0,60,40.862152,-73.920828,10034
718403,0,0,0,40,0,40,41.691113,-73.859272,12603
229050,0,0,0,2,6,8,42.149258,-75.092877,13856
373958,0,0,0,2,6,8,42.920104,-77.11129,14432
556796,8,12,33,12,0,65,41.334631,-73.871376,10579
256705,0,0,0,217,0,217,40.753123,-73.884779,11372
637604,0,0,0,19,0,19,40.768062,-73.810291,11354
345760,0,0,0,4,12,16,40.642752,-73.932168,11203
557208,0,0,0,0,10,10,43.173454,-77.614128,14605
875940,0,0,40,0,0,40,43.104496,-75.251075,13502
856033,0,0,0,4,12,16,40.801803,-73.962576,10025
584241,0,0,0,4,12,16,40.7483,-73.301685,11706
767201,0,0,0,2,12,14,40.866775,-73.902,10468
692116,0,0,0,2,6,8,43.041923,-76.168292,13204
652721,0,0,0,4,12,16,43.177693,-77.577088,14609
495600,0,0,0,0,12,12,40.852715,-73.911578,10453
777907,0,0,0,2,6,8,42.66668,-73.777836,12206
867872,0,0,0,2,6,8,40.820535,-73.89462,10459
609323,0,0,0,4,12,16,40.626005,-73.974736,11230
842195,0,0,123,0,0,123,43.08367,-77.582101,14623
874071,0,0,0,4,12,16,40.764159,-73.874582,11369
12104,0,0,0,4,12,16,40.920329,-73.791464,10801
42530,0,0,0,75,0,75,40.837693,-73.188658,11787
809261,0,0,0,300,0,300,40.755081,-73.874227,11372
134458,0,0,0,2,6,8,41.522246,-74.228537,12549
784201,0,0,0,4,12,16,40.864147,-73.894105,10458
874479,0,0,81,0,0,81,41.781608,-73.930949,12538
287921,0,0,0,2,6,8,40.835521,-73.91898,10452
759555,0,0,0,4,12,16,40.68127,-73.9274,11233
302150,0,0,0,4,12,16,40.836144,-73.912214,10456
43071,0,18,0,16,0,34,40.781793,-73.001821,11772
827488,0,0,0,2,6,8,40.747845,-73.989419,10001
469607,0,0,0,2,6,8,40.648957,-73.963154,11226
704124,0,0,21,0,0,21,42.161358,-77.068445,14830
603278,0,0,0,110,0,110,40.738077,-73.315885,11703
580132,0,0,0,37,0,37,40.863168,-73.897667,10468
447956,8,16,0,0,0,24,42.593278,-76.179256,13045
42480,0,0,108,0,0,108,40.88414,-72.398055,11968
274613,32,54,48,30,0,164,42.791348,-78.769828,14127
365292,0,0,0,2,6,8,43.271357,-75.471611,13440
173651,16,24,127,25,0,192,43.166972,-77.610061,14605
616797,0,0,0,4,12,16,40.71095,-73.995769,10002
751829,0,0,0,4,12,16,40.66706,-73.593912,11520
600511,0,0,0,2,6,8,41.788927,-74.297636,12446
479444,0,0,0,4,12,16,43.176498,-77.611683,14621
757504,0,0,0,4,12,16,40.879909,-73.871901,10467
729142,0,0,0,4,12,16,40.949936,-73.875148,10701
850872,0,0,0,4,12,16,40.763307,-73.567138,11590
101274,0,0,0,2,6,8,42.104626,-76.022903,13760
257292,0,0,0,4,12,16,40.617892,-74.075004,10304
503716,0,0,0,4,12,16,43.142796,-73.658409,12831
476936,0,0,0,487,0,487,40.719295,-73.875272,11379
44315,7,19,18,15,0,59,42.814386,-78.828147,14218
316887,0,0,0,4,12,16,40.703065,-73.880685,11385
150851,0,0,138,84,0,222,42.112574,-76.051564,13760
710899,0,0,0,4,12,16,40.852844,-73.863153,10462
819498,0,0,0,4,12,16,40.679883,-73.905996,11233
836111,0,0,0,2,6,8,41.035979,-73.791551,10607
33348,0,0,0,4,12,16,41.062873,-74.033153,10965
241651,0,0,0,4,12,16,40.789821,-73.251141,11717
72014,0,0,0,4,12,16,40.637024,-73.97732,11218
40608,8,10,24,0,0,42,42.534766,-78.420558,14009
540568,0,0,0,4,12,16,43.176507,-77.60221,14621
651957,0,11,72,0,0,83,41.018946,-73.765292,10605
729982,8,26,57,20,0,111,40.948353,-72.906334,11786
265941,0,0,0,4,12,16,40.899221,-73.845288,10466
73223,0,0,0,168,0,168,40.669568,-73.892795,11207
878530,0,0,0,4,12,16,40.662441,-73.855517,11414
799188,16,30,45,0,0,91,43.054304,-76.234726,13219
696445,0,0,0,4,12,16,40.689964,-73.915975,11221
877533,0,0,154,0,0,154,40.675156,-73.370038,11757
769733,0,0,0,4,12,16,42.925762,-78.804323,14215
40051,16,24,67,21,0,128,42.876258,-76.98769,14456
143049,0,0,0,23,0,23,40.660006,-73.917722,11212
864216,8,10,16,20,0,54,42.947501,-78.857561,14216
255423,0,0,0,227,0,227,40.806013,-73.94092,10035
820848,0,0,0,2,6,8,42.905611,-76.785439,13148
401087,0,0,0,2,6,8,40.842716,-73.892266,10457
616757,0,0,0,4,12,16,40.692906,-73.918941,11221
709785,0,0,0,86,0,86,40.672846,-73.919755,11233
549386,0,0,0,4,12,16,40.660443,-73.948,11225
774401,0,0,0,4,12,16,40.873154,-73.899859,10468
576168,0,0,0,2,12,14,40.834441,-73.929086,10452
447074,0,0,0,4,12,16,40.841266,-73.910285,10457
867292,0,0,0,15,0,15,40.816901,-73.858308,10473
214425,0,0,0,4,12,16,40.838049,-73.940412,10032
802056,0,0,0,4,12,16,43.030904,-75.139468,13340
860378,0,0,0,2,12,14,40.823553,-73.910007,10451
760212,0,0,0,4,12,16,40.841818,-73.937199,10032
726616,0,0,0,44,0,44,42.585914,-73.714075,12061
794680,0,0,0,100,0,100,43.281369,-76.149369,13036
743968,16,24,59,24,0,123,43.199089,-77.593112,14617
149719,0,0,0,61,0,61,40.898491,-73.808794,10803
766487,0,0,0,4,12,16,40.585774,-73.82055,11694
867664,0,0,20,0,0,20,42.924474,-76.579627,13021
595316,0,0,0,4,12,16,40.704345,-73.884966,11385
705438,0,0,0,4,12,16,40.703557,-73.703025,11003
26475,0,0,0,2,6,8,41.955072,-73.987279,12401
873959,0,0,0,2,6,8,42.296765,-77.74825,14804
867330,0,0,0,4,12,16,40.826874,-73.880933,10472
214942,0,0,0,2,6,8,40.864488,-73.891087,10458
178574,0,0,0,15,0,15,40.747051,-73.888206,11372
72347,0,0,0,2,12,14,40.650887,-73.737009,11422
822803,0,0,117,0,0,117,41.164405,-73.994141,10956
475321,0,0,0,2,12,14,40.856779,-73.903358,10453
882934,0,0,0,4,12,16,40.732457,-73.822634,11367
43273,0,0,0,70,0,70,42.587715,-76.192725,13045
473737,0,0,0,194,0,194,41.102395,-73.800692,10532
190091,0,0,0,4,12,16,40.830097,-73.921286,10452
417619,0,0,0,2,6,8,40.819282,-73.943665,10030
41278,0,23,213,0,0,236,41.711654,-73.935172,12601
660719,8,12,115,0,0,135,42.665188,-73.776803,12206
548699,0,0,0,2,12,14,40.847244,-73.918429,10453
699733,0,0,0,70,0,70,40.638523,-73.665341,11518
40154,0,12,61,0,0,73,41.094998,-73.91818,10960
779147,0,0,0,28,0,28,40.747466,-73.756052,11364
322351,0,0,0,128,0,128,40.700762,-73.993007,11201
865671,0,0,0,0,10,10,40.860717,-73.893911,10458
577758,0,0,0,2,6,8,41.637417,-73.897432,12603
880339,0,12,34,18,0,64,41.073924,-73.814158,10523
713799,0,0,0,40,0,40,41.656241,-73.73465,12540
881141,0,0,0,4,12,16,40.844163,-73.906877,10457
702429,0,0,0,4,12,16,42.781555,-73.672176,12182
646794,0,0,0,2,6,8,43.23051,-77.7409,14626
820539,0,0,0,159,0,159,40.715431,-73.979686,10002
858933,0,0,0,4,12,16,40.730448,-73.849646,11375
838771,0,0,0,2,12,14,40.860869,-73.907648,10468
768937,0,0,0,60,0,60,40.718377,-73.940199,11211
71325,0,0,0,4,12,16,40.626749,-73.942214,11210
820382,0,0,0,2,6,8,44.702573,-73.461187,12901
876490,0,0,0,40,0,40,41.611066,-73.936115,12590
834570,0,0,0,0,10,10,40.678586,-73.594704,11575
737501,0,0,0,4,12,16,42.765092,-77.770066,14454
778809,0,0,0,4,12,16,40.632981,-73.950151,11210
699351,0,0,0,4,12,16,40.665758,-73.762062,11413
825569,0,0,0,0,11,11,40.864445,-73.927837,10040
868111,0,0,0,0,12,12,40.836607,-73.919363,10452
772415,0,0,93,0,0,93,40.661205,-73.550956,11566
40558,0,12,32,0,0,44,41.014777,-73.872491,10522
808123,0,0,0,0,12,12,40.847507,-73.904368,10457
320051,0,0,0,2,12,14,41.431636,-74.442266,10940
870102,0,0,0,40,0,40,40.743536,-73.917796,11104
232835,0,0,0,339,0,339,40.607717,-73.984905,11204
794143,24,69,112,35,0,240,40.768166,-73.531951,11801
725918,0,0,0,4,12,16,40.829834,-73.89402,10459
109425,0,0,0,4,12,16,40.603628,-73.754665,11691
685451,0,0,0,4,12,16,40.890503,-73.862211,10466
725294,0,0,0,4,12,16,40.956258,-73.785806,10804
866045,0,0,0,4,12,16,41.265711,-74.355979,10990
830082,0,0,0,4,12,16,42.798322,-73.917303,12304
509708,0,0,0,2,6,8,42.747557,-73.680656,12180
431770,0,0,0,0,12,12,40.849339,-73.908257,10453
813654,0,0,0,0,5,5,40.691958,-73.42948,11758
499040,0,0,0,40,0,40,44.581096,-73.537462,12972
130473,16,36,48,45,0,145,41.190655,-73.73594,10549
41111,0,0,36,0,0,36,44.688982,-73.506851,12901
40693,8,10,21,0,0,39,42.734255,-73.561601,12180
216691,0,0,0,4,12,16,41.441571,-74.143928,10992
390681,0,0,0,4,12,16,41.117456,-73.772431,10594
694299,0,0,0,4,12,16,40.703028,-73.910876,11385
861479,8,24,46,20,0,98,42.88623,-75.873159,13035
269710,0,0,0,2,6,8,43.333131,-75.746501,13316
650104,0,0,0,4,12,16,40.799489,-73.25105,11717
346237,0,0,0,0,9,9,40.747519,-73.239704,11706
863628,6,15,29,16,0,66,41.739569,-74.019264,12528
671487,0,0,0,4,12,16,42.836622,-73.963241,12302
492134,0,0,0,4,12,16,42.777415,-73.676793,12182
304724,0,0,0,4,12,16,40.680055,-73.86731,11208
167375,0,0,0,4,12,16,40.777433,-73.222525,11717
252276,0,0,0,121,0,121,41.00932,-73.864398,10522
604644,0,0,0,0,12,12,40.842306,-73.892232,10457
689609,0,0,0,87,0,87,40.656269,-73.888578,11207
704030,0,0,0,4,12,16,43.204973,-77.630042,14615
651678,0,0,0,0,12,12,40.746812,-73.858107,11368
785102,0,0,0,4,12,16,40.609462,-73.758329,11691
39785,0,0,0,58,0,58,40.664752,-73.669627,11563
819839,0,0,0,4,12,16,40.850385,-73.902625,10457
612017,0,0,0,4,12,16,40.759929,-73.79404,11358
43650,8,10,88,0,0,106,43.046701,-76.099782,13224
265306,0,0,0,4,12,16,40.661914,-73.59214,11520
847053,0,0,0,4,12,16,40.756928,-73.111414,11716
643633,0,0,0,2,12,14,40.84785,-73.894368,10457
285063,0,0,0,4,12,16,40.740878,-73.8774,11373
171259,0,0,0,4,12,16,43.141195,-76.128479,13212
44495,0,0,0,44,0,44,42.96613,-78.852849,14223
661574,0,0,0,4,12,16,40.725913,-73.984627,10009
846270,0,0,0,145,0,145,40.745218,-73.758097,11364
71821,0,0,0,4,12,16,40.578376,-73.847857,11694
813347,0,0,0,2,6,8,43.259189,-73.289759,12865
693059,0,0,0,4,12,16,40.729743,-74.000909,10012
114767,0,0,0,100,0,100,41.403875,-74.448553,10940
880900,0,0,0,2,6,8,43.142487,-77.594689,14607
842037,0,0,0,2,6,8,42.62504,-73.938549,12186
156512,0,0,0,4,12,16,43.117412,-73.733902,12866
819182,0,0,0,2,6,8,42.660605,-73.817658,12208
881776,8,23,16,0,0,47,40.695609,-73.389937,11757
153328,0,0,0,50,0,50,41.118264,-73.943397,10989
761459,0,0,0,200,0,200,40.805949,-73.935567,10035
877269,0,0,0,60,0,60,44.218745,-75.789464,13691
697882,0,0,0,176,0,176,40.671335,-73.893604,11207
375201,0,0,0,4,12,16,40.674865,-73.867164,11208
338823,0,0,0,2,6,8,40.82127,-73.935398,10039
711039,0,0,0,160,0,160,40.729375,-73.982499,10009
727880,0,0,0,128,0,128,40.861357,-73.891235,10458
435668,0,0,0,366,0,366,40.638528,-73.984594,11218
40345,0,0,0,81,0,81,40.715464,-73.446971,11735
801864,0,0,0,44,0,44,42.883311,-78.778026,14206
863711,0,0,42,630,0,672,40.73897,-73.995105,10011
490384,0,0,0,214,0,214,40.891452,-73.838566,10466
735082,0,0,0,4,12,16,40.857319,-73.901051,10453
72047,0,0,0,4,12,16,40.613544,-73.957076,11230
871513,0,0,0,4,12,16,40.640388,-73.679873,11557
269402,0,0,0,2,6,8,43.225197,-73.513574,12809
218730,0,0,0,2,6,8,42.598976,-77.698316,14437
39797,24,47,84,0,0,155,40.7059,-73.5442,11554
352918,0,0,0,4,12,16,40.830404,-73.89452,10459
39589,16,28,72,30,0,146,43.9743,-75.9097,13601
402174,0,0,0,4,12,16,41.105462,-74.080908,10952
709842,0,0,0,160,0,160,40.618172,-74.028855,11209
864349,12,12,50,0,0,74,41.404436,-74.323341,10924
786477,0,0,0,34,0,34,40.84887,-73.88999,10457
709691,0,0,0,142,0,142,40.814686,-73.856283,10473
43499,16,23,81,13,0,133,40.921412,-72.665339,11901
758210,0,0,0,0,10,10,40.842761,-73.883694,10460
874609,0,0,0,0,12,12,40.831744,-73.906443,10456
696533,0,0,0,4,12,16,40.642642,-73.898264,11236
878797,0,0,0,173,0,173,40.691545,-73.778554,11434
764985,0,16,46,18,0,80,40.820552,-72.628517,11978
792013,8,10,26,0,0,44,42.789867,-73.981281,12306
882467,0,0,0,4,12,16,40.827244,-73.939816,10039
37848,0,0,0,2,5,7,43.013872,-76.146712,13205
837440,0,0,0,4,12,16,40.703326,-73.614319,11550
877494,8,12,90,0,0,110,42.475547,-79.332836,14048
777366,0,0,0,4,12,16,40.704982,-73.947251,11206
854749,0,0,0,4,12,16,40.765952,-73.556421,11590
861013,0,22,21,0,0,43,40.61674,-73.746815,11096
301729,0,0,0,0,6,6,40.82335,-73.89031,10459
707153,0,0,436,0,0,436,40.789242,-73.369072,11746
648455,0,0,0,2,6,8,40.854012,-73.927885,10040
796490,0,0,0,4,12,16,40.828691,-72.713652,11941
502737,0,0,0,4,12,16,40.627377,-74.158057,10303
596016,0,0,0,2,12,14,40.878961,-73.905939,10463
40860,8,8,33,15,0,64,43.972159,-75.911108,13601
27982,0,0,0,2,6,8,42.946663,-78.837319,14214
709286,0,0,0,4,12,16,40.656485,-74.000741,11232
129687,7,12,34,20,0,73,41.443086,-74.055245,12553
628564,16,28,28,0,0,72,43.023859,-78.768735,14068
707869,0,0,0,34,0,34,40.661587,-73.893305,11207
795429,16,20,30,15,0,81,42.834135,-78.636782,14059
264299,0,0,0,2,12,14,40.850663,-73.918013,10453
856613,0,0,0,4,12,16,40.721025,-73.43722,11735
268731,0,0,0,4,12,16,40.682307,-73.946381,11216
339179,0,0,0,280,0,280,40.699098,-73.83547,11418
42227,32,72,39,21,0,164,40.7806,-73.492946,11803
168690,0,0,0,4,12,16,40.611497,-73.981187,11204
789126,0,0,0,2,6,8,40.829853,-73.922667,10452
415587,24,24,28,40,0,116,44.613603,-75.160881,13617
844389,0,0,0,4,12,16,40.661817,-73.892809,11207
709667,0,0,0,128,0,128,40.66287,-73.9921,11215
236895,0,0,0,2,6,8,42.788745,-73.988365,12306
384331,0,0,0,0,12,12,40.799447,-73.961618,10025
43082,0,0,0,44,0,44,42.910693,-73.881261,12019
71341,0,0,0,2,12,14,40.6834,-73.766463,11434
124303,0,0,0,2,6,8,40.723116,-73.974351,10009
783447,0,0,0,4,12,16,40.713441,-73.750976,11429
826967,0,0,0,4,12,16,41.120117,-74.036881,10977
349092,0,0,0,4,12,16,40.621164,-74.073629,10304
471610,0,0,0,4,12,16,40.642275,-73.893657,11236
773821,0,0,0,2,12,14,40.682096,-73.828962,11419
42827,16,26,58,0,0,100,43.010583,-77.453736,14564
739753,0,0,0,4,12,16,40.660653,-73.579391,11520
735833,0,0,0,4,12,16,43.248172,-77.716786,14612
247023,0,0,0,2,5,7,40.69313,-73.913595,11221
646518,0,0,0,4,12,16,40.774933,-73.233124,11717
904985,16,24,36,0,0,76,42.9007,-77.30376,14424
889121,0,0,0,4,12,16,40.842445,-72.869558,11967
891725,0,0,0,2,6,8,43.137392,-77.638749,14619
883703,0,0,0,4,12,16,41.112587,-74.068875,10952
905347,0,0,0,4,12,16,40.848409,-73.905378,10457
914794,0,0,0,4,12,16,40.663759,-73.606534,11510
896308,0,0,0,4,12,16,40.756768,-73.946324,11101
900064,0,0,0,40,0,40,42.162443,-78.692893,14779
893042,0,0,0,4,12,16,40.682655,-73.868786,11208
912338,0,0,0,4,12,16,43.067151,-76.135415,13203
910085,0,0,0,2,6,8,42.3126,-76.773905,14869
899305,0,0,0,0,10,10,40.816031,-73.915986,10455
898249,0,0,0,2,10,12,40.872353,-73.887212,10458
907854,0,0,0,4,12,16,40.635147,-73.993548,11219
890950,0,0,17,0,0,17,42.524801,-75.516381,13815
902022,8,0,8,0,0,16,42.038573,-77.780067,14897
896468,0,0,0,90,0,90,42.954084,-76.425824,13152
900452,0,0,0,4,12,16,40.674153,-73.844243,11417
904075,0,0,0,4,12,16,40.87784,-73.882195,10467
897213,0,0,0,4,12,16,40.782704,-72.841419,11951
888884,0,0,0,4,12,16,40.668293,-73.906711,11212
909870,0,0,0,4,12,16,40.743198,-73.858646,11368
892861,0,0,0,4,12,16,40.74799,-73.861435,11368
897852,0,0,0,4,12,16,40.862214,-73.847997,10469
886489,0,0,0,2,6,8,42.846344,-78.824063,14220
911545,0,0,0,2,6,8,43.168836,-77.655346,14606
896789,0,0,0,90,0,90,40.801221,-72.798686,11934
884501,0,0,0,2,12,14,40.830329,-73.919598,10456
901517,0,0,0,4,12,16,40.848485,-73.403509,11746
894815,0,0,0,4,12,16,43.834589,-73.425747,12883
894578,0,0,0,38,0,38,40.645251,-73.980423,11218
906270,0,0,0,4,12,16,40.765381,-73.786866,11361
906374,0,0,0,4,12,16,40.725034,-73.820019,11367
915054,0,0,0,2,6,8,40.652402,-73.959035,11226
918690,0,0,0,4,12,16,40.813718,-73.930202,10453
890321,0,0,0,4,12,16,40.846996,-73.939673,10033
906725,0,0,0,0,12,12,40.634846,-74.000589,11219
884053,0,0,0,4,12,16,40.814072,-73.860113,10473
906678,8,10,12,6,0,36,42.824592,-78.802921,14218
914698,0,0,0,2,6,8,42.112294,-79.242109,14701
904200,0,0,0,4,12,16,40.647736,-74.013444,11220
904464,0,0,0,4,12,16,40.923958,-73.899105,10705
897714,0,0,0,4,12,16,40.819844,-73.821696,10465
903520,0,0,0,4,12,16,41.092005,-73.99298,10994
899694,0,0,0,4,12,16,40.871605,-73.900994,10468
911809,0,0,0,2,6,8,40.853851,-73.892296,10457
903910,0,0,0,83,0,83,40.862156,-73.929644,10040
901032,0,0,8,22,0,30,42.227479,-76.337327,13743
919486,0,0,0,4,12,16,40.689781,-73.866317,11421
903023,0,0,0,4,12,16,40.612909,-73.932642,11234
887417,32,60,41,20,0,153,40.828801,-73.421295,11743
898976,0,0,0,2,6,8,42.796772,-73.941504,12303
893765,0,0,0,4,12,16,40.829768,-73.870467,10472
886307,0,0,0,0,12,12,40.828422,-73.916581,10456
900622,0,0,0,4,12,16,42.814507,-73.926038,12308
920088,0,0,0,50,0,50,43.393234,-76.472124,13126
916409,0,0,0,4,12,16,41.522385,-74.0903,12550
907501,0,0,34,0,0,34,42.738662,-73.685225,12180
913092,0,0,0,114,0,114,40.819312,-73.956843,10027
895418,0,0,0,4,12,16,43.161573,-77.557544,14609
891282,0,0,0,4,12,16,44.054356,-73.508152,12960
891984,0,0,0,2,12,14,40.872898,-73.862547,10467
913628,0,0,0,4,12,16,40.708563,-73.581517,11553
886209,0,0,0,4,12,16,41.107018,-73.789688,10532
888877,0,0,0,4,12,16,40.688444,-73.914726,11221
892924,0,0,0,4,12,16,40.861481,-73.900175,10468
885514,0,0,0,4,12,16,40.6712,-73.5872,11520
907965,0,0,0,2,6,8,43.04919,-73.872764,12020
919443,0,0,0,4,12,16,40.663078,-73.588591,11520
902232,8,10,34,0,0,52,40.771145,-73.06662,11741
891734,0,0,0,4,12,16,40.721949,-73.814954,11367
901718,0,0,0,100,0,100,42.935376,-76.543083,13021
922068,0,0,0,70,0,70,40.801681,-73.95061,10026
896219,0,0,0,2,12,14,40.808745,-73.913726,10454
911898,0,0,0,2,6,8,40.79217,-72.866154,11967
909642,0,0,0,2,6,8,42.767826,-73.828238,12309
887752,4,12,16,0,0,32,42.028107,-76.41746,13812
901762,0,0,0,4,12,16,40.841817,-73.926261,10452
908459,0,0,0,4,12,16,42.899817,-74.57658,13317
907592,0,0,0,4,12,16,40.86691,-73.90032,10468
908206,0,0,0,4,12,16,40.659998,-73.99994,11232
893452,0,0,0,4,12,16,40.759099,-73.888604,11370
892343,14,22,14,18,0,68,41.470083,-74.047538,12553
902967,0,0,0,2,12,14,43.08095,-76.130003,13208
887317,0,0,0,4,12,16,40.866679,-73.896731,10468
909156,0,0,0,2,12,14,40.850932,-73.853234,10461
920233,0,0,0,2,6,8,42.937984,-76.603518,13021
885393,0,0,0,4,12,16,40.629435,-73.654663,11572
908991,0,0,0,2,6,8,40.827546,-73.895651,10459
892213,0,0,0,4,12,16,40.831362,-73.818657,10465
883021,0,0,0,115,0,115,40.855963,-73.91616,10453
894702,0,0,0,206,0,206,40.812323,-73.734829,11024
906599,0,0,0,0,8,8,40.659626,-73.587965,11520
890580,0,0,0,44,0,44,40.889772,-73.394563,11743
921961,0,0,0,80,0,80,42.206352,-78.135567,14739
888073,0,0,0,4,12,16,40.873184,-73.876246,10467
889283,0,0,0,232,0,232,44.482643,-75.303371,13630
901469,0,0,0,4,12,16,40.866938,-73.920484,10034
895989,0,0,0,0,12,12,40.846522,-73.828164,10461
902695,0,0,0,4,12,16,40.823138,-73.940175,10039
902641,0,0,0,0,12,12,40.839021,-73.885327,10460
883974,0,0,0,2,6,8,43.062878,-76.15221,13208
898860,0,0,0,2,6,8,43.183977,-77.58976,14621
906118,8,24,0,0,0,32,43.109658,-77.574538,14618
898926,0,0,0,4,12,16,41.560834,-74.113174,12586
893792,0,0,149,0,0,149,41.803777,-74.831311,12758
916486,0,0,126,0,0,126,43.270053,-73.586248,12828
900225,0,0,0,4,12,16,40.867567,-73.88824,10458
887437,0,0,0,4,12,16,40.796561,-73.943451,10029
886355,0,0,0,4,12,16,40.748905,-73.579321,11590
905907,0,0,0,4,12,16,40.882681,-73.851719,10469
906900,0,0,0,0,12,12,40.870082,-73.839974,10469
901780,0,0,0,2,6,8,40.664829,-73.957361,11225
894923,0,0,0,4,12,16,40.836966,-73.919221,10452
903959,0,0,0,2,6,8,40.677169,-73.92294,11233
921413,0,0,0,4,12,16,40.737592,-73.800768,11365
900829,0,0,0,2,6,8,42.904852,-76.858178,13165
916672,0,0,0,4,12,16,40.830735,-73.929598,10452
886858,0,0,0,60,0,60,41.648351,-74.679097,12701
892468,0,0,0,4,12,16,40.851778,-73.906553,10453
884788,0,0,0,4,12,16,41.196647,-74.020765,10923
895048,0,0,0,65,0,65,40.813926,-73.946101,10027
887840,0,0,0,0,12,12,40.847439,-73.890846,10457
894465,0,0,0,4,12,16,43.165469,-77.598799,14605
906411,0,0,0,4,12,16,43.360068,-73.621419,12804
908644,0,0,0,140,0,140,40.71149,-73.985849,10002
888244,0,0,0,4,12,16,40.820865,-72.852775,11950
914274,0,0,0,4,12,16,43.020669,-76.163374,13207
890330,0,0,0,4,12,16,40.692055,-73.950597,11206
915287,0,0,0,4,12,16,40.59933,-73.97982,11223
902419,0,0,0,0,12,12,40.875717,-73.884434,10458
892701,0,0,0,4,12,16,42.854039,-78.828556,14220
905465,0,0,0,4,12,16,42.784881,-73.975791,12306
904264,0,0,0,4,12,16,40.687802,-73.583472,11575
899398,0,0,0,100,0,100,40.802864,-73.965822,10025
897085,0,0,0,4,12,16,42.962511,-78.822689,14226
884199,0,0,0,4,12,16,41.145632,-74.031659,10977
904155,0,0,0,4,12,16,41.791524,-75.016059,12745
918383,0,0,0,4,12,16,40.685581,-73.398017,11726
889408,0,0,0,4,12,16,43.102395,-75.264187,13502
889942,0,0,15,0,0,15,41.400079,-74.078908,10930
895931,0,0,0,4,12,16,41.197177,-73.98059,10927
902028,0,0,0,4,12,16,41.06173,-73.808754,10523
885244,0,0,0,4,12,16,40.704467,-73.422814,11701
885693,0,0,0,4,12,16,42.096279,-75.929533,13905
905658,0,0,0,4,12,16,40.87878,-73.861816,10467
909963,0,0,0,30,0,30,41.026179,-73.791444,10530
893265,0,0,0,0,12,12,40.836963,-73.908412,10456
912163,0,0,0,4,12,16,44.939135,-74.918722,13662
898515,0,0,0,0,12,12,40.867935,-73.892547,10458
910255,0,0,0,213,0,213,40.579992,-73.833114,11694
908410,0,0,0,2,6,8,42.066041,-76.80968,14904
917251,0,0,0,4,12,16,40.740287,-73.330282,11703
907133,0,0,0,2,6,8,40.824018,-73.060222,11738
907295,0,0,0,4,12,16,40.880395,-73.867171,10467
913494,0,0,0,4,12,16,40.74897,-73.904023,11377
903795,0,0,0,4,12,16,40.637824,-74.000168,11219
921691,0,0,0,40,0,40,40.63491,-73.89736,11236
897553,0,0,0,4,12,16,43.141528,-77.621149,14608
911807,0,0,0,2,6,8,43.150608,-77.624396,14608
901358,0,0,0,4,12,16,43.052877,-76.19048,13204
910401,0,0,0,2,6,8,40.734136,-73.811524,11365
919754,0,0,0,4,12,16,40.587418,-74.15387,10314
920991,0,0,0,4,12,16,40.866069,-73.896318,10468
899577,0,0,0,4,12,16,40.687247,-73.858447,11421
917974,0,0,0,4,12,16,40.68825,-73.42314,11701
919137,0,0,0,75,0,75,42.641743,-73.789824,12209
892616,0,0,0,2,6,8,41.48471,-74.113922,12553
908831,0,0,0,4,12,16,42.828901,-73.959901,12302
914944,0,0,0,4,12,16,40.839829,-73.87729,10460
916251,0,0,0,2,6,8,42.568166,-76.258455,13045
914011,0,0,0,60,0,60,40.95757,-72.196969,11937
909599,0,0,0,4,12,16,40.677067,-73.80486,11704
920297,0,0,0,4,12,16,42.631898,-73.772751,12202
897333,0,0,0,2,6,8,42.648533,-76.18064,13077
885990,0,0,0,4,12,16,40.682815,-73.592766,11575
913942,0,0,0,4,12,16,40.837286,-73.940277,10032
899132,0,0,0,4,12,16,40.873015,-73.900586,10468
902568,0,0,0,60,0,60,43.000451,-73.867567,12020
905863,0,0,0,4,12,16,40.819844,-73.821696,10465
915574,0,0,0,2,6,8,42.097388,-76.818432,14901
890084,0,0,0,4,12,16,40.839092,-73.876993,10460
893317,0,0,0,4,12,16,40.661735,-73.991295,11215
910597,0,0,0,4,12,16,41.362905,-73.784649,10541
898824,0,0,0,2,12,14,40.824433,-73.911875,10451
910643,0,0,0,2,12,14,40.860539,-73.900339,10468
903256,0,0,0,4,12,16,40.851266,-73.885784,10457
883081,0,0,0,4,12,16,40.897885,-73.872208,10470
900616,0,0,0,2,6,8,40.891372,-73.852897,10466
915683,0,0,0,228,0,228,40.665841,-73.851026,11414
891580,0,0,0,4,12,16,43.25395,-77.736116,14612
914706,0,0,0,2,10,12,40.824862,-73.90473,10456
894978,0,0,0,2,6,8,43.25642,-76.024743,13044
887181,0,0,90,0,0,90,42.907982,-78.679034,14086
884217,23,36,30,42,0,131,41.459344,-74.056788,12553
904083,0,0,0,4,12,16,40.713019,-73.613685,11550
906155,0,0,0,4,12,16,40.677115,-73.874084,11208
885506,0,0,0,4,12,16,40.879856,-73.905545,10463
899373,0,0,0,438,0,438,40.736536,-73.874677,11373
904215,0,0,0,4,12,16,40.609797,-73.911074,11234
912663,0,0,0,2,12,14,43.165994,-77.655316,14606
894234,0,0,0,2,6,8,40.796959,-73.942289,10029
886563,0,0,0,4,12,16,40.82081,-73.897098,10457
895751,0,0,0,4,12,16,40.862894,-73.893181,10458
891619,0,0,0,2,6,8,44.443259,-73.67469,12912
887101,0,0,0,4,12,16,42.954678,-78.903875,14207
889212,0,0,0,40,0,40,43.09018,-75.646869,13421
920840,0,0,0,2,6,8,40.791782,-73.259102,11717
887691,0,0,0,4,12,16,40.758274,-73.566845,11590
907103,0,0,0,4,12,16,40.691411,-73.916487,11221
902845,0,0,0,140,0,140,40.836662,-73.93711,10032
901237,0,0,0,40,0,40,42.337542,-79.090393,14138
919509,8,12,39,0,0,59,43.845938,-73.42573,12883
912880,0,0,0,4,12,16,40.68387,-73.939378,11216
898747,0,0,0,4,12,16,40.826114,-73.819763,10465
888732,0,0,0,182,0,182,44.558025,-74.946775,13625
900283,0,0,0,4,12,16,40.669757,-73.894168,11207
885659,0,0,0,2,6,8,42.827013,-73.920425,12308
896132,0,0,0,2,6,8,43.181312,-77.623449,14621
885116,0,0,0,4,12,16,40.923432,-73.899326,10705
888482,0,0,0,0,8,8,40.8216,-73.8134,10465
897518,0,0,0,0,12,12,40.838553,-73.917219,10452
893055,0,0,0,4,12,16,40.847117,-73.82826,10461
891439,8,12,24,0,0,44,43.09817,-73.776593,12866
919162,0,0,0,4,12,16,40.628367,-73.992098,11219
894626,0,0,0,2,6,8,42.994055,-76.815731,13148
898143,0,0,0,2,12,14,40.856171,-73.933826,10040
898236,0,0,0,47,0,47,40.832581,-73.927834,10452
883163,0,0,0,2,6,8,40.881958,-73.869992,10467
905304,0,0,0,4,12,16,40.769384,-73.506336,11801
900384,0,0,0,4,12,16,40.768042,-73.873183,11369
914754,0,0,0,4,12,16,40.860942,-73.908021,10468
893378,0,0,0,4,12,16,40.736851,-73.315034,11703
901206,0,0,0,4,12,16,40.76205,-73.579662,11590
897355,0,0,0,0,12,12,40.831736,-73.876434,10472
917061,0,0,0,4,12,16,40.618279,-73.948366,11210
900094,0,0,0,0,12,12,40.856185,-73.859978,10461
899528,0,0,0,4,12,16,40.846043,-73.910429,10453
920156,0,0,0,4,12,16,40.702596,-73.910128,11385
886659,0,0,0,4,12,16,40.878726,-73.838167,10469
883598,0,0,0,4,12,16,40.791136,-73.938773,10029
899963,0,0,0,4,12,16,41.153718,-73.991744,10956
915751,0,0,0,4,12,16,40.825243,-73.821941,10465
919968,0,0,0,2,12,14,40.81762,-73.851584,10473
915003,0,0,0,35,0,35,40.632265,-73.973603,11218
894132,0,0,0,2,6,8,40.852808,-73.907208,10453
909812,0,0,0,4,12,16,40.847731,-73.92186,10453
910787,0,0,0,0,5,5,40.847906,-73.899598,10457
900941,8,22,24,0,0,54,41.052273,-73.693007,10573
896192,0,0,0,4,12,16,40.872319,-73.842665,10469
887936,0,0,0,4,12,16,40.885573,-73.863358,10467
914630,0,0,0,2,6,8,43.180101,-77.642936,14613
903536,0,0,0,2,10,12,40.875607,-73.876257,10467
918571,0,0,0,2,6,8,44.338431,-75.470335,13642
918984,0,0,0,4,12,16,40.635243,-73.997294,11219
924727,0,0,0,96,0,96,42.475547,-79.332836,14048
915979,0,0,0,4,12,16,40.689259,-73.556853,11566
888048,0,0,0,2,6,8,42.437722,-73.714796,12184
924827,0,0,0,4,12,16,40.650851,-73.960949,11226
918946,0,0,0,2,12,14,40.854687,-73.842986,10461
884521,0,0,0,4,12,16,40.668041,-73.6985,11580
911532,0,0,0,4,12,16,40.847076,-73.884988,10460
913606,0,0,0,48,0,48,40.838377,-73.82603,10461
914965,0,0,0,2,12,14,40.831011,-73.918404,10456
900666,0,0,0,2,6,8,40.598868,-73.797281,11692
901961,0,0,0,4,12,16,40.884931,-73.850964,10466
887566,0,0,0,100,0,100,43.183903,-77.63155,14613
905178,4,9,10,20,0,43,41.624794,-73.573827,12594
916541,0,0,0,4,12,16,40.657569,-73.740565,11422
894527,0,0,0,4,12,16,43.227106,-77.620313,14612
903063,0,0,0,4,12,16,40.86676,-73.894264,10468
890822,0,0,0,4,12,16,40.677588,-73.790007,11434
906495,0,0,0,69,0,69,43.02538,-77.748107,14546
920211,0,0,0,56,0,56,43.44763,-76.510933,13126
889796,0,0,0,4,12,16,40.642758,-74.015766,11220
907763,0,0,0,4,12,16,40.858609,-73.928446,10040
918615,0,0,0,4,12,16,40.827305,-73.901442,10456
913747,0,0,0,4,12,16,40.846063,-73.819719,10465
895800,0,0,0,60,0,60,42.056356,-76.125621,13732
904592,0,0,0,164,0,164,40.858493,-73.887169,10458
907640,0,0,0,4,12,16,40.69057,-73.944121,11221
901972,0,0,0,4,12,16,40.691321,-73.84587,11421
911138,0,0,0,0,12,12,40.855366,-73.910911,10453
887336,0,0,0,0,12,12,40.880431,-73.90578,10463
922812,0,0,0,4,12,16,40.759089,-73.865758,11369
895267,0,0,0,248,0,248,40.69427,-73.85978,11421
890998,0,0,0,4,12,16,40.632744,-73.996174,11219
896375,0,0,0,4,12,16,41.022576,-73.801358,10530
908200,0,0,0,4,12,16,40.813195,-73.917239,10455
910038,0,0,0,4,12,16,40.888555,-73.855468,10466
905029,24,12,0,15,0,51,43.308074,-73.64767,12801
895675,0,0,0,4,12,16,40.944658,-73.863712,10701
889558,0,0,0,4,12,16,40.833687,-73.892622,10459
902358,0,0,8,32,0,40,43.025331,-75.071346,13340
917506,0,0,0,4,12,16,40.811281,-73.952438,10027
902992,0,0,0,4,12,16,40.69133,-73.761308,11412
907933,0,0,0,4,12,16,40.821783,-73.819828,10465
919740,0,0,0,4,12,16,40.881317,-73.858838,10467
900988,0,0,0,40,0,40,42.44289,-75.345058,13776
896524,0,0,0,4,12,16,40.761799,-73.882568,11369
915761,16,24,78,23,0,141,42.92014,-78.645268,14086
890137,0,0,0,60,0,60,42.100507,-75.775829,13865
892041,0,0,0,4,12,16,40.87321,-73.88851,10468
920559,0,0,0,4,12,16,40.872776,-73.86167,10467
921878,0,0,0,4,12,16,40.698812,-73.820875,11418
899769,0,0,0,2,6,8,43.153714,-77.65794,14611
909473,0,0,0,4,12,16,40.931284,-73.892798,10701
913393,0,0,0,62,0,62,40.765448,-73.959919,10065
892255,0,0,0,40,0,40,41.205948,-73.64092,10506
918360,0,0,0,4,12,16,40.680313,-73.979948,11217
893226,0,0,0,4,12,16,43.188222,-77.601213,14621
902690,0,0,0,4,12,16,40.685394,-73.773438,11434
912727,0,0,0,4,12,16,40.95747,-73.886722,10703
886276,0,0,0,4,12,16,40.653691,-73.720613,11581
922036,0,0,0,60,0,60,43.008395,-74.380861,12095
903588,0,0,0,4,12,16,40.636357,-73.587152,11520
887992,0,20,12,10,0,42,40.912475,-73.850089,10550
896672,0,0,0,4,12,16,40.811122,-73.073618,11741
884648,0,0,0,4,12,16,40.799895,-72.842843,11950
904743,0,0,0,20,0,20,40.72902,-73.807074,11365
898330,0,0,0,4,12,16,40.651983,-73.881242,11239
895202,0,0,0,4,12,16,40.81415,-73.914549,10455
892143,0,0,0,4,12,16,40.68164,-73.615969,11550
906896,0,0,0,4,12,16,40.83537,-73.909592,10456
897729,0,0,0,150,0,150,41.707538,-73.924494,12601
889318,0,0,0,4,12,16,40.821587,-73.943482,10030
917891,0,0,0,364,0,364,40.910189,-73.797839,10801
909388,0,0,0,4,12,16,40.786724,-73.848883,11356
891102,0,0,0,0,10,10,40.839537,-73.865961,10460
919005,32,44,68,0,0,144,41.079,-73.8253,10591
884802,0,0,0,0,12,12,40.861081,-73.906673,10468
893635,0,0,0,4,12,16,40.870006,-73.841512,10469
886815,0,0,0,4,12,16,40.890153,-73.846194,10466
918609,0,0,0,2,6,8,40.810852,-72.850545,11950
894895,0,0,0,2,10,12,40.646282,-73.904762,11236
900775,0,0,0,4,12,16,40.84248,-73.818631,10465
915626,0,0,0,4,12,16,40.779595,-73.846823,11356
891814,0,0,0,4,12,16,40.840125,-73.911877,10457
884907,0,0,0,4,12,16,40.618093,-74.080916,10304
901652,0,0,0,44,0,44,42.858501,-78.264156,14011
905549,0,0,0,4,12,16,40.852794,-73.910292,10453
917295,0,0,0,4,12,16,40.604885,-74.137262,10305
923684,0,0,0,2,6,8,43.386242,-76.453742,13126
906777,0,0,0,4,12,16,40.667781,-73.434568,11758
918788,0,0,0,4,12,16,40.706461,-73.586207,11553
892668,0,0,0,2,6,8,40.842951,-73.937035,10032
921588,0,0,0,4,12,16,43.091713,-75.240066,13501
911261,0,0,0,4,12,16,40.640021,-73.990275,11219
914262,0,0,0,2,6,8,43.097353,-75.23388,13501
923994,0,0,0,4,12,16,40.693864,-73.619109,11550
903653,0,0,0,0,10,10,40.854965,-73.899829,10457
907630,0,0,0,4,12,16,40.697436,-73.39479,11726
902329,0,0,0,4,12,16,40.856268,-73.858499,10461
908380,0,0,0,4,12,16,40.910612,-73.064178,11776
895498,0,0,0,74,0,74,40.63321,-74.125602,10310
893975,0,0,0,111,0,111,40.660341,-73.907249,11212
911729,0,0,0,2,6,8,42.084379,-79.238607,14701
909015,0,0,0,4,12,16,40.82389,-73.945053,10030
901167,0,0,0,4,12,16,40.748012,-73.588509,11590
920909,0,0,0,4,12,16,40.701039,-73.817855,11418
883468,0,0,0,4,12,16,40.872554,-73.83011,10475
914378,0,0,0,4,12,16,42.909014,-78.811329,14211
905623,0,0,0,2,6,8,42.905768,-76.804589,13148
896971,0,0,0,4,12,16,40.593836,-73.77173,11691
899191,0,0,0,4,12,16,43.053837,-76.197982,13204
917460,0,0,0,2,6,8,40.602396,-73.756778,11691
890619,0,0,0,4,12,16,40.69749,-73.952655,11206
897543,0,0,0,4,12,16,40.915211,-73.795645,10801
889723,0,0,0,4,12,16,40.776089,-73.226962,11717
903336,0,0,0,4,12,16,43.117247,-78.969427,14304
891250,0,0,0,2,6,8,42.946148,-78.819378,14215
921044,0,0,0,4,12,16,40.625057,-73.981945,11204
886886,0,0,0,4,12,16,40.663753,-73.757624,11413
883303,0,0,0,4,12,16,41.590368,-73.864138,12590
892458,0,0,0,0,12,12,40.640409,-73.602313,11570
891657,0,0,0,72,0,72,42.982561,-77.856573,14423
915456,0,0,0,4,12,16,40.918888,-72.66155,11901
893071,0,0,0,4,12,16,40.845641,-73.822936,10465
885794,0,0,0,4,12,16,40.669512,-73.885919,11207
899539,0,0,18,0,0,18,42.860588,-78.822273,14210
918347,0,0,0,4,12,16,40.677119,-73.837474,11433
903208,0,0,0,126,0,126,40.752637,-73.896874,11377
902544,0,0,0,4,12,16,40.669648,-73.836981,11417
899851,0,0,0,4,12,16,40.830096,-73.906476,10456
899790,0,0,0,2,6,8,40.829791,-73.917971,10456
902386,0,0,0,4,12,16,43.174402,-77.597764,14605
913211,0,0,0,4,12,16,42.695525,-73.792372,12205
896686,0,0,0,4,12,16,40.759182,-73.563032,11590
899478,0,0,0,2,6,8,43.170827,-77.644145,14606
896961,0,0,0,2,6,8,40.71041,-73.950404,11206
917943,16,31,52,0,0,99,42.744371,-73.838615,12309
920380,0,0,0,0,10,10,40.843655,-73.882638,10460
885924,0,0,0,4,12,16,40.658739,-73.727463,11422
904014,16,22,57,15,0,110,43.970837,-75.880792,13601
916036,0,0,0,4,12,16,40.685137,-73.847136,11416
900532,0,0,0,4,12,16,42.145841,-76.986753,14830
897991,0,0,0,4,12,16,40.683573,-73.582438,11575
886075,0,0,0,4,12,16,40.66818,-73.991549,11215
905089,0,0,0,4,12,16,40.83208,-73.876978,10472
888109,8,10,30,10,0,58,43.327778,-73.686168,12804
896751,0,0,0,2,12,14,40.58514,-73.936628,11235
908676,0,0,0,2,6,8,43.046019,-74.868549,13365
907365,0,0,0,2,6,8,40.921097,-73.902748,10705
903881,0,0,0,4,12,16,42.789267,-73.966649,12306
912369,0,0,0,2,6,8,40.6952,-73.5816,11553
898656,0,0,0,4,12,16,40.690518,-73.748649,11412
902768,0,0,0,4,12,16,40.732116,-73.823483,11367
912311,0,0,0,2,6,8,42.795486,-73.936146,12303
887024,0,0,0,4,12,16,40.857422,-73.896297,10458
901338,0,0,0,4,12,16,40.946772,-73.887671,10703
904533,0,0,0,4,12,16,40.831356,-73.855472,10472
883421,0,0,0,20,0,20,40.701938,-73.783375,11433
902267,0,0,0,0,10,10,40.854061,-73.885348,10458
898469,0,0,0,2,6,8,40.670118,-73.614416,11510
895690,0,0,0,4,12,16,40.840025,-73.898773,10457
900356,8,0,21,0,0,29,43.64975,-73.801204,12817
908874,0,0,0,4,12,16,40.593113,-73.957386,11229
907425,0,0,0,2,6,8,43.842608,-73.42876,12883
895226,0,0,0,152,0,152,40.886973,-73.913436,10463
899599,0,0,0,4,12,16,40.939839,-73.897269,10701
898040,0,0,0,2,6,8,43.034212,-73.846097,12020
922380,0,0,0,4,12,16,40.844519,-73.878295,10460
883309,0,0,0,4,12,16,40.863553,-73.868553,10467
895626,0,0,0,0,10,10,40.805916,-73.927028,10454
913001,0,0,0,20,0,20,40.703921,-73.896377,11385
902111,0,0,0,4,12,16,40.635766,-73.997584,11219
889185,40,50,97,0,0,187,42.761214,-73.814256,12110
914074,0,0,0,4,12,16,40.641967,-73.6027,11510
885562,0,0,0,2,6,8,40.758968,-73.274919,11706
910347,0,0,0,0,12,12,40.868011,-73.86425,10467
886688,0,0,0,4,12,16,42.416626,-76.511196,14850
899652,0,0,0,4,12,16,40.746069,-73.215612,11751
917459,0,0,0,0,8,8,40.834199,-73.867718,10472
883551,0,0,0,2,12,14,40.853976,-73.915266,10453
893193,0,0,0,4,12,16,40.724459,-73.349034,11704
897113,0,0,0,0,12,12,40.84156,-73.91284,10452
889884,0,0,0,4,12,16,40.77503,-73.227519,11717
916906,0,0,0,2,12,14,40.824004,-73.92615,10451
920173,0,0,0,4,12,16,40.685227,-73.838369,11416
917657,0,0,16,28,0,44,42.642414,-79.032553,14006
895918,0,0,0,2,6,8,42.904223,-74.576139,13317
917133,0,0,0,4,12,16,40.746334,-73.881164,11373
883173,0,0,0,4,12,16,40.81808,-73.885792,10474
900415,0,0,0,0,12,12,40.672529,-73.45128,11758
909807,0,0,0,4,12,16,40.858056,-73.865507,10467
906583,0,0,0,479,0,479,40.735563,-73.981556,10003
913588,0,0,0,2,6,8,41.704861,-73.901295,12603
916832,0,0,0,4,12,16,40.861467,-73.905887,10468
914823,0,0,0,0,5,6,42.275116,-74.916184,13753
888156,0,0,0,2,12,14,40.861148,-73.903227,10468
919945,0,0,0,2,6,8,42.086153,-78.41593,14760
901233,0,0,0,40,0,40,41.192056,-73.790216,10514
897397,0,0,0,4,12,16,42.998813,-73.852967,12020
924486,0,0,0,160,0,160,40.702277,-73.953024,11206
911473,0,0,0,4,12,16,43.172157,-77.646076,14606
912238,0,0,0,4,12,16,40.66138,-73.886079,11207
902986,0,0,0,4,12,16,40.667934,-73.74144,11422
903579,0,0,0,53,0,53,40.899747,-73.319423,11768
917890,0,0,0,227,0,227,40.915985,-73.789508,10801
884887,0,0,0,4,12,16,44.242322,-74.48389,12986
910927,0,0,0,127,0,127,40.674501,-73.960582,11238
900987,0,0,0,40,0,40,41.820949,-73.901665,12538
915917,0,0,0,2,6,8,42.121277,-79.205895,14733
900029,0,0,0,0,12,12,40.877531,-73.87482,10467
896096,0,0,0,2,12,14,40.853696,-73.904109,10453
915745,0,0,0,4,12,16,40.887171,-73.84851,10466
910531,0,0,0,52,0,52,41.922982,-74.06296,12443
889826,0,24,0,0,0,24,40.967808,-73.790266,10804
906719,0,0,0,4,12,16,43.7625,-74.2581,12842
890641,0,0,0,4,12,16,40.618699,-74.085955,10304
914977,0,0,0,2,6,8,42.279884,-77.601743,14823
906060,0,0,0,60,0,60,40.644728,-73.693759,11557
911679,0,0,0,2,6,8,40.852105,-73.905196,10453
886512,0,0,75,485,0,560,40.789638,-73.968159,10025
920792,0,0,0,4,12,16,40.692966,-73.588997,11553
887597,0,0,0,4,12,16,40.707168,-73.761794,11412
901967,8,19,11,0,0,38,41.019064,-72.482155,11935
922022,0,0,0,44,0,44,40.905988,-73.566402,11709
884099,0,0,0,4,12,16,40.759794,-73.216812,11717
911079,0,0,0,4,12,16,40.73227,-73.958126,11222
902278,0,0,0,4,12,16,43.155072,-77.645566,14611
908466,0,0,0,4,12,16,40.638522,-74.104525,10310
922815,0,0,0,71,0,71,40.681892,-73.856774,11416
896386,0,0,0,0,12,12,40.884831,-73.891242,10463
907749,0,0,0,4,12,16,42.113697,-75.828819,13904
901869,0,0,0,4,12,16,40.616864,-73.900213,11234
895689,0,0,0,4,12,16,40.824232,-73.862002,10473
905550,0,0,0,4,12,16,40.720263,-73.613973,11550
888323,0,0,0,0,8,8,40.820439,-73.913059,10451
896354,0,14,17,18,0,49,42.784657,-73.912657,12304
922738,0,0,0,0,10,10,40.821993,-73.097513,11779
916180,0,0,0,4,12,16,40.621046,-73.952914,11210
925161,0,0,0,4,12,16,40.70323,-73.699204,11003
888769,0,0,0,4,12,16,40.685188,-73.402625,11726
891237,0,0,61,0,0,61,41.41454,-74.324237,10924
898372,0,0,0,4,12,16,43.16173,-77.623985,14608
906082,0,0,0,2,6,8,43.967348,-75.90277,13601
892067,0,0,0,2,6,8,43.05032,-76.077178,13214
889626,0,0,0,2,6,8,40.808816,-73.853886,10473
890174,0,0,0,0,10,10,40.868232,-73.892298,10458
920638,0,0,0,2,6,8,42.939474,-73.795055,12151
890890,8,12,39,0,0,59,43.152717,-78.658631,14094
884269,0,0,0,4,12,16,40.78253,-72.855873,11967
886285,0,0,0,4,12,16,40.864782,-73.891847,10458
910761,0,0,0,4,12,16,40.663405,-73.990583,11215
915847,0,0,0,2,6,8,40.805732,-73.957898,10026
901529,0,0,0,4,12,16,40.63484,-73.999703,11219
921534,0,0,0,4,12,16,40.657482,-74.002394,11232
896214,0,0,0,2,12,14,40.854333,-73.903529,10453
895814,3,0,7,8,0,18,43.157686,-77.632104,14611
919661,0,0,0,18,0,18,40.745408,-73.880789,11373
905180,0,0,0,4,12,16,40.875358,-73.856671,10469
899213,0,0,0,2,6,8,42.725006,-73.786359,12211
897717,0,0,0,4,12,16,42.88899,-78.861133,14204
917940,0,0,0,4,12,16,40.76648,-73.224021,11717
909163,0,0,0,4,12,16,40.927276,-73.850056,10704
915459,0,10,14,19,0,43,43.042354,-74.865555,13365
908257,0,0,0,0,9,9,40.82134,-73.93534,10039
901637,0,0,0,4,12,16,40.634281,-74.004762,11219
913352,0,0,0,4,12,16,40.683226,-73.852148,11416
892160,0,0,0,2,6,8,42.076971,-76.063145,13850
886421,0,0,0,4,12,16,40.710036,-73.604549,11550
894833,0,0,0,200,0,200,40.669473,-73.879455,11208
903012,0,0,0,2,6,8,43.027547,-74.992647,13350
908000,0,0,0,4,12,16,41.015467,-73.659008,10573
904375,0,0,0,30,0,30,42.71308,-73.930089,12009
885043,0,0,0,4,12,16,40.820746,-73.866466,10473
897782,0,0,0,4,12,16,40.695819,-73.76239,11412
893204,0,0,0,4,12,16,41.554464,-73.724431,12582
894061,0,0,0,2,6,8,40.799713,-73.951734,10026
892279,0,0,0,4,12,16,43.184553,-77.595334,14621
911548,0,0,0,2,6,8,40.788682,-72.86792,11967
909308,0,0,0,4,12,16,40.765172,-73.923741,11102
906846,0,20,0,0,0,20,41.80534,-73.91064,12538
888002,0,0,0,4,12,16,42.148966,-77.126478,14870
887244,0,0,24,20,0,44,42.852392,-78.8035,14210
884695,0,0,0,4,12,16,40.855861,-73.85947,10461
911006,0,0,0,96,0,96,40.643098,-74.020886,11220
898835,0,0,0,2,6,8,43.256843,-77.705993,14612
907544,0,0,0,4,12,16,41.531177,-74.351663,10941
902403,0,0,0,4,12,16,40.69181,-73.394869,11726
891009,0,0,37,0,0,37,41.928717,-74.004182,12401
910846,0,0,0,4,12,16,40.860045,-73.852901,10469
891844,0,0,0,4,12,16,40.675874,-73.653091,11552
888081,0,0,0,4,12,16,40.710043,-73.582885,11553
915577,0,0,0,4,12,16,41.462764,-74.137736,12575
901283,16,10,90,0,0,116,43.047769,-76.048394,13057
911141,0,0,0,0,12,12,40.635745,-74.166964,10303
921144,0,0,0,2,6,8,42.089529,-79.25503,14701
888995,0,0,0,4,12,16,40.680746,-73.955405,11238
891370,0,0,0,4,12,16,40.84598,-73.919904,10452
902187,0,0,0,4,12,16,43.187908,-77.601532,14621
920327,0,0,0,4,12,16,40.681915,-73.893083,11207
896918,0,0,0,22,0,22,42.114985,-76.071052,13760
919105,0,0,0,50,0,50,40.711572,-73.814232,11435
919184,0,0,0,2,8,10,40.639917,-74.165782,10303
912900,0,0,0,4,12,16,40.88956,-73.86373,10466
905035,0,0,0,4,12,16,40.866695,-73.923104,10034
907403,0,0,0,4,12,16,42.97262,-76.139742,13120
924081,0,0,21,0,0,21,42.902671,-73.686848,12118
893473,0,0,0,4,12,16,40.687777,-73.857791,11421
898415,0,0,0,2,6,8,43.195675,-77.571642,14609
884917,0,0,0,2,12,14,40.877013,-73.885812,10468
883266,0,0,0,4,12,16,40.757405,-73.796641,11358
894333,0,0,0,4,12,16,40.854172,-73.900434,10457
895555,0,0,0,2,10,12,40.839803,-73.91591,10452
903701,0,0,0,209,0,209,40.620541,-74.081525,10304
909060,0,0,0,4,12,16,43.045853,-76.1112,13224
896268,0,0,0,4,12,16,40.757417,-73.809258,11355
900360,0,0,0,4,12,16,40.695308,-73.928235,11221
886911,0,0,0,44,0,44,43.028223,-78.79734,14228
891527,8,12,11,0,0,31,43.080597,-75.369377,13323
902168,0,0,0,4,12,16,40.637819,-73.990414,11219
911750,0,0,0,4,12,16,40.682941,-73.376915,11757
898005,0,0,0,4,12,16,40.66613,-73.893541,11207
883518,0,0,0,4,12,16,40.771976,-73.800614,11358
899529,0,0,0,4,12,16,40.841892,-73.914482,10452
892395,0,0,0,4,12,16,40.843866,-73.904727,10457
883995,0,0,0,0,12,12,40.882594,-73.898188,10463
907054,0,0,0,2,6,8,44.271386,-73.984198,12946
888584,0,0,0,0,10,10,40.839803,-73.91591,10452
896550,0,0,0,4,12,16,40.828623,-73.921351,10451
899149,0,0,10,20,0,30,42.763864,-73.808819,12110
892721,0,0,0,2,6,8,40.873978,-73.874561,10467
885770,0,0,0,2,6,8,41.852229,-74.551459,12740
890505,0,0,0,2,12,14,40.873931,-73.850658,10469
900734,0,0,0,2,6,8,42.133519,-76.815215,14845
897016,0,0,0,2,6,8,40.663638,-73.592141,11520
891628,0,0,0,4,12,16,40.690562,-73.596268,11553
886885,0,0,0,4,12,16,40.752426,-73.875155,11372
893845,0,0,0,4,12,16,40.934173,-73.884896,10701
910188,0,0,0,2,6,8,40.943239,-73.861829,10701
913691,0,0,0,2,12,14,40.857778,-73.906314,10453
886168,0,0,63,0,0,63,41.277026,-74.326485,10990
917687,0,0,0,40,0,40,40.692661,-73.799224,11435
920443,0,0,0,4,12,16,40.63798,-73.584575,11520
918359,0,0,0,4,12,16,40.698257,-73.612562,11550
925653,0,12,14,0,0,26,40.83981,-72.600536,11959
902528,0,0,0,0,12,12,40.852559,-73.907116,10453
884646,0,0,0,4,12,16,40.636828,-73.586279,11520
899123,0,0,0,4,12,16,40.630538,-73.990446,11219
914732,0,0,0,4,12,16,40.683435,-73.593188,11575
908724,7,21,13,20,0,61,42.902576,-78.863271,14203
911341,0,0,0,0,5,5,42.6485,-73.7607,12242
885345,0,0,0,4,12,16,40.711879,-73.596531,11553
904932,0,0,0,0,8,8,40.634152,-73.976415,11218
903419,0,0,0,4,12,16,41.153643,-74.039068,10977
899779,0,0,0,4,12,16,40.6551,-73.941547,11203
885797,0,0,0,69,0,69,42.931018,-74.204572,12010
901096,14,0,0,9,0,23,41.394886,-74.463792,10973
887161,0,0,0,4,12,16,43.117357,-79.036317,14305
906353,0,0,0,0,12,12,40.877272,-73.859269,10469
901436,0,0,15,0,0,15,43.058921,-76.134756,13203
888954,0,0,72,0,0,72,40.808209,-73.740779,11024
898197,0,0,0,4,12,16,40.752433,-73.787158,11358
883608,0,0,0,2,6,8,42.765139,-77.892599,14481
914449,0,0,0,215,0,215,40.888173,-73.913354,10463
886068,0,0,0,4,12,16,41.5633,-74.462139,12721
896698,0,0,0,4,12,16,40.861228,-73.900268,10468
902755,0,0,0,4,12,16,40.888733,-73.819425,10475
916600,0,0,0,2,6,8,41.19989,-73.972803,10927
921832,0,0,0,2,6,8,40.655041,-73.829507,11414
883809,0,0,0,4,12,16,40.596033,-73.798228,11692
901983,0,0,0,0,12,12,40.838716,-73.866706,10460
901127,0,0,0,4,12,16,40.880223,-73.060382,11720
912862,0,0,0,17,0,17,40.755382,-73.99933,10001
917252,0,0,0,4,12,16,40.827983,-73.923761,10452
907213,0,0,128,0,0,128,40.747493,-73.638852,11501
908901,0,0,0,58,0,58,40.817378,-73.947447,10030
893683,0,0,0,292,0,292,40.874106,-73.833117,10001
895265,0,0,0,2,6,8,41.63535,-74.379734,12566
917573,0,0,0,10,0,10,42.836634,-76.688475,13160
901753,0,0,0,4,12,16,40.89445,-73.785298,10805
883355,0,0,0,4,12,16,40.683028,-73.822814,11419
912420,0,0,0,4,12,16,40.913986,-73.830575,10550
907883,0,0,0,4,12,16,40.847342,-73.933536,10033
903133,0,0,0,0,12,12,40.879287,-73.906022,10463
905107,0,0,0,4,12,16,40.714043,-73.735102,11429
905597,0,0,0,4,12,16,40.808348,-73.914819,10454
885242,0,0,0,4,12,16,40.788773,-73.227588,11717
898150,0,0,0,4,12,16,40.861187,-73.927558,10040
913984,0,20,49,0,0,69,42.738967,-73.813839,12211
905717,0,0,0,0,12,12,40.811356,-73.939871,10037
897228,0,0,16,28,0,44,42.41083,-76.50251,14850
887360,16,24,36,23,0,99,42.882653,-78.86451,14204
892097,0,0,0,0,12,12,40.823554,-73.890326,10459
918478,0,0,0,4,12,16,40.795704,-73.658099,11576
909895,0,0,0,0,10,10,40.844519,-73.878295,10460
902626,0,0,0,0,12,12,40.859865,-73.907331,10453
887496,0,0,0,2,6,8,43.245149,-77.595869,14617
884715,0,0,0,4,12,16,41.659002,-73.904983,12603
897789,0,0,0,2,6,8,43.080029,-76.13793,13208
921225,0,0,0,2,6,8,40.799915,-73.932343,10035
919972,0,0,0,4,12,16,40.879684,-73.882552,10467
896125,0,0,0,4,12,16,40.87339,-73.905362,10463
890271,0,0,0,209,0,209,40.650889,-74.008299,11232
900046,0,0,0,4,12,16,43.041751,-76.563006,13166
912001,0,0,0,4,12,16,40.631096,-73.995002,11219
906536,0,0,0,4,12,16,40.63473,-73.989057,11219
900435,0,0,0,2,6,8,42.128906,-76.833904,14903
903474,0,0,0,4,12,16,42.950808,-77.352752,14425
916858,14,19,128,0,0,161,41.760099,-74.597261,12788
890693,0,0,24,0,0,24,44.293412,-73.998642,12946
904156,0,0,0,2,6,8,43.103643,-79.030768,14305
915297,0,0,0,4,12,16,40.691996,-73.612297,11434
901396,0,0,0,4,12,16,40.863651,-73.869151,10467
884854,0,0,0,2,12,14,40.877399,-73.873841,10467
897640,0,0,0,4,12,16,40.674426,-73.751389,11413
904034,0,0,0,4,12,16,40.6263,-73.9784,11204
888428,0,0,0,316,0,316,40.925756,-73.896709,10705
919407,0,0,0,4,12,16,40.690541,-73.748785,11412
896840,0,0,0,0,5,5,40.848901,-73.914713,10453
914544,0,0,0,4,12,16,40.658462,-73.938855,11203
887128,0,0,0,4,12,16,40.770073,-73.752237,11363
902320,0,0,0,2,6,8,42.681851,-73.68313,12180
918118,0,0,0,4,12,16,40.745639,-73.514033,11801
911872,0,0,0,4,12,16,40.664155,-73.587944,11520
893054,0,0,0,4,12,16,40.876793,-73.884529,10458
893780,0,0,0,4,12,16,40.881763,-73.883496,10467
913290,0,0,0,4,12,16,42.317904,-75.781075,13778
899687,0,0,85,0,0,85,41.366243,-74.685872,12771
886078,0,0,0,4,12,16,43.133715,-77.654484,14619
908049,0,0,0,4,12,16,40.87784,-73.882195,10467
886550,0,0,0,0,12,12,40.836737,-73.886871,10460
905968,0,0,0,2,6,8,43.168221,-77.5996,14605
916369,0,0,0,4,8,12,40.860386,-73.926937,10040
910279,0,0,0,2,6,8,40.829644,-73.81642,10465
897270,0,0,0,4,12,16,40.874716,-73.880524,10467
920242,0,0,0,40,0,40,41.503868,-73.977409,12508
907833,0,0,0,2,6,8,42.088057,-75.908258,13903
905708,0,0,36,0,0,36,42.041508,-74.000065,12477
888841,0,0,0,20,0,20,40.912511,-73.821586,10553
896454,0,0,0,4,12,16,40.833044,-73.910967,10456
885230,0,0,0,4,12,16,40.711297,-73.701087,11001
921272,0,0,16,28,0,44,43.160149,-76.2782,13207
889122,0,0,0,4,12,16,40.773432,-73.782195,11360
920464,0,0,0,4,12,16,40.679136,-73.908994,11233
885524,0,0,0,215,0,215,40.671464,-73.977974,11215
913138,0,0,0,2,6,8,41.166885,-74.186179,10974
900172,0,0,0,4,12,16,43.155047,-76.139256,13041
887456,0,0,0,0,12,12,40.701075,-73.944777,11206
894125,0,0,0,4,12,16,43.151421,-77.64089,14611
891172,0,0,0,64,0,64,40.648141,-73.951784,11226
901841,0,0,0,4,12,16,40.698933,-73.619572,11550
920147,0,0,0,0,12,12,40.828039,-73.944814,10031
921227,0,0,0,4,12,16,44.846389,-74.299487,12953
901933,0,0,0,2,6,8,40.82449,-73.864991,10473
904345,0,0,0,2,6,8,43.144515,-73.748138,12831
884082,0,0,0,0,6,6,40.855158,-73.890151,10458
885416,0,0,0,4,12,16,40.829984,-73.877426,10472
901556,0,0,0,4,12,16,43.071981,-74.30869,12078
923446,0,0,0,89,0,89,40.674656,-73.580115,11575
913666,0,0,0,2,6,8,43.166073,-77.565594,14609
902929,0,0,0,317,0,317,40.832756,-73.911502,10456
884243,0,0,0,0,6,6,43.132,-76.2173,13090
887732,0,0,0,4,12,16,43.190819,-77.610913,14621
894348,0,0,0,4,12,16,40.936681,-72.638858,11901
892202,0,0,0,4,12,16,40.536862,-74.149583,10312
906213,0,0,0,77,0,77,40.80909,-73.944221,10027
896950,0,0,0,4,12,16,40.850882,-73.933354,10033
892791,0,0,0,34,0,34,40.806431,-73.916921,10454
886320,0,0,0,2,6,8,40.849721,-73.907807,10453
918841,0,0,0,4,12,16,40.695642,-73.947881,11206
888182,0,0,0,2,6,8,42.788899,-73.756354,12047
905919,0,0,0,4,12,16,40.666941,-73.992488,11215
900110,0,0,0,0,3,3,40.818761,-73.941682,10030
908977,0,0,0,4,12,16,43.201613,-77.936275,14420
903528,0,0,0,4,12,16,40.654286,-73.703229,11581
902745,0,0,0,4,12,16,42.356079,-77.402926,14810
909097,0,0,0,2,6,8,42.081621,-76.795814,14904
918022,0,0,0,4,12,16,44.218878,-75.79068,13691
890935,0,0,0,0,12,12,40.840363,-73.857512,10462
883899,0,0,0,4,12,16,43.092445,-77.568721,14618
918163,0,0,0,4,12,16,40.614225,-74.00684,11228
915494,0,0,0,4,12,16,40.678896,-73.590246,11575
899244,0,0,0,4,12,16,40.657746,-73.930191,11203
886356,0,0,0,4,12,16,40.767847,-73.275301,11706
906672,0,0,0,4,12,16,42.796447,-73.944625,12303
892369,0,0,0,2,6,8,40.885617,-73.860818,10467
911808,8,20,10,0,0,38,42.693131,-73.873293,12203
916243,0,0,0,4,12,16,40.613391,-73.935644,11234
894725,0,0,0,4,12,16,40.689767,-73.79116,11433
895833,0,0,0,30,0,30,42.085198,-75.954838,13850
903915,0,0,0,4,12,16,40.617198,-74.132448,10314
893130,0,0,0,2,12,14,40.823508,-73.824092,10465
891052,0,0,0,4,12,16,40.694697,-73.628568,11550
903309,0,0,0,2,6,8,41.164305,-73.846042,10562
891906,0,0,0,4,12,16,40.866454,-73.892813,10458
887419,8,10,12,0,0,30,42.476884,-77.854909,14884
888525,0,0,0,2,6,8,44.930218,-74.379173,12926
908589,0,0,0,0,12,12,40.837652,-73.923975,10452
892510,0,0,0,104,0,104,42.815718,-77.665919,14487
890452,0,0,0,4,12,16,40.868925,-73.92314,10034
914151,0,0,0,4,12,16,40.658462,-73.590908,11520
884578,0,0,0,4,12,16,40.830918,-73.867248,10472
901740,0,0,0,2,6,8,42.742291,-73.775915,12110
903774,0,0,0,4,12,16,41.116051,-74.048853,10977
894581,0,0,0,0,12,12,40.844542,-73.906382,10457
886773,6,9,15,0,0,30,42.741402,-73.86054,12205
889455,0,0,0,4,12,16,40.85062,-73.86025,10462
906927,0,0,0,40,0,40,42.167201,-75.864707,13901
907659,0,0,0,4,12,16,43.206998,-77.571036,14622
921479,0,0,0,4,12,16,40.911652,-73.901047,10471
902480,0,0,0,2,6,8,40.831173,-73.890475,10459
915220,0,0,0,4,12,16,40.701796,-73.948702,11249
896892,0,0,0,4,12,16,41.186764,-73.869517,10562
885729,0,0,0,4,12,16,40.933425,-73.797742,10804
909947,0,0,0,2,6,8,40.680184,-73.930194,11233
912532,0,0,0,2,6,8,41.779726,-74.540454,12428
916746,0,0,0,4,12,16,40.694414,-73.914331,11221
906136,0,0,0,2,6,8,40.812197,-73.906362,10455
912921,0,0,0,2,6,8,43.077575,-76.140435,13208
895115,0,0,0,105,0,105,40.872702,-73.905309,10463
883617,0,0,0,4,12,16,40.8419,-73.9263,10452
902219,0,0,0,0,10,10,40.832756,-73.910241,10456
891613,0,0,0,2,6,8,43.475382,-76.435638,13126
889517,0,0,0,20,0,20,40.767246,-73.822199,11354
905249,0,0,0,4,12,16,40.702055,-73.766553,11412
919806,0,0,0,4,12,16,40.623166,-73.91884,11234
889992,0,0,0,4,12,16,40.808117,-73.919061,10454
885276,0,0,0,4,12,16,42.0793,-75.7726,13795
897615,0,0,0,4,12,16,40.677473,-73.997181,11231
908221,0,0,0,4,12,16,40.707747,-73.615424,11550
885829,0,0,0,2,6,8,40.737321,-73.855662,11368
892314,0,0,18,0,0,18,42.901033,-78.837708,14211
920920,0,0,0,4,12,16,40.719131,-73.958037,11249
891482,0,0,0,4,12,16,40.702429,-73.661171,11552
902090,0,0,0,2,6,8,42.224203,-77.023284,14830
908765,0,0,0,95,0,95,40.700762,-73.993007,11201
901263,8,9,40,24,0,81,40.727538,-73.443959,11735
893312,0,0,0,4,12,16,40.686924,-73.787657,11434
914924,0,0,0,2,6,8,42.074381,-76.814189,14904
921014,0,24,72,0,0,96,42.779425,-74.02997,12306
908869,0,0,0,4,12,16,40.820693,-73.862641,10473
887199,0,0,0,4,12,16,40.831613,-73.852301,10462
893885,0,0,0,4,12,16,40.623638,-73.928526,11234
899594,0,0,0,2,6,8,43.01343,-76.143097,13205
907574,0,0,0,4,12,16,43.17084,-76.260361,13027
890544,0,0,0,4,12,16,40.747947,-73.360636,11798
907032,0,0,0,4,12,16,40.704022,-73.583178,11553
914329,0,0,0,4,12,16,40.745448,-73.548037,11590
897001,0,0,0,4,12,16,40.66338,-73.895812,11207
911781,0,0,0,2,6,8,42.6663,-73.7985,12206
916327,0,0,0,4,12,16,40.669395,-73.406255,11701
886767,0,0,0,2,6,8,44.560021,-75.428393,13654
898575,0,0,0,0,12,12,40.853423,-73.904049,10453
904534,0,0,0,4,12,16,40.833456,-73.91281,10456
883984,0,0,0,4,12,16,42.427769,-74.023988,12083
896599,0,0,0,4,12,16,42.903621,-78.821671,14211
884433,0,0,0,0,12,12,40.863572,-73.895071,10458
889243,0,0,0,4,12,16,40.842018,-73.853077,10462
918935,0,0,0,4,12,16,40.690705,-73.613622,11550
903097,0,0,0,4,12,16,40.661206,-73.576083,11520
892635,0,0,0,4,12,16,40.774181,-73.333839,11729
917334,0,0,0,4,12,16,40.633591,-74.152976,10303
905787,0,0,0,2,12,14,40.833044,-73.910967,10456
886861,0,0,36,0,0,36,41.65318,-74.686184,12701
896533,0,0,0,2,6,8,43.253579,-77.653336,14612
892562,0,0,0,2,6,8,40.737332,-73.361798,11704
906162,0,0,0,4,12,16,40.847912,-73.902339,10457
910210,0,0,0,132,0,132,41.008501,-73.660204,10573
918542,0,0,0,4,12,16,40.596254,-73.799792,11692
897461,0,0,0,4,12,16,40.874877,-73.848178,10469
884201,0,0,0,2,12,14,40.61936,-73.922242,11234
904142,0,0,0,4,12,16,40.76999,-73.265554,11706
911610,0,0,0,2,6,8,40.814518,-72.994905,11763
885448,0,0,0,4,12,16,41.644422,-74.094478,12589
897077,0,0,0,2,6,8,42.966973,-78.816643,14226
917175,0,0,0,2,6,8,42.174244,-76.831987,14845
902587,0,0,0,2,6,8,40.794543,-73.944903,10029
886936,0,0,0,30,0,30,41.679669,-73.854777,12603
894926,0,0,0,259,0,259,40.678313,-73.965735,11238
912142,0,0,0,2,6,8,40.896753,-73.849136,10466
914157,0,0,0,2,6,8,42.127338,-76.342766,13827
883025,0,10,33,7,0,50,40.78313,-73.190243,11722
899472,0,0,0,4,12,16,40.940563,-73.893451,10703
922173,0,0,0,4,12,16,40.722804,-73.812131,11367
893760,0,0,0,4,12,16,43.036998,-76.166177,13204
900314,0,0,0,4,12,16,40.690485,-73.414994,11701
895493,0,0,0,4,12,16,40.690151,-73.831933,11419
885624,0,0,0,4,12,16,40.899316,-73.846392,10466
921857,0,0,0,140,0,140,40.843993,-73.884534,10460
891339,0,0,0,60,0,60,43.144611,-76.131642,13212
922510,0,0,0,2,8,10,40.866184,-73.925877,10034
907286,0,0,0,4,12,16,42.104209,-76.151549,13760
904901,0,0,0,4,12,16,40.776834,-73.252754,11717
898513,0,0,0,4,12,16,43.006674,-75.020817,13407
887636,0,0,30,0,0,30,40.707203,-73.592711,11553
887867,0,0,0,4,12,16,40.839084,-73.817032,10465
886052,0,0,0,30,0,30,40.670218,-73.921585,11233
883765,0,0,0,128,0,128,40.806359,-73.921026,10454
920769,0,0,0,4,12,16,40.808324,-73.914341,10454
911210,8,10,14,12,0,44,44.404647,-74.085061,12913
919564,0,0,0,4,12,16,40.790112,-73.252377,11717
905411,0,0,0,2,12,14,40.849013,-73.912411,10453
900307,0,0,0,4,12,16,43.183004,-77.581741,14621
916670,0,0,0,4,12,16,40.684989,-73.873824,11208
885171,0,0,0,4,12,16,40.890692,-73.862105,10466
909548,0,0,0,4,12,16,40.828657,-73.914943,10456
914340,0,0,0,4,12,16,40.814282,-73.951475,10027
913185,0,0,0,4,12,16,40.860756,-73.892638,10458
902868,0,0,0,261,0,261,40.735601,-73.999136,10011
899049,0,0,0,4,12,16,42.437553,-76.47328,14850
911728,32,36,44,0,0,112,43.171021,-76.117008,13039
919138,0,0,0,75,0,75,42.64144,-73.778678,12209
901910,0,0,0,4,12,16,40.950615,-73.884866,10703
920135,0,0,0,4,12,16,40.683628,-73.397749,11726
914028,0,0,0,4,12,16,40.677603,-73.742511,11413
885977,0,0,0,4,12,16,40.850665,-73.914371,10453
899891,0,0,0,4,12,16,40.807339,-73.956712,10026
893321,0,0,0,4,12,16,40.852082,-73.853642,10461
899493,0,0,0,184,0,184,40.839664,-73.925697,10452
913632,0,0,0,0,12,12,40.822188,-73.900338,10459
916235,0,0,0,2,12,14,40.870685,-73.889492,10458
903211,0,0,0,4,12,16,41.474923,-74.357083,10941
915532,0,0,0,2,6,8,42.950104,-77.352766,14425
922070,0,0,0,4,12,16,40.636034,-73.997079,11219
885827,0,0,0,2,6,8,40.855397,-73.899913,10457
917245,0,0,0,4,12,16,40.68158,-73.888684,11207
895009,0,0,0,4,12,16,40.690767,-73.812615,11419
885388,0,0,0,0,8,8,40.869188,-73.891589,10458
887197,0,0,0,4,12,16,44.4319,-74.1813,12939
883083,0,0,0,4,12,16,40.622613,-74.161651,10303
892089,0,0,0,4,12,16,40.764179,-73.562011,11590
885508,0,0,0,4,12,16,40.693412,-73.739799,11411
883616,0,0,0,4,12,16,40.709082,-73.348742,11704
886586,0,0,0,2,6,8,40.786807,-73.852232,11356
920238,0,0,0,40,0,40,41.517963,-73.928389,12524
920910,0,0,0,4,12,16,40.764501,-73.868805,11369
920274,0,0,0,4,12,16,43.085444,-75.23651,13501
884204,0,0,0,4,12,16,40.572352,-74.095257,10306
887723,0,0,0,2,6,8,40.847906,-73.899598,10457
892214,0,0,0,4,12,16,40.762849,-73.921577,11106
887062,0,0,0,40,0,40,43.054994,-76.142762,13203
922229,0,0,0,4,12,16,40.663437,-73.739255,11422
913517,0,0,0,120,0,120,40.636522,-73.998831,11219
905407,0,0,0,4,8,12,43.231798,-76.358565,13135
918188,0,0,0,2,6,8,40.694929,-73.968924,11205
889358,0,0,37,0,0,37,40.737157,-73.479025,11714
908130,0,0,0,4,12,16,41.219239,-73.988621,10980
885662,0,0,0,2,10,12,40.832805,-73.930638,10452
887883,0,0,0,4,12,16,42.926971,-76.559393,13021
921965,0,0,24,0,0,24,43.011929,-74.362976,12095
900279,16,19,19,20,0,74,42.818462,-73.773181,12085
909359,0,0,0,4,12,16,40.848667,-73.904162,10457
897526,0,0,0,4,12,16,40.842341,-73.915168,10452
889248,0,0,0,4,12,16,40.938076,-73.894972,10701
888020,0,0,0,2,6,8,42.715117,-75.535251,13332
890779,0,0,0,202,0,202,40.830751,-73.877566,10472
916445,0,0,0,115,0,115,40.935014,-73.89463,10701
917668,0,0,0,4,12,16,40.958354,-73.879192,10703
910262,0,0,0,4,12,16,40.854083,-73.914708,10453
892099,0,0,0,0,12,12,40.86307,-73.898864,10468
883933,0,0,0,49,0,49,43.019026,-76.138913,13210
896138,0,0,0,2,6,8,42.800654,-73.965635,12306
885114,0,0,0,4,12,16,40.882493,-73.879164,10467
921344,0,0,0,4,12,16,40.815517,-73.851198,10473
894909,0,0,0,125,0,125,40.574397,-73.992104,11224
924009,0,0,0,110,0,110,40.703769,-73.611575,11550
906907,0,0,0,4,12,16,40.856671,-73.861768,10462
905010,0,0,0,2,6,8,43.100953,-76.132889,13211
894396,0,0,0,4,12,16,40.688241,-73.857641,11421
890322,0,0,0,4,12,16,40.717299,-73.59154,11553
916686,0,0,0,4,12,16,40.757747,-73.82296,11355
904282,8,19,29,0,0,56,42.729397,-77.876084,14510
890958,0,0,19,0,0,19,42.149867,-76.835084,14903
896479,0,0,0,2,6,8,43.043079,-76.168969,13204
886603,0,0,0,4,12,16,40.919049,-73.898913,10705
903660,0,0,0,100,0,100,40.759265,-73.819738,11355
918384,24,60,63,21,0,168,40.842455,-73.294981,11725
897896,0,0,0,4,12,16,40.634321,-73.986699,11219
902331,0,0,0,4,12,16,40.729315,-73.718799,11426
900413,0,0,0,4,12,16,40.827616,-73.938646,10039
904073,0,0,0,4,12,16,40.68031,-73.885564,11208
901168,0,0,0,4,12,16,43.167204,-77.570242,14609
911483,0,0,0,4,12,16,40.67485,-73.854604,11417
885262,8,19,15,26,0,68,40.708648,-73.631842,11550
886492,0,0,0,4,12,16,40.833186,-73.916017,10456
896205,0,0,0,95,0,95,41.00457,-73.672907,10573
887938,0,0,0,4,12,16,40.954523,-73.838933,10710
905666,0,0,0,0,10,10,40.834381,-73.925408,10452
906277,0,0,0,4,12,16,40.855326,-73.865847,10462
906376,0,0,0,0,12,12,40.84247,-73.921852,10452
915061,0,0,0,0,10,10,40.814054,-73.957623,10027
910213,0,0,0,135,0,135,41.020158,-73.667963,10573
884059,0,0,0,2,6,8,43.104033,-74.772831,13329
904015,0,0,0,4,12,16,40.624794,-73.992245,11204
893262,0,0,0,4,12,16,40.704744,-73.879987,11385
900714,0,0,0,4,12,16,40.908913,-73.0402,11776
908418,0,0,0,4,12,16,40.932372,-73.885553,10701
909960,0,0,0,205,0,205,40.846604,-73.889908,10457
911976,0,0,0,4,12,16,40.791161,-73.850001,11356
910409,0,0,0,4,12,16,40.85119,-73.938831,10033
901036,0,0,0,10,0,10,42.898373,-75.515228,13402
913436,0,0,0,4,12,16,40.685081,-73.41162,11701
889794,0,0,0,0,12,12,40.831928,-73.869554,10472
901964,0,0,0,4,12,16,40.842909,-73.940086,10032
907140,0,0,0,150,0,150,40.681812,-73.935556,11233
903794,0,0,0,4,12,16,40.683252,-73.764047,11434
921705,0,0,0,0,12,12,40.822891,-73.950628,10031
911793,0,0,0,2,6,8,41.530158,-74.089374,12550
903066,0,0,0,4,12,16,40.704297,-73.823382,11415
899706,0,0,0,4,12,16,40.728112,-73.864246,11374
919765,0,0,0,2,6,8,40.794875,-73.26152,11717
893077,0,0,0,2,6,8,42.714828,-77.964188,14530
900649,0,0,0,4,12,16,40.837744,-73.821977,10465
890857,0,0,0,4,12,16,40.623167,-73.918477,11234
914929,0,0,0,2,6,8,40.842176,-73.897563,10457
893199,0,0,0,4,12,16,40.771948,-73.902933,11105
894516,0,0,0,60,0,60,42.742049,-74.172663,12053
895796,0,0,0,2,6,8,40.753491,-73.910129,11377
907718,0,0,0,4,12,16,40.6434,-73.9862,11218
910635,0,0,0,4,12,16,40.853214,-73.914319,10453
909596,0,0,0,2,6,8,40.888336,-73.863712,10466
886211,0,0,0,4,12,16,40.862085,-73.902622,10468
911012,0,0,0,2,6,8,42.878406,-77.280318,14424
906013,0,0,0,2,12,14,43.183803,-77.647217,14613
907481,0,0,0,132,0,132,40.688949,-73.982256,11201
896962,0,0,0,4,12,16,40.897135,-73.832791,10550
902233,0,0,0,4,12,16,41.05629,-73.960623,10913
900526,0,0,0,2,12,14,40.869272,-73.900475,10468
891986,0,0,0,4,12,16,40.856033,-73.900394,10457
917609,16,36,82,35,0,169,42.795602,-73.734316,12047
892329,0,0,0,2,6,8,42.197074,-76.535821,14883
895205,0,0,0,0,10,10,40.879216,-73.899395,10463
891744,0,0,0,0,12,12,40.626441,-74.111544,10310
890121,0,12,14,11,0,37,43.15762,-77.605377,14604
893553,0,0,0,120,0,120,40.760814,-73.950727,10044
909802,0,0,0,4,12,16,40.644753,-73.640217,11572
907593,0,0,0,4,12,16,42.788002,-73.912324,12304
911449,0,0,0,146,0,146,40.736935,-73.88733,11373
891094,0,0,0,4,12,16,40.848719,-73.90271,10457
896526,0,0,0,150,0,150,40.832775,-73.86683,10472
909157,0,0,0,4,12,16,40.757351,-73.257097,11706
912147,0,0,0,4,12,16,41.474065,-74.359492,10941
905904,0,0,0,4,12,16,40.681478,-73.885861,11208
892815,0,0,0,4,12,16,40.699818,-73.901852,11385
922473,0,0,0,40,0,40,40.8181,-72.6523,11978
890581,0,0,0,315,0,315,41.17522,-73.860372,10562
893057,0,0,0,2,6,8,40.892393,-73.849993,10466
892287,0,0,0,117,0,117,40.847022,-73.712308,11050
908980,0,0,0,4,12,16,41.128,-74.0668,10952
898498,0,0,0,40,0,40,42.108369,-75.879747,13904
909675,0,0,0,0,10,10,40.93499,-73.896162,10701
896676,0,0,0,0,10,10,40.869152,-73.902893,10468
899232,0,0,0,4,12,16,42.194335,-76.723774,14838
906106,0,3,5,0,0,8,43.061071,-76.153774,13204
895633,0,0,0,4,12,16,41.365998,-74.336318,10924
885929,0,0,0,4,12,16,43.215369,-77.652076,14616
885577,0,0,0,4,12,16,43.175265,-77.62046,14621
893902,0,0,0,4,12,16,40.826229,-73.888506,10459
891445,0,0,0,42,0,42,40.835052,-73.929273,10452
886345,0,0,0,2,6,8,40.819155,-73.850402,10473
899134,0,0,0,2,6,8,40.878009,-73.108491,11755
894629,0,0,0,4,12,16,40.68815,-73.916587,11221
883334,0,0,0,175,0,175,40.725883,-73.332028,11703
900109,0,0,0,4,12,16,40.870161,-73.879784,10467
904474,0,11,28,7,0,46,40.888555,-73.164453,11780
883427,0,0,0,4,12,16,40.747503,-73.879137,11373
895155,0,0,0,4,12,16,40.848665,-73.888179,10457
888487,0,0,0,4,12,16,40.820091,-73.901164,10459
904795,24,36,50,9,0,119,41.244474,-73.683222,10507
884700,0,0,0,4,12,16,40.703215,-73.699089,11003
898253,0,0,0,4,12,16,40.620064,-73.978807,11204
900839,0,0,0,4,12,16,40.683107,-73.762475,11434
891045,0,0,0,4,12,16,40.866821,-73.885865,10458
888089,0,0,0,4,12,16,43.245678,-77.60395,14617
900067,0,0,0,40,0,40,43.230698,-78.027997,14470
886724,8,10,26,0,0,44,40.834992,-73.62453,11545
898145,0,12,144,0,0,156,41.072465,-73.770151,10595
922686,8,12,18,6,0,44,43.175849,-76.107155,13039
885883,0,0,0,80,0,80,42.955861,-74.168337,12010
883740,0,0,0,2,6,8,41.117471,-74.012527,10954
914206,0,0,0,4,12,16,40.867756,-73.885116,10458
886914,0,0,0,44,0,44,42.985941,-78.779947,14221
917315,0,0,0,4,12,16,40.784156,-73.275831,11717
915231,0,0,0,0,12,12,40.814649,-73.891165,10474
917273,0,0,0,4,12,16,40.762311,-73.239726,11717
884994,0,0,0,2,6,8,42.149522,-74.647687,12455
886847,0,0,0,2,6,8,42.111604,-75.96358,13790
889518,0,0,0,0,12,12,40.862048,-73.870322,10467
919032,0,0,0,4,12,16,40.762813,-73.921538,11106
888912,0,0,0,40,0,40,41.925948,-74.014907,12401
913811,0,0,0,4,12,16,43.286974,-73.592015,12839
909811,0,0,0,4,12,16,40.678444,-73.740419,11413
916256,0,0,0,0,10,10,40.857839,-73.898629,10458
886956,0,0,0,2,6,8,40.858429,-73.862584,10469
915978,0,0,17,0,0,17,43.068999,-78.886649,14120
901527,0,0,0,4,12,16,40.665245,-73.88763,11207
885692,0,0,21,38,0,59,43.192154,-77.509399,14580
890691,24,46,36,0,0,106,41.525234,-74.198064,12549
883267,0,0,0,4,12,16,40.72791,-73.482979,11714
899583,0,0,0,4,12,16,40.889915,-73.852749,10466
904864,0,0,0,2,6,8,43.177279,-77.561777,14609
884486,0,0,0,81,0,81,40.72814,-73.863265,11374
903522,0,0,0,2,6,8,40.834905,-73.915712,10456
884724,0,0,0,4,12,16,40.689689,-73.619931,11550
914397,0,0,0,0,12,12,40.8286,-73.824564,10465
891001,0,0,0,4,12,16,43.18686,-77.581508,14621
904473,0,0,0,4,12,16,44.564986,-75.650359,13669
913254,0,0,0,4,12,16,40.671523,-73.575962,11575
907507,0,0,0,2,6,8,40.795042,-73.189715,11722
917461,0,0,0,4,12,16,42.959117,-74.290768,12068
889941,0,0,0,20,0,20,42.772403,-73.674189,12182
908859,0,0,0,2,6,8,42.808507,-73.931912,12307
916969,32,36,50,0,0,118,42.634114,-73.902401,12159
907303,0,0,0,4,12,16,40.672067,-73.810528,11420
883386,0,0,0,4,12,16,40.836737,-73.886871,10460
921132,0,0,0,4,12,16,42.945421,-78.791804,14215
918616,0,0,0,28,0,28,40.686119,-73.75724,11413
895448,0,0,0,305,0,305,40.783706,-73.795026,11357
903260,0,0,0,0,12,12,40.874451,-73.87746,10467
917976,0,0,0,2,12,14,40.832846,-73.917861,10456
902034,0,0,0,4,12,16,41.68391,-73.874353,12603
898978,0,0,0,4,12,16,40.843429,-73.91439,10452
917944,0,0,0,4,12,16,40.645137,-73.890835,11236
914092,0,0,0,4,12,16,42.948934,-78.871724,14211
883991,0,0,0,2,6,8,40.679905,-73.834765,11417
897340,0,0,0,0,12,12,40.891086,-73.86189,10466
918300,0,0,0,4,12,16,40.806152,-72.96639,11763
917782,0,0,0,4,12,16,40.834869,-73.862076,10462
887297,0,0,0,4,12,16,43.122461,-77.299712,14568
916405,0,0,0,4,12,16,40.718044,-73.790595,11432
907751,0,0,0,4,12,16,40.913458,-73.846133,10550
916792,0,0,0,4,12,16,40.644047,-73.603802,11510
907971,0,0,0,4,12,16,42.920606,-78.814804,14215
902567,0,0,0,4,12,16,40.687041,-73.711333,11003
885346,0,0,0,4,12,16,40.830472,-73.902734,10456
891310,0,0,0,4,12,16,40.830087,-73.86868,10472
911688,0,0,0,4,12,16,41.372539,-74.693569,12771
888145,0,0,0,2,6,8,42.95824,-78.898126,14207
887454,0,0,0,2,12,14,40.900713,-73.855124,10470
913040,0,0,0,4,12,16,40.764172,-73.531755,11801
892974,0,0,0,2,6,8,43.208435,-77.563702,14622
885520,0,0,0,4,12,16,40.892887,-73.832871,10550
901683,0,0,0,4,12,16,40.739977,-73.297475,11706
917698,0,0,0,2,8,10,40.812052,-73.905235,10455
899486,0,0,0,0,12,12,40.824398,-73.925926,10451
922872,0,0,0,4,12,16,40.726687,-73.738253,11428
885054,0,0,0,4,12,16,40.654836,-73.923151,11203
886460,0,0,0,4,12,16,43.183014,-77.603668,14621
896749,0,0,0,4,12,16,42.763928,-73.681264,12182
910040,0,0,0,4,12,16,41.001171,-73.683776,10573
883639,0,12,20,0,0,32,42.99368,-76.152696,13207
910576,0,0,0,4,12,16,42.556282,-77.717406,14437
902381,0,0,0,4,12,16,40.63721,-74.085537,10301
888860,0,0,0,0,12,12,40.825848,-73.889306,10459
907632,0,0,0,4,12,16,40.842319,-73.912583,10452
908201,0,0,0,4,12,16,40.827371,-73.875295,10472
919528,0,0,0,4,12,16,44.858611,-74.298734,12953
902805,0,0,0,4,12,16,40.864653,-73.868519,10467
909168,0,0,0,38,0,38,40.857741,-73.904076,10453
916843,0,0,0,4,12,16,42.873589,-74.309611,12010
891623,0,0,0,2,12,14,40.874146,-73.901907,10468
891356,0,0,0,0,12,12,40.877937,-73.906509,10463
910494,0,0,0,2,6,8,43.05685,-75.889019,13037
898967,0,0,0,4,12,16,40.834496,-73.919661,10452
906604,0,0,0,4,12,16,43.182571,-77.60194,14621
912370,0,0,0,4,12,16,40.634418,-73.927801,11234
887023,0,0,0,4,12,16,40.824433,-73.911875,10451
918364,0,0,0,0,12,12,40.8967,-73.845294,10466
912330,0,0,0,40,0,40,42.892787,-76.108623,13084
918136,0,0,0,2,6,8,43.187592,-77.604463,14621
916027,0,0,0,4,12,16,40.859942,-73.907261,10468
920848,0,0,0,4,12,16,40.881008,-73.905222,10463
915155,0,0,0,4,12,16,40.619066,-74.08431,10304
918787,0,0,0,2,8,10,40.712583,-73.986488,10002
921798,0,0,0,4,12,16,40.629511,-73.994038,11219
884013,0,0,0,4,12,16,42.800963,-73.927022,12304
922037,0,0,0,55,0,55,42.998751,-74.370636,12095
886185,0,20,24,0,0,44,41.656616,-74.691931,12701
894687,0,0,0,2,6,8,42.722988,-73.925788,12303
913027,0,0,0,69,0,69,40.81486,-73.920984,10451
902655,0,0,0,240,0,240,40.8223,-73.88923,10459
902161,0,0,47,0,0,47,40.67538,-73.670114,11565
896016,0,0,0,4,12,16,40.76533,-73.786216,11361
889261,16,10,14,17,0,57,44.866469,-74.783508,13613
922422,0,0,0,50,0,50,42.745045,-73.677839,12180
900228,0,0,0,0,12,12,40.838361,-73.866645,10460
897728,0,0,0,172,0,172,40.64816,-73.946123,11203
903885,0,0,0,2,6,8,43.192185,-77.608383,14621
901497,0,0,0,4,12,16,40.922888,-73.830721,10552
899600,0,0,0,4,12,16,43.183713,-77.583314,14621
888280,0,0,0,2,6,8,43.077264,-76.120932,13206
905348,0,0,0,4,12,16,40.627689,-73.992347,11219
909819,0,0,0,0,9,9,40.864671,-73.92692,10040
887810,0,0,0,4,12,16,40.850589,-73.862225,10462
891103,0,0,0,4,12,16,42.916386,-78.844861,14208
891690,0,0,0,4,12,16,40.875607,-73.876257,10467
905109,0,0,0,0,10,10,40.860321,-73.900722,10468
921631,0,0,0,2,12,14,40.840366,-73.920554,10452
916053,0,0,0,4,12,16,42.741963,-73.693684,12183
894470,0,0,0,4,12,16,40.665598,-73.883112,11207
887249,24,61,42,0,0,127,41.165143,-73.821923,10510
921443,0,0,0,4,12,16,40.757906,-73.205427,11722
901657,0,0,0,0,10,10,40.827921,-73.898859,10459
901201,0,0,0,4,12,16,43.193882,-77.62629,14615
905133,0,0,0,4,12,16,40.636684,-73.989119,11219
887504,0,0,0,4,12,16,42.638289,-73.773299,12209
895044,0,0,0,0,12,12,40.847394,-73.910197,10453
900006,0,0,0,80,0,80,42.933597,-74.633769,13339
893390,0,0,0,2,12,14,40.834597,-73.91718,10456
892906,0,0,0,4,12,16,40.767266,-73.870496,11369
906554,0,0,0,4,12,16,40.840573,-73.864416,10462
905491,0,0,0,2,12,14,40.830155,-73.901814,10455
890310,0,0,0,4,12,16,40.890344,-73.832845,10466
914815,0,0,0,4,12,16,40.830487,-73.92979,10452
915022,0,0,0,2,6,8,42.073752,-75.816123,13905
906752,0,0,0,0,10,10,40.645601,-73.943452,11203
889400,0,0,0,4,12,16,40.846232,-73.924006,10453
894850,0,0,0,0,12,12,40.860876,-73.901416,10468
905482,0,0,0,2,6,8,40.692494,-73.385467,11757
897095,0,0,0,2,6,8,40.764321,-73.566889,11590
909013,0,0,0,4,12,16,40.698373,-73.599382,11553
906742,8,12,10,7,0,37,42.904805,-76.863309,13165
906448,0,0,0,4,12,16,42.798648,-73.945515,12303
888060,0,0,0,4,12,16,41.136248,-74.055863,10977
893976,24,33,24,0,0,81,42.702264,-74.311469,12157
908394,0,0,0,4,12,16,40.670927,-73.778429,11434
895831,0,0,0,90,0,90,42.088288,-76.013718,13850
911533,0,0,0,4,12,16,40.685794,-73.787395,11434
899698,0,0,0,4,12,16,40.843564,-73.819397,10465
896975,0,0,0,2,12,14,40.889165,-73.856131,10466
905646,0,0,0,4,12,16,40.861475,-73.868306,10467
924565,0,0,0,4,12,16,40.785055,-73.84842,11356
904213,0,0,0,2,6,8,40.868511,-73.88852,10458
895932,0,0,0,0,12,12,40.826116,-73.875862,10472
889725,0,0,0,0,12,12,40.880293,-73.904535,10463
887217,0,0,0,178,0,178,40.850894,-73.887101,10458
914873,0,0,0,4,12,16,40.825071,-73.880976,10472
919623,0,0,0,60,0,60,41.371004,-74.68138,12771
900731,0,0,0,80,0,80,42.789969,-73.666233,12182
902290,0,0,0,2,12,14,43.160163,-77.654356,14606
891274,0,0,0,4,12,16,40.761519,-73.585239,11590
886164,0,0,0,38,0,38,40.651936,-73.571838,11520
899153,0,0,0,2,12,14,43.182812,-77.613935,14621
892459,0,0,0,2,10,12,40.825321,-73.918298,10451
922318,0,0,0,4,12,16,40.670659,-73.891482,11207
920210,0,0,0,50,0,50,43.448919,-76.4945,13126
892720,0,0,0,2,6,8,43.036118,-76.198723,13219
910299,0,0,0,2,6,8,42.797493,-73.961392,12306
885779,0,0,0,4,12,16,43.794667,-75.495117,13367
885296,0,0,0,4,12,16,40.852352,-73.937564,10033
893766,0,0,0,4,12,16,40.86845,-73.885386,10458
897057,8,12,18,0,0,38,42.441457,-76.031905,13803
896688,0,0,0,4,12,16,40.806039,-73.913167,10454
905803,0,0,0,2,6,8,42.772243,-73.935483,12303
896577,0,0,0,4,12,16,40.873358,-73.869439,10467
902548,0,0,0,4,12,16,42.778004,-73.714315,12047
887760,0,24,0,0,0,24,42.290552,-74.776152,13740
915639,0,0,0,2,6,8,40.929334,-73.76711,10801
920394,0,0,0,0,12,12,40.831423,-73.89207,10459
899380,4,5,12,12,0,33,41.464381,-74.036995,12553
890089,0,0,0,4,12,16,40.630484,-73.57859,11520
906301,0,0,0,0,10,10,40.826695,-73.937021,10039
888222,0,0,0,2,6,8,42.106239,-76.806503,14901
889556,0,0,0,4,12,16,40.603106,-73.752092,11691
893505,0,0,0,2,6,8,41.86711,-73.718884,12581
908453,0,0,0,124,0,124,40.577157,-73.854393,11694
922808,16,17,18,0,0,51,40.702799,-73.507597,11793
895285,0,0,0,4,12,16,40.685545,-73.646728,11552
898803,0,0,0,4,12,16,40.643479,-73.615988,11510
902973,0,0,0,4,12,16,40.870156,-73.889022,10458
891583,0,0,0,4,12,16,40.711133,-73.760481,11423
904930,0,0,0,2,6,8,42.688649,-73.803623,12205
912696,0,0,0,2,6,8,43.184438,-77.591437,14621
894235,0,0,0,2,6,8,42.071999,-76.80004,14904
904216,0,0,0,4,12,16,40.770017,-73.176671,11752
920569,0,0,0,4,12,16,40.867416,-73.851279,10469
900989,0,0,0,40,0,40,41.036211,-73.788596,10607
908666,0,0,0,4,12,16,42.134571,-77.022342,14830
917511,0,0,0,26,0,26,40.595074,-73.773976,11691
904089,0,0,0,4,12,16,40.751152,-73.590085,11590
919683,0,0,0,2,6,8,42.597962,-76.168724,13045
895783,0,0,0,4,12,16,40.74929,-73.277159,11706
901765,0,0,0,4,12,16,40.788768,-72.864239,11967
901063,0,0,0,4,12,16,40.695608,-73.390036,11757
895673,0,0,16,0,0,16,43.71462,-75.409831,13343
915823,0,0,0,4,12,16,40.844611,-73.911004,10457
914451,0,0,0,4,12,16,40.791246,-72.992826,11772
886069,0,0,0,4,12,16,40.745043,-73.819182,11355
907086,0,0,0,250,0,250,40.831208,-73.886724,10460
889155,0,0,0,0,12,12,40.824899,-73.861186,10473
892276,0,0,0,4,12,16,40.815049,-73.534042,11791
912076,0,0,0,4,12,16,40.631894,-74.030728,11209
898749,0,0,0,2,6,8,41.200767,-74.013219,10984
901240,0,0,0,4,12,16,42.796549,-73.963652,12306
892779,0,0,0,4,12,16,40.660242,-73.946834,11225
902687,0,0,0,4,12,16,40.578988,-74.000537,11224
910778,0,0,0,4,12,16,42.805666,-73.930597,12307
901340,0,0,0,4,12,16,40.887115,-73.864359,10466
884676,0,0,0,4,12,16,42.096454,-75.934577,13905
913333,0,0,0,4,12,16,40.732249,-73.799694,11365
912704,0,0,0,4,12,16,40.633657,-73.577911,11520
896377,0,0,0,0,12,12,40.841401,-73.846158,10461
906855,0,0,0,4,12,16,40.843956,-73.937864,10032
896878,0,0,0,4,12,16,40.730498,-73.822464,11367
914264,0,0,0,4,12,16,40.677847,-73.980428,11217
893900,16,10,78,0,0,104,41.428043,-74.15696,10992
909415,0,0,0,2,12,14,40.881131,-73.877586,10467
919151,0,0,0,4,12,16,40.638378,-73.982263,11218
893250,0,0,0,4,12,16,40.631964,-73.986757,11219
893794,0,0,0,0,10,10,40.831233,-73.937458,10039
911081,0,0,0,4,12,16,40.865574,-73.640863,11542
902816,0,0,0,4,12,16,40.683451,-73.607812,11510
895223,0,0,0,2,6,8,43.147595,-77.646703,14611
917083,0,0,0,4,12,16,40.692476,-73.840888,11418
901800,0,0,0,40,0,40,43.135343,-75.575049,13478
889891,0,0,0,250,0,250,40.84076,-73.882315,10460
892507,0,0,0,4,12,16,40.903737,-73.847055,10470
886811,0,0,0,4,12,16,40.663133,-73.990053,11215
910848,0,0,0,66,0,66,40.633506,-74.023068,11209
898237,0,0,0,0,12,12,40.641952,-74.011413,11220
883130,0,0,0,4,12,16,40.766989,-73.235611,11717
899361,0,0,0,4,12,16,40.87685,-73.874832,10467
910855,0,0,0,4,12,16,40.833117,-73.880551,10472
897352,0,0,0,2,6,8,40.825171,-73.916052,10451
893639,0,0,25,0,0,25,40.69456,-73.324856,11702
884915,0,0,0,0,12,12,40.738741,-73.269402,11706
908593,0,0,0,4,12,16,40.909612,-73.887477,10705
915588,0,0,71,0,0,71,42.741687,-73.660681,12180
900098,0,0,0,4,12,16,40.723201,-73.374443,11704
898801,0,0,0,4,12,16,40.713138,-73.570128,11554
892703,0,0,0,4,12,16,40.653931,-73.598378,11520
921162,0,0,0,4,12,16,40.855735,-73.907609,10453
886683,0,0,0,2,6,8,42.90518,-78.821265,14211
902004,0,0,0,4,12,16,40.830697,-73.889428,10459
919238,0,0,0,4,12,16,41.089953,-73.860678,10591
911277,0,0,0,2,6,8,41.797758,-73.83335,12578
910098,0,0,0,2,6,8,43.162142,-77.596963,14605
883553,0,0,0,4,12,16,40.652094,-73.937979,11203
894172,0,0,0,4,10,14,43.16502,-77.581759,14609
911275,8,20,15,0,0,43,42.110868,-75.937775,13905
900457,0,0,0,4,12,16,40.843999,-73.912996,10452
886409,0,0,0,2,6,8,42.995161,-76.139888,13205
912902,0,0,0,4,12,16,40.876618,-73.909795,10463
908942,0,0,0,2,6,8,40.699366,-73.344871,11704
923957,0,0,0,160,0,160,41.081892,-73.858008,10591
884786,0,0,0,4,12,16,40.764665,-73.948456,10044
915750,0,0,0,0,12,12,40.878349,-73.90668,10463
915346,0,0,0,4,12,16,42.701376,-73.782509,12205
888459,0,0,0,0,6,6,40.82159,-73.900636,10459
925100,16,12,34,0,0,62,42.080751,-78.429677,14760
884515,0,0,0,2,12,14,40.867741,-73.88177,10458
891499,0,0,0,2,6,8,40.813127,-73.907287,10455
917299,0,0,0,2,6,8,42.088663,-76.018292,13850
888656,0,0,0,4,12,16,42.78645,-73.943559,12303
900902,0,0,0,4,12,16,40.838405,-73.913594,10456
890632,0,0,0,4,12,16,40.867303,-73.924763,10034
910204,16,21,23,0,0,60,43.303618,-73.663817,12804
886907,0,0,30,0,0,30,42.076668,-74.034379,12477
893863,0,0,0,2,6,8,40.710374,-73.609428,11550
906034,0,0,0,4,12,16,40.695817,-73.94417,11206
920160,0,0,0,4,12,16,40.773012,-73.230423,11717
916936,0,0,0,4,12,16,40.664883,-73.771518,11434
887533,0,0,0,4,12,16,40.785669,-73.469236,11803
914605,0,0,0,4,12,16,40.77379,-73.741468,11363
892582,0,0,0,227,0,227,40.731797,-73.732403,11427
915100,0,0,80,0,0,80,40.766281,-73.67056,11576
916560,0,0,0,2,6,8,42.841836,-77.303546,14424
915443,0,0,0,4,12,16,40.855351,-73.913736,10453
914763,0,0,0,4,12,16,40.673653,-73.891861,11207
891407,0,0,0,30,0,30,43.070325,-75.284273,13413
897010,0,0,0,2,6,8,43.186136,-77.584596,14621
884096,0,0,0,4,12,16,40.635039,-74.153783,10303
886184,0,0,0,80,0,80,42.790419,-77.502923,14471
899100,0,0,0,4,12,16,40.705925,-73.604496,11550
887334,0,0,0,4,12,16,40.668085,-73.986122,11215
885561,0,0,0,2,6,8,43.128147,-77.647772,14619
907934,0,0,0,4,12,16,40.822874,-73.954144,10031
898194,0,0,0,4,12,16,41.157969,-74.050705,10977
912066,0,0,0,4,12,16,40.78936,-72.854084,11950
891637,0,0,0,4,12,16,40.650186,-73.590497,11520
896379,0,0,0,4,12,16,40.848086,-73.910065,10453
894473,0,0,0,0,12,12,40.820565,-73.905857,10456
916039,0,0,0,2,6,8,43.219567,-77.667103,14615
918358,0,0,0,4,12,16,40.698238,-73.612616,11550
913096,0,0,0,4,12,16,40.736089,-73.260594,11706
893412,24,12,21,20,0,77,42.519399,-76.628182,14886
903407,0,0,0,60,0,60,40.789901,-73.635058,11577
918523,0,0,0,2,6,8,42.754097,-73.679353,12180
916049,0,0,0,2,12,14,40.841858,-73.915511,10452
887469,0,0,0,37,0,37,40.7478,-73.868437,11368
896696,0,0,0,4,12,16,40.634149,-74.109946,10310
884266,0,0,0,29,0,29,40.857581,-73.897022,10458
902757,0,0,0,4,12,16,40.677055,-73.892231,11207
902576,0,0,0,4,12,16,40.692313,-73.363116,11757
885299,0,0,0,4,12,16,40.749007,-72.882063,11967
900028,0,0,0,4,12,16,40.735992,-73.313727,11703
914592,0,0,0,4,12,16,40.70757,-73.593365,11553
906532,0,0,0,2,6,8,40.932599,-73.883896,10701
916589,0,0,0,2,6,8,43.172209,-77.572656,14609
886239,8,12,15,0,0,35,44.368262,-73.395035,12996
895959,0,0,0,4,12,16,41.031271,-73.780929,10606
892157,0,0,15,0,0,15,42.518717,-76.628595,14886
883799,0,0,0,2,6,8,41.523671,-73.934145,12508
923449,0,0,0,89,0,89,40.67971,-73.587094,11575
919609,0,0,0,125,0,125,40.833288,-73.884749,10460
888072,0,0,0,4,12,16,40.753023,-73.234689,11706
890214,0,0,0,4,12,16,40.672179,-73.696364,11580
909160,0,0,0,4,12,16,40.59449,-73.776044,11691
916990,0,0,0,4,12,16,42.640948,-73.770987,12202
912456,0,0,0,2,6,8,40.790402,-72.848153,11950
894718,0,0,0,4,12,16,40.777155,-73.217538,11717
915511,0,0,0,0,12,12,40.600379,-74.132393,10314
900718,0,0,0,4,12,16,40.808982,-73.854361,10473
885002,0,0,0,0,12,12,40.861205,-73.896502,10458
897752,0,0,0,50,0,50,41.684425,-73.91085,12603
887973,0,0,0,4,12,16,40.835437,-73.871231,10472
889304,0,0,0,4,12,16,40.873107,-73.902905,10463
912988,0,0,0,4,12,16,40.782377,-73.21171,11722
922373,0,0,0,4,12,16,40.659025,-73.83328,11414
891840,0,0,0,2,6,8,43.080127,-76.151813,13208
889450,0,0,0,4,12,16,40.694695,-73.922608,11221
907530,0,0,0,4,12,16,40.757044,-73.218273,11717
893327,0,0,0,4,12,16,40.705257,-73.821083,11418
887367,0,0,0,4,10,14,43.161111,-77.638599,14606
897350,0,0,0,140,0,140,40.821641,-73.917,10451
920163,0,0,0,4,12,16,42.453294,-76.498949,14850
906424,0,0,0,4,12,16,40.846232,-73.924006,10453
914702,0,0,0,4,12,16,43.065073,-75.268262,13501
907879,0,0,0,2,6,8,40.85984,-73.907353,10453
904010,0,0,0,4,12,16,43.185225,-75.011051,13416
889071,0,0,44,0,0,44,43.025034,-76.17501,13207
897221,0,0,0,66,0,66,40.660341,-73.907249,11212
903720,0,0,0,0,12,12,40.826702,-73.908849,10456
905322,0,0,0,4,12,16,43.100794,-76.136621,13211
905770,0,0,0,30,0,30,40.922707,-72.670193,11901
887863,0,0,0,4,12,16,40.703053,-73.637291,11550
901735,0,0,0,4,12,16,40.659714,-73.577198,11520
888983,0,0,0,2,6,8,42.171321,-76.861062,14845
899295,0,0,0,4,12,16,40.808621,-73.910362,10454
900349,0,0,0,4,12,16,40.673067,-73.457651,11762
887472,16,12,0,0,0,28,42.158486,-77.093595,14870
909888,0,0,0,4,12,16,40.896775,-73.858983,10466
914869,0,8,29,0,0,37,41.938704,-73.910734,12572
901382,0,0,0,4,12,16,40.934239,-73.88491,10701
901214,0,0,0,0,10,10,40.859942,-73.907261,10468
905088,0,0,0,4,12,16,40.6915,-73.6193,11550
919966,0,0,0,2,6,8,40.763594,-73.935968,11106
895105,0,0,0,4,12,16,40.871396,-73.891172,10468
916827,8,12,22,39,0,81,40.718872,-73.306663,11706
906784,0,0,0,4,12,16,40.760391,-73.218144,11717
904180,0,0,0,4,12,16,43.215127,-77.380831,14519
903562,0,0,0,4,12,16,40.843956,-73.937864,10032
897611,0,0,0,4,12,16,40.673098,-73.583366,11575
909053,0,0,0,4,12,16,42.313316,-75.337942,13849
892747,0,0,0,4,12,16,40.662596,-73.949104,11225
895024,0,0,0,66,0,66,40.688412,-73.960093,11238
888388,0,0,0,0,10,10,40.841441,-73.91445,10452
904017,0,0,0,317,0,317,40.695133,-73.80693,11435
924463,0,0,0,110,0,110,40.695619,-73.6221,11550
910516,0,0,0,71,0,71,42.097568,-79.240172,14701
902166,0,0,0,4,12,16,40.726167,-73.731206,11426
921776,0,0,0,4,12,16,40.661504,-73.578135,11520
899538,0,0,18,0,0,18,42.861233,-78.810022,14210
914315,0,0,0,4,12,16,40.854601,-73.882385,10458
910278,0,0,0,4,12,16,40.643716,-73.590813,11520
889386,0,0,0,4,12,16,40.830235,-73.916812,10456
893053,0,0,0,4,12,16,40.712533,-73.588867,11553
892399,0,0,0,4,12,16,40.686884,-73.873925,11208
906504,0,0,0,4,12,16,40.686498,-73.877803,11208
918105,0,0,0,4,12,16,40.638458,-73.987515,11219
894404,0,0,0,2,6,8,43.586711,-76.103475,13142
888028,0,0,0,373,0,373,41.174473,-73.835345,10562
900767,0,0,0,2,6,8,40.666555,-73.875943,11208
922011,0,0,0,4,12,16,40.769677,-73.20665,11722
885234,0,0,0,4,12,16,41.203604,-73.996973,10923
889689,0,0,0,4,12,16,40.641165,-74.084087,10301
911817,0,0,0,4,12,16,41.307377,-74.203624,10950
884009,0,0,0,4,12,16,40.685065,-73.864918,11421
897271,0,0,0,2,6,8,42.096759,-76.825038,14901
888807,0,0,40,0,0,40,41.097608,-74.001057,10954
891235,0,0,0,106,0,106,40.870192,-73.853773,10469
917328,0,0,0,2,6,8,41.716531,-73.891835,12603
901528,0,0,0,80,0,80,43.23549,-76.300945,13135
914198,0,0,0,138,0,138,40.702596,-73.941469,11206
896357,0,0,0,2,6,8,40.670214,-73.904796,11212
906161,0,0,0,2,6,8,43.129977,-76.186373,13088
908539,0,0,0,2,6,8,43.187815,-77.574876,14609
886733,0,0,0,4,12,16,43.145079,-77.639246,14611
893844,0,0,0,4,12,16,40.634305,-73.910384,11236
889125,0,0,0,45,0,45,42.408448,-77.223706,14840
901123,0,0,0,4,12,16,40.919525,-73.903798,10705
895688,0,0,0,4,12,16,40.818454,-73.893534,10459
892622,0,0,0,44,0,44,42.947733,-74.197157,12010
922703,0,0,0,4,12,16,40.746658,-73.881896,11373
925531,0,0,0,172,0,172,40.6726,-73.928257,11213
907825,24,39,103,18,0,184,41.311834,-73.870173,10547
913744,0,0,0,4,12,16,40.751905,-73.872195,11372
920666,0,0,54,520,0,574,40.732584,-74.006293,10014
904350,0,0,0,4,12,16,40.637004,-73.981494,11218
899364,0,0,24,0,0,24,42.748091,-73.779075,12110
893654,32,49,72,0,0,153,41.004562,-73.813802,10583
892547,0,0,0,4,12,16,40.961166,-73.872855,10703
889593,0,0,0,2,6,8,42.641432,-73.771591,12202
887737,0,0,0,4,12,16,40.714336,-73.541315,11554
894340,0,0,0,4,12,16,40.633108,-74.152172,10303
898001,0,0,0,4,12,16,40.869843,-73.895088,10468
895565,0,0,0,2,6,8,40.860756,-73.892638,10458
908722,0,0,0,0,10,10,40.824171,-73.900869,10459
908938,0,0,0,4,12,16,40.815223,-73.499421,11791
896026,0,0,0,2,6,8,43.035646,-76.177426,13204
915850,0,0,0,0,12,12,40.839739,-73.943057,10032
921522,0,0,0,4,12,16,40.654052,-73.608274,11510
897658,0,0,144,0,0,144,41.002414,-73.670134,10573
890057,0,0,0,2,6,8,43.166926,-77.575305,14609
906363,0,0,0,4,12,16,40.87784,-73.882195,10467
898673,0,0,0,240,0,240,40.756617,-73.902468,11377
898797,0,0,0,4,12,16,43.190157,-77.608902,14621
897724,0,0,0,0,8,8,40.890004,-73.841796,10466
896947,0,0,0,4,12,16,40.593836,-73.77173,11691
908255,0,0,0,2,6,8,41.768971,-74.335729,12446
912728,0,0,0,47,0,47,40.682214,-73.916807,11233
909720,0,0,0,2,6,8,43.089609,-75.228681,13501
915088,0,0,0,4,12,16,40.812131,-73.917808,10454
895694,0,0,0,4,12,16,40.813923,-73.903573,10455
889473,0,0,0,0,12,12,42.442176,-76.525514,14850
918822,0,0,16,40,0,56,43.194817,-78.579421,14067
904899,0,0,0,140,0,140,40.601792,-73.762917,11691
913391,0,0,0,4,12,16,40.946312,-73.893987,10701
907207,0,0,0,247,0,247,40.93029,-73.898799,10701
901628,0,0,0,491,0,491,40.643456,-73.989789,11218
895259,0,0,0,138,0,138,40.669473,-73.879455,11208
894060,0,0,0,4,12,16,40.834283,-73.857231,10462
889211,0,0,0,20,0,20,43.085712,-75.653509,13421
900071,0,0,0,44,0,44,42.619113,-77.400421,14512
902867,0,0,0,202,0,202,40.763936,-73.964106,10065
898879,0,0,0,4,12,16,40.674034,-73.979146,11215
912831,0,0,0,4,12,16,40.701151,-73.630711,11550
905788,0,0,0,4,12,16,40.642,-73.987318,11218
906844,0,0,0,0,12,12,40.871684,-73.9025,10468
894838,0,0,0,4,12,16,40.946478,-72.848674,11792
902529,0,0,0,4,12,16,40.858976,-73.868446,10467
909484,0,0,0,70,0,70,40.72052,-73.719928,11001
907994,0,0,0,4,12,16,40.675726,-73.391913,11726
893107,0,0,0,31,0,31,40.69335,-73.755466,11412
887220,16,24,21,0,0,61,42.968708,-78.848138,14223
892545,0,0,16,0,0,16,43.789285,-75.494697,13367
884800,0,0,0,4,12,16,40.657202,-73.708119,11581
891990,0,0,0,240,0,240,40.828504,-73.917559,10456
908553,0,0,0,4,12,16,43.287489,-73.629366,12803
919361,0,0,0,4,12,16,40.866617,-73.891594,10458
917134,0,0,0,154,0,154,40.683237,-73.929694,11233
921488,0,0,0,2,6,8,42.205223,-76.774091,14845
903130,0,0,0,4,12,16,40.907178,-73.818713,10553
908421,0,0,0,4,12,16,40.841219,-73.925946,10452
889855,0,0,0,2,6,8,40.670099,-73.58679,11520
909172,0,0,0,4,12,16,40.843225,-73.88181,10460
901280,0,0,0,4,12,16,40.95044,-73.887733,10703
883170,0,0,0,4,12,16,40.852003,-73.912131,10453
902630,0,0,0,0,7,7,40.845181,-73.941562,10032
884320,0,0,0,4,12,16,40.708649,-73.609733,11550
902984,0,0,0,4,12,16,40.843335,-73.868722,10460
892695,0,0,0,2,12,14,40.830732,-73.853236,10472
901770,0,0,0,4,12,16,43.175746,-77.586621,14621
912233,0,0,0,4,12,16,43.185089,-77.587039,14621
923644,0,0,0,2,6,8,44.660089,-75.451278,13669
901982,0,0,0,4,12,16,40.781613,-73.228574,11717
915742,0,0,0,4,12,16,40.827471,-73.878766,10472
888155,0,0,0,4,12,16,42.307181,-73.869981,12414
897395,0,0,0,4,12,16,40.906344,-73.018998,11776
917443,0,0,0,4,12,16,42.923974,-78.820906,14215
919643,0,0,0,4,12,16,42.638396,-73.780957,12209
912939,0,0,0,2,10,12,40.836144,-73.912214,10456
911744,0,0,0,4,12,16,40.860996,-73.856266,10469
903711,0,0,0,4,12,16,40.627969,-73.982231,11204
908210,0,0,0,4,12,16,40.83822,-73.869303,10460
899460,0,0,0,191,0,191,40.797037,-73.930211,10035
910921,0,0,0,4,12,16,41.720419,-74.687662,12701
895514,0,6,18,0,0,24,41.022364,-73.794342,10530
900436,0,0,0,4,12,16,43.070135,-77.31651,14502
918575,0,0,0,4,12,16,40.711237,-73.597712,11550
915153,0,0,0,0,11,11,40.555386,-74.171174,10312
900505,0,0,0,193,0,193,40.736718,-73.813193,11367
915696,0,0,0,4,12,16,40.875201,-73.868732,10467
902932,0,0,0,4,12,16,40.755441,-73.883628,11372
883464,0,0,0,2,6,8,42.342226,-74.719905,13842
890593,0,0,0,4,12,16,40.865552,-73.887821,10458
915294,0,0,0,40,0,40,43.17437,-77.599417,14605
914637,0,0,0,4,12,16,40.759035,-73.573709,11590
906069,0,0,0,2,6,8,42.634767,-73.748054,12144
918945,0,0,0,4,12,16,40.697575,-73.851679,11421
904585,0,0,0,4,12,16,43.015407,-76.148295,13205
886508,0,0,0,4,12,16,40.86379,-73.902635,10468
911684,0,0,0,2,6,8,40.678552,-73.403922,11726
915416,0,0,0,4,12,16,40.815975,-73.86603,10473
916860,0,48,120,0,0,168,41.643037,-74.676474,12701
887596,0,0,0,4,12,16,40.697258,-73.893958,11385
888553,0,0,40,40,0,80,42.998574,-75.982742,13104
900951,22,43,42,37,0,144,40.798031,-73.173522,11749
896997,0,0,0,2,6,8,40.839803,-73.91591,10452
899651,0,0,0,4,12,16,43.129581,-75.351854,13424
907021,0,0,0,2,6,8,42.939731,-76.567075,13021
917050,0,0,0,4,12,16,40.868159,-73.889288,10458
898572,0,0,0,4,12,16,40.694979,-73.849386,11421
916176,24,60,56,0,0,140,40.872866,-73.256375,11754
920245,0,0,0,4,12,16,40.845212,-73.941795,10032
884436,0,0,0,4,12,16,42.779206,-73.894432,12304
896416,0,0,0,4,12,16,43.186348,-77.568778,14609
910153,0,0,0,4,12,16,40.787323,-73.250158,11717
911609,0,0,0,4,12,16,40.674018,-73.94788,11216
897463,0,0,0,4,12,16,40.869726,-73.857821,10469
883759,0,0,0,4,12,16,40.927381,-73.898661,10701
901838,0,0,0,4,12,16,40.647151,-74.005853,11220
884317,0,0,0,4,12,16,40.854931,-73.908387,10453
885413,0,0,0,4,12,16,43.173915,-77.577485,14609
903006,0,0,0,4,12,16,40.852671,-73.929641,10040
911899,0,0,0,4,12,16,44.701854,-75.48598,13669
896266,0,0,0,4,12,16,40.872776,-73.86167,10467
884075,0,0,0,4,10,14,42.445526,-77.157272,14840
885449,0,0,0,4,12,16,40.841704,-73.914263,10452
913676,0,0,0,4,12,16,40.848594,-73.885605,10457
894930,0,0,0,4,12,16,40.881827,-73.859449,10467
890753,16,20,32,20,0,88,42.936698,-78.783581,14225
883033,16,24,39,20,0,99,42.771166,-78.747498,14127
905404,0,0,0,4,12,16,40.845301,-73.935879,10033
901413,0,0,0,4,12,16,40.82603,-73.939939,10039
893465,0,0,0,4,12,16,40.825071,-73.880976,10472
892203,0,0,0,4,12,16,40.870023,-73.885065,10458
917162,0,0,0,4,12,16,40.803528,-73.120727,11779
895474,0,0,0,4,12,16,40.833812,-73.928172,10452
911003,0,0,0,4,12,16,40.651438,-73.910951,11236
908996,6,16,0,0,0,22,40.603091,-73.65553,11558
921904,0,0,0,45,0,45,42.328673,-79.56848,14787
911702,0,0,0,2,6,8,43.972316,-75.89594,13601
888951,8,20,39,0,0,67,42.659448,-73.755658,12210
901142,0,0,0,2,6,8,42.808084,-73.902264,12309
923560,0,0,0,2,6,8,40.866188,-73.863623,10467
886436,0,0,0,4,12,16,40.661692,-73.980956,11215
905427,0,0,0,4,12,16,40.767925,-73.740748,11363
890932,0,0,0,4,12,16,43.057784,-76.194618,13204
885164,0,0,0,4,12,16,41.657706,-73.906091,12603
903611,0,0,0,4,12,16,40.633796,-73.610815,11510
887670,0,0,0,4,12,16,40.68357,-73.880559,11208
917923,0,0,0,4,12,16,40.683175,-73.97972,11217
922170,0,0,0,4,12,16,40.72639,-73.806627,11366
916657,0,0,0,4,12,16,42.796679,-73.922139,12304
886041,0,0,0,4,12,16,42.852088,-78.802667,14210
900301,0,0,0,4,12,16,40.638357,-73.992008,11219
913180,0,0,0,4,12,16,43.171197,-77.646831,14606
916502,0,0,0,81,0,81,40.615496,-74.024954,11228
892090,0,0,0,4,12,16,43.32398,-76.584312,13074
887997,0,0,42,0,0,42,42.041508,-74.000065,12477
899030,0,0,0,4,12,16,40.624175,-73.930538,11234
889221,0,0,0,2,6,8,42.480422,-79.323269,14048
903767,0,0,0,4,12,16,40.712747,-73.611962,11550
890449,0,0,0,2,12,14,40.856706,-73.907249,10453
900425,0,0,0,4,12,16,40.82503,-73.8479,10473
918287,0,0,0,38,0,38,43.218613,-77.800305,14559
922238,0,0,0,60,0,60,42.411343,-77.416791,14809
901749,0,0,0,4,12,16,42.100003,-77.232755,14801
893179,12,17,16,20,0,65,43.043019,-76.09494,13224
903955,0,0,0,2,12,14,40.846999,-73.891772,10457
911605,16,24,20,0,0,60,42.731118,-73.687559,12180
894582,0,0,0,4,12,16,40.72265,-73.525033,11756
914146,0,0,0,4,12,16,40.869158,-73.89551,10468
895880,23,46,72,0,0,141,41.094004,-73.811568,10532
918464,0,0,0,2,6,8,42.912203,-78.855334,14208
886776,0,0,0,4,12,16,40.591185,-73.962657,11235
892989,0,0,0,40,0,40,43.010084,-78.634742,14032
906978,0,0,0,460,0,460,40.747052,-73.955326,11101
897796,0,0,0,4,12,16,43.162163,-77.683621,14606
888079,0,0,0,0,12,12,40.847342,-73.933536,10033
893308,0,0,0,2,6,8,43.164142,-76.341693,13027
907402,0,0,0,97,0,97,40.708754,-73.939801,11206
894791,0,0,0,4,12,16,40.892973,-73.859007,10466
924149,0,0,0,4,12,16,40.697384,-73.649032,11552
889327,0,0,0,4,12,16,40.665607,-73.883862,11207
913562,0,0,0,4,12,16,40.614206,-73.751816,11096
907711,0,0,0,4,12,16,40.869312,-73.894689,10468
907462,0,0,0,19,0,19,42.53862,-77.954535,14863
912000,0,0,0,4,12,16,40.635682,-73.993512,11219
900037,0,33,72,0,0,105,40.991027,-73.80298,10583
904033,0,0,0,4,12,16,40.665497,-73.957233,11225
916767,0,0,0,4,12,16,40.703827,-73.616139,11550
898421,0,0,0,4,12,16,40.635317,-73.891081,11236
892898,0,0,0,154,0,154,42.259862,-73.772465,12534
920980,0,0,0,4,12,16,40.813906,-73.904759,10455
902210,0,0,0,0,12,12,40.867741,-73.88177,10458
894576,0,0,0,2,6,8,40.784238,-73.27208,11717
910260,0,0,0,2,6,8,40.853408,-73.929102,10040
905245,0,0,0,0,12,12,40.845382,-73.920288,10452
899568,0,0,0,2,6,8,43.236411,-77.73381,14626
919811,0,0,0,4,12,16,40.612348,-73.949514,11229
914504,0,0,0,4,12,16,40.806039,-73.913167,10454
887887,0,0,0,4,12,16,40.697664,-73.394021,11757
909910,0,0,0,4,12,16,40.932286,-73.891003,10701
892289,0,0,0,153,0,153,40.817831,-73.674121,11050
910456,0,0,0,4,12,16,40.663709,-73.709174,11580
894760,0,0,0,2,6,8,42.665371,-73.777706,12206
890539,0,0,0,4,12,16,40.744002,-73.952589,11101
890794,0,0,0,0,12,12,40.828944,-73.870321,10472
888303,24,19,26,28,0,97,44.854102,-74.336199,12953
906718,0,0,0,44,0,44,40.828981,-73.888451,10459
903030,0,0,0,0,12,12,43.026098,-76.162949,13207
907573,0,0,0,4,12,16,40.811383,-73.855197,10473
889249,0,0,0,4,12,16,40.822566,-73.9152,10451
889821,0,24,101,0,0,125,41.278849,-73.786333,10598
891689,0,0,0,4,12,16,40.666598,-73.753518,11413
900654,0,0,0,0,10,10,40.837144,-73.904366,10456
892127,0,0,66,0,0,66,42.772045,-73.755487,12110
913515,0,0,0,4,12,16,40.738272,-73.557819,11590
904343,0,0,0,300,0,300,40.679779,-73.774016,11434
905678,0,0,0,4,12,16,40.76621,-73.564971,11590
904690,0,0,0,4,12,16,40.604369,-73.652742,11558
891913,0,0,0,2,6,8,41.696768,-73.934138,12601
895812,0,0,0,4,12,16,40.670068,-73.743947,11413
902271,0,0,0,4,12,16,40.679578,-73.871702,11208
885916,0,0,0,2,6,8,44.952208,-73.459417,12919
913799,0,0,0,2,6,8,43.165137,-77.553987,14609
894118,0,0,0,4,12,16,40.879655,-73.861625,10467
911339,0,0,0,4,12,16,40.669293,-73.989291,11215
899837,0,0,0,4,12,16,40.744809,-73.865739,11368
886869,0,0,0,4,12,16,40.692895,-73.865351,11421
927282,0,0,19,0,0,19,43.02158,-78.969476,14072
903067,0,0,0,4,12,16,42.085107,-75.924143,13903
892354,0,0,0,4,12,16,42.714666,-76.422119,13118
890168,0,0,15,0,0,15,43.063459,-77.232474,14522
900581,0,0,0,4,12,16,40.681305,-73.757489,11413
898361,0,0,0,2,12,14,40.848861,-73.864762,10462
895588,0,0,0,0,5,5,40.813463,-73.948227,10027
888762,0,0,0,2,6,8,41.285091,-73.921748,10566
901001,0,0,0,4,12,16,40.726948,-73.858903,11374
907504,0,0,0,4,12,16,40.665921,-73.377998,11757
915909,0,0,0,2,6,8,40.690739,-73.703712,11003
886919,0,0,0,2,12,14,40.873311,-73.902775,10463
910648,0,0,0,4,12,16,40.926078,-73.846596,10704
905104,0,0,0,0,12,12,40.831887,-73.911072,10456
887730,0,0,0,4,12,16,41.622032,-73.927065,12590
894325,16,12,36,0,0,64,42.527541,-78.448917,14009
900899,0,0,0,2,6,8,40.696484,-73.943918,11206
906225,0,0,0,4,12,16,40.63342,-73.949428,11210
886961,0,0,0,4,12,16,40.848134,-73.91804,10453
907275,0,0,0,2,6,8,42.546271,-75.081729,13796
913429,0,0,0,4,12,16,40.721989,-73.814843,11367
900160,0,0,0,4,12,16,40.664754,-73.590384,11520
900337,0,0,0,2,6,8,41.591165,-73.915135,12590
902739,0,0,0,4,12,16,42.949365,-78.903316,14207
909134,0,0,0,4,12,16,40.709013,-73.606732,11550
893739,0,0,0,4,10,14,43.171473,-77.646249,14606
918872,0,0,0,4,12,16,40.738839,-73.827278,11367
905913,0,0,0,2,10,12,40.866309,-73.902347,10468
906088,0,0,20,0,0,20,40.939567,-73.750307,10538
903523,0,0,0,4,12,16,40.820713,-73.893996,10459
904814,0,0,0,4,12,16,42.201562,-76.550236,14889
914946,0,0,0,4,12,16,40.710499,-73.942242,11206
909538,0,0,0,4,12,16,40.816784,-73.852746,10473
917572,0,0,0,40,0,40,42.821252,-78.093969,14591
911193,0,0,0,4,12,16,40.675445,-73.887915,11207
895185,0,0,0,180,0,180,40.67547,-73.816564,11420
891090,0,0,0,4,12,16,40.674873,-73.762561,11434
922561,0,0,0,4,12,16,40.770807,-73.740734,11363
884732,0,0,0,4,12,16,40.861598,-73.903227,10468
920766,0,0,0,4,12,16,40.62471,-73.988903,11204
898080,0,0,0,4,12,16,43.028036,-76.150118,13205
883383,0,0,0,4,12,16,40.871241,-73.898752,10468
883387,0,0,0,4,12,16,43.140986,-77.642449,14619
895793,0,0,0,2,10,12,40.889604,-73.832906,10466
884580,0,0,0,4,12,16,42.625632,-73.704114,12061
915358,0,0,0,2,6,8,40.624332,-73.940778,11210
909300,0,0,0,4,12,16,41.222948,-73.986542,10980
900776,0,0,0,4,12,16,40.704952,-73.561582,11554
885622,0,0,0,0,12,12,40.840125,-73.911877,10457
898858,0,0,0,4,12,16,40.838094,-73.902804,10457
902477,0,0,0,4,12,16,43.057687,-76.194019,13204
883513,0,0,0,2,6,8,42.994566,-76.145077,13205
891406,0,0,0,30,0,30,43.061257,-75.258955,13413
917625,0,0,0,4,12,16,40.695222,-73.849925,11421
884709,0,0,0,2,6,8,42.9711,-78.795932,14226
890097,0,0,0,4,12,16,40.858666,-73.899584,10468
917994,0,0,0,2,12,14,40.842341,-73.915168,10452
885723,0,0,0,4,12,16,40.698316,-73.690233,11003
883629,0,0,0,4,12,16,42.807116,-73.904614,12309
909803,0,0,0,4,12,16,40.75662,-73.926258,11106
903476,0,0,0,4,12,16,40.878464,-73.88121,10467
896110,0,0,0,2,6,8,42.015913,-79.234949,14701
919135,0,0,0,75,0,75,42.647619,-73.769779,12202
899394,0,0,0,4,12,16,40.733834,-73.879482,11373
921212,0,0,0,4,12,16,40.618134,-74.081604,10304
911460,0,0,0,4,12,16,40.699823,-73.787127,11433
888179,0,10,0,0,0,10,43.08667,-79.020885,14303
884855,0,0,0,4,12,16,40.702728,-73.597409,11553
885882,0,0,0,80,0,80,42.947733,-74.197157,12010
915703,0,0,44,0,0,44,41.469486,-74.540644,10963
917861,0,0,0,2,12,14,40.828512,-73.919086,10456
883207,0,0,0,2,6,8,40.654931,-73.875647,11239
887129,0,0,0,4,12,16,40.836894,-73.910808,10456
913327,0,0,0,4,12,16,40.633412,-73.906929,11236
896846,0,0,0,4,12,16,40.70088,-73.735204,11411
908812,0,0,0,4,12,16,42.801812,-73.938079,12307
884584,8,16,66,50,0,140,40.657836,-73.697658,11581
919422,0,0,0,4,12,16,40.870419,-73.877591,10467
907075,8,12,75,19,0,114,42.986853,-78.806967,14226
899656,0,0,0,4,12,16,40.612478,-73.93835,11234
886549,0,0,0,4,12,16,40.682399,-73.883187,11208
889990,0,0,0,2,6,8,43.482867,-75.340142,13309
918676,0,0,0,200,0,200,40.751644,-73.286679,11706
916328,0,0,0,60,0,60,42.667821,-73.756464,12210
905975,0,0,0,4,12,16,42.720011,-73.685791,12180
888522,0,0,0,4,12,16,42.973231,-76.603731,13021
888286,0,0,0,4,12,16,40.944635,-73.884313,10703
921457,0,0,0,4,12,16,40.634669,-73.975565,11218
919077,0,0,0,4,12,16,40.685675,-73.588173,11575
891027,0,0,19,40,0,59,42.170543,-75.1266,13856
888095,0,0,0,95,0,95,40.635934,-73.972181,11218
891865,0,0,0,2,6,8,42.96551,-73.784253,12020
892465,0,0,0,4,12,16,42.977874,-73.444275,12028
919240,0,0,200,0,0,200,40.817421,-73.117142,11779
916740,0,0,0,4,12,16,40.961239,-73.833494,10710
884804,0,0,0,4,12,16,40.675614,-73.798981,11436
921636,0,0,0,4,12,16,40.638533,-73.600264,11510
901642,0,0,0,4,12,16,40.689557,-73.825582,11418
915232,0,0,0,4,12,16,41.127886,-74.070484,10977
911312,0,0,0,4,12,16,43.118151,-77.731825,14624
886913,0,0,0,44,0,44,43.009842,-78.827089,14150
892704,0,0,0,4,12,16,40.900713,-73.855124,10470
889526,0,0,0,56,0,56,42.160784,-79.389291,14712
884986,0,0,0,4,12,16,40.836142,-73.927902,10452
902340,0,0,0,0,12,12,40.869763,-73.905743,10463
886807,0,0,0,2,6,8,43.076696,-76.157879,13208
924071,0,0,0,50,0,50,40.908532,-72.651575,11901
917277,0,0,0,80,0,80,42.679096,-74.498509,12043
903677,0,0,8,20,0,28,42.976612,-76.138651,13120
912903,16,30,28,20,0,94,42.115657,-75.971756,13760
913817,0,0,0,4,12,16,40.667263,-73.577199,11520
905607,0,0,0,4,12,16,40.691692,-73.36117,11757
902082,0,0,0,20,0,20,40.70485,-73.916451,11237
883293,0,0,0,2,6,8,44.615864,-75.404901,13654
899541,0,0,18,0,0,18,42.933621,-78.845497,14124
901169,0,0,0,2,6,8,40.860523,-73.907177,10468
896968,0,0,0,2,6,8,40.746926,-73.357876,11798
917516,0,0,0,40,0,40,42.681562,-73.841175,12203
883488,0,0,0,4,12,16,40.750903,-73.552612,11590
911980,0,0,0,4,12,16,40.685414,-73.860442,11421
917316,0,0,0,4,12,16,40.844326,-73.8516,10461
911950,0,0,0,4,12,16,40.840573,-73.864416,10462
891276,0,0,0,4,12,16,40.769673,-73.568177,11590
921167,0,0,0,2,6,8,40.789557,-73.005253,11772
893944,0,0,0,84,0,84,40.714833,-73.963129,11249
908814,0,0,0,4,12,16,43.083123,-76.132612,13208
922661,0,0,0,4,12,16,43.033211,-76.447961,13060
910361,0,0,0,4,12,16,40.753195,-73.534624,11801
912821,0,0,0,36,0,36,40.670854,-73.769805,11434
905186,0,0,0,4,12,16,40.74198,-73.263953,11701
890537,0,0,0,4,12,16,40.652253,-73.529293,11710
914332,0,0,0,4,12,16,40.738445,-73.854457,11368
899585,0,0,0,4,12,16,40.836348,-73.853687,10462
920460,0,0,0,4,12,16,40.833907,-73.911522,10456
908261,0,0,0,4,12,16,40.672246,-73.591214,11520
907293,0,0,0,4,12,16,40.680115,-73.766028,11434
915434,0,0,0,4,12,16,40.845653,-73.936723,10033
885788,0,0,0,4,12,16,40.917524,-73.891611,10705
900866,0,0,0,2,6,8,43.076675,-76.15323,13208
899896,0,0,0,4,12,16,40.709132,-73.558345,11554
915391,0,0,0,2,10,12,43.198886,-77.708221,14626
902513,0,0,0,4,12,16,40.710386,-73.589833,11553
917948,16,36,59,0,0,111,42.762527,-73.749106,12110
910640,0,0,0,4,12,16,40.686912,-73.792782,11434
903273,0,0,0,4,12,16,43.055015,-76.169707,13204
908655,0,0,0,0,12,12,40.831854,-73.86363,10472
909227,0,0,0,0,10,10,40.855326,-73.865847,10462
896965,0,0,0,4,12,16,41.382522,-74.682142,12771
917794,0,0,0,4,12,16,40.855778,-73.93044,10040
890092,0,0,0,0,12,12,40.897422,-73.853823,10466
891585,0,0,18,0,0,18,42.94618,-78.889665,14207
891096,0,0,0,0,12,12,40.826336,-73.87756,10472
888218,0,0,0,4,12,16,42.163749,-78.968019,14772
889779,0,0,0,2,6,8,43.408973,-75.168694,13338
888230,0,0,0,4,12,16,43.182042,-77.639249,14613
885819,0,0,0,139,0,139,40.659182,-73.922655,11212
898755,0,0,0,4,12,16,42.140819,-75.958779,13790
912148,0,0,0,0,12,12,40.867567,-73.88824,10458
914464,0,0,0,4,12,16,40.634008,-73.989349,11219
892332,0,0,0,4,12,16,40.790865,-73.655379,11577
897063,0,0,0,4,12,16,40.737439,-73.86235,11368
883613,0,0,0,4,12,16,40.686436,-73.871636,11208
920270,0,0,0,4,12,16,40.633639,-73.968828,11238
884205,0,0,0,4,12,16,40.908277,-73.880026,10705
901248,0,0,0,2,6,8,42.666153,-73.761693,12206
900352,0,0,0,4,12,16,40.854931,-73.908387,10453
922196,0,0,0,165,0,165,42.663299,-73.771096,12206
907349,0,0,0,4,12,16,40.855863,-73.899453,10457
911170,0,0,0,2,6,8,43.125118,-77.58224,14620
922497,0,0,0,120,0,120,40.708667,-73.27461,11706
902760,0,0,0,4,12,16,40.706516,-73.701342,11003
898510,0,0,0,2,12,14,40.825848,-73.889306,10459
919543,0,0,0,2,6,8,41.447206,-74.226712,10916
912292,0,0,0,0,12,12,40.653167,-73.960354,11226
893909,0,0,0,0,12,12,40.852752,-73.886006,10458
885732,0,0,0,4,12,16,40.809677,-73.919958,10454
885126,0,0,0,56,0,56,40.778156,-73.799839,11357
910915,0,0,0,60,0,60,40.755852,-73.926373,11106
895644,0,0,0,2,6,8,42.074247,-76.809895,14904
895220,0,0,0,4,12,16,40.680692,-73.576714,11575
888019,0,0,0,80,0,80,40.650905,-73.913885,11236
898146,0,0,0,4,12,16,43.141525,-77.621208,14608
885576,0,0,0,4,12,16,40.999407,-73.667042,10573
904477,0,0,0,0,6,6,40.593195,-74.077146,10305
883322,0,0,0,4,12,16,40.88155,-73.859513,10467
922406,0,0,0,100,0,100,42.91762,-76.541212,13021
914094,14,0,18,32,0,64,42.86255,-73.794394,12065
886876,0,0,0,2,6,8,41.110947,-73.995436,10954
917025,0,0,0,4,12,16,40.620285,-74.018414,11228
889050,0,0,0,4,12,16,40.859155,-73.929312,10040
897392,0,0,0,4,12,16,40.750994,-73.871661,11372
917140,0,0,0,2,12,14,40.87331,-73.905365,10463
904977,0,0,0,2,6,8,40.820148,-73.891293,10459
883755,0,0,0,4,12,16,40.722165,-73.746523,11428
886721,0,0,0,4,12,16,40.84802,-73.941116,10033
894181,0,0,0,4,12,16,40.764079,-73.884821,11370
898255,0,0,0,4,12,16,40.620064,-73.978807,11204
883169,0,0,0,4,12,16,40.666693,-73.778818,11434
905297,0,0,0,4,12,16,40.86815,-73.869121,10467
901198,0,0,0,4,12,16,40.844532,-73.862388,10462
914805,0,0,0,0,12,12,40.832302,-73.917922,10456
900086,0,0,0,4,12,16,40.721737,-73.3644,11704
887130,0,0,0,4,12,16,41.070149,-74.064589,10977
892200,0,0,0,4,12,16,40.627135,-74.142691,10302
915747,0,0,0,4,12,16,40.810482,-73.921645,10454
886613,0,0,0,4,12,16,40.690588,-73.365879,11757
883562,0,0,34,0,0,34,42.110842,-76.022134,13760
905583,0,0,0,4,12,16,43.071837,-75.29698,13413
888178,16,36,64,20,0,136,40.857414,-73.082616,11720
903485,0,0,0,4,12,16,43.180244,-77.585123,14621
906543,0,0,0,4,12,16,41.103562,-74.130505,10901
900409,0,0,0,2,12,14,40.876453,-73.902872,10463
886061,0,0,0,2,6,8,43.242675,-77.915751,14420
906264,0,0,0,4,12,16,40.829184,-72.960934,11763
915051,0,0,0,2,12,14,40.868232,-73.892298,10458
913262,0,0,0,4,12,16,40.673495,-73.784327,11434
895790,0,0,0,4,12,16,40.856637,-73.863318,10462
906407,0,12,66,19,0,97,40.697528,-73.622548,11550
896828,0,0,0,4,12,16,42.910946,-77.402363,14469
915311,0,0,0,136,0,136,40.635593,-73.886454,11236
896211,0,8,12,10,0,30,44.235322,-76.083673,13624
924563,0,0,0,4,12,16,40.636324,-73.985478,11219
888674,0,0,0,25,0,25,43.156756,-77.554372,14609
890688,0,0,0,4,12,16,40.676931,-73.581012,11575
925115,0,0,0,2,6,8,43.963185,-75.912261,13601
884541,0,0,0,4,12,16,40.83835,-73.946008,10032
918555,0,0,0,175,0,175,40.656279,-73.951479,11226
911486,0,0,0,4,12,16,40.597328,-73.78291,11691
916981,0,0,0,4,12,16,40.879723,-73.872264,10467
889793,0,0,0,4,12,16,40.719131,-73.958037,11249
901935,0,0,0,4,12,16,43.192038,-77.627218,14613
887531,0,0,0,4,12,16,40.668817,-73.579729,11520
899701,0,0,0,2,12,14,40.861598,-73.903227,10468
913760,0,0,0,2,6,8,43.252598,-77.669854,14612
914611,0,0,0,4,12,16,40.89652,-73.843345,10466
900659,0,0,0,4,12,16,42.039263,-77.284035,14801
893200,0,0,0,4,12,16,40.636183,-73.989765,11219
893771,0,0,0,0,12,12,43.049833,-76.098784,13224
918618,0,0,0,106,0,106,40.676555,-73.593592,11575
922261,0,0,0,4,12,16,40.697165,-73.664939,11552
895454,0,0,0,37,0,37,40.796437,-73.969421,10025
903037,0,0,0,2,6,8,42.802276,-73.949834,12303
896397,0,0,0,0,12,12,40.828947,-73.893112,10459
915828,16,12,16,10,0,54,43.185459,-77.693683,14626
883537,0,0,0,4,12,16,40.726253,-73.780766,11432
907734,0,0,0,4,12,16,43.070299,-76.078123,13057
911692,0,0,0,4,12,16,40.863332,-73.837212,10469
911635,0,0,0,2,10,12,43.307919,-77.911833,14464
920140,0,0,0,4,12,16,40.834597,-73.91718,10456
887277,0,0,0,4,12,16,40.720359,-73.448039,11735
903738,0,0,0,2,6,8,43.220388,-77.649998,14616
893574,0,0,0,2,6,8,43.263703,-77.699729,14612
886212,0,0,0,4,12,16,40.695909,-73.844726,11418
911072,0,0,0,4,12,16,40.764691,-73.22177,11717
905018,0,0,0,4,12,16,40.666995,-73.584843,11520
901007,0,0,0,60,0,60,42.338972,-77.32224,14810
893545,0,0,0,2,6,8,40.840776,-73.925981,10452
885408,16,24,18,0,0,58,42.124696,-77.961697,14895
922952,0,0,0,2,6,8,42.337815,-77.325948,14810
922055,0,0,0,4,12,16,40.882537,-73.90374,10463
907897,0,12,17,0,0,29,41.990517,-73.995576,12449
902225,0,0,0,4,12,16,40.717039,-73.761723,11423
892088,0,0,0,4,12,16,43.099489,-77.768748,14624
909152,0,0,0,2,6,8,44.22175,-74.443727,12986
924312,0,0,0,213,0,213,40.963585,-73.844345,10710
890928,0,0,0,2,6,8,43.097285,-79.027699,14301
884864,0,0,34,8,0,42,42.949319,-76.545928,13021
907581,0,0,0,4,12,16,40.693279,-73.785428,11433
919750,0,0,0,2,6,8,40.8276,-73.920315,10451
895652,0,0,0,50,0,50,43.127672,-75.676673,13054
889678,0,0,0,20,0,20,44.659605,-73.733109,12981
918252,0,0,0,4,12,16,40.634373,-73.703354,11557
915477,0,0,0,4,12,16,40.606454,-73.944807,11229
897787,0,0,0,4,12,16,40.708711,-73.534055,11554
908148,0,0,0,0,10,10,40.858945,-73.929306,10040
892267,0,0,0,2,6,8,43.292367,-75.46879,13440
918176,0,0,0,4,12,16,40.868323,-73.899925,10468
921969,0,0,0,37,0,37,41.370662,-73.968822,10928
899719,0,0,0,80,0,80,42.766466,-73.672102,12182
918824,0,0,0,200,0,200,40.755582,-73.274535,11706
895215,0,0,0,126,0,126,40.604164,-73.749474,11691
909351,0,0,0,4,12,16,43.548551,-73.395682,12887
904802,0,13,10,0,0,23,40.588862,-73.653668,11561
906850,0,0,0,4,12,16,40.70587,-73.640495,11552
906521,0,0,20,79,0,99,40.765448,-73.959919,10065
896677,0,0,0,4,12,16,40.860877,-73.904423,10468
886348,0,0,0,2,6,8,42.113693,-76.023976,13760
916466,0,0,0,0,12,12,40.887665,-73.86309,10466
900108,0,0,0,0,12,12,40.797937,-73.930714,10035
887996,0,12,40,0,0,52,41.289063,-73.92375,10566
883951,0,0,0,4,12,16,40.859996,-73.907652,10468
921405,0,0,0,4,10,14,40.863479,-73.922557,10034
884699,0,0,0,4,12,16,40.68878,-73.872192,11208
889322,0,0,0,4,12,16,40.67944,-73.597257,11575
908601,0,0,0,4,12,16,40.663357,-73.995519,11232
890359,0,0,0,4,12,16,41.44075,-74.383014,10940
892493,0,0,0,4,12,16,40.670687,-73.985585,11215
888545,0,0,0,4,12,16,40.799855,-73.943227,10035
894849,0,0,0,213,0,213,40.658841,-73.946393,11203
906755,0,0,0,165,0,165,40.956505,-73.895333,10701
903968,0,0,0,4,12,16,40.75205,-73.573341,11590
906898,0,0,55,0,0,55,43.014775,-73.849038,12020
906418,0,0,0,4,12,16,41.015067,-73.667789,10573
915587,0,0,0,2,6,8,40.615789,-74.08204,10304
908735,0,0,0,4,12,16,40.968709,-73.719511,10528
884909,0,0,0,4,12,16,41.095209,-74.082453,10952
895041,0,0,0,4,12,16,40.86489,-73.902864,10468
911251,0,0,0,4,12,16,40.865682,-73.646554,11542
904283,0,0,0,240,0,240,40.685085,-73.98263,11217
918797,0,0,0,154,0,154,42.339837,-78.45713,14737
891832,0,26,48,0,0,74,42.940529,-78.813395,14215
886822,0,0,0,0,12,12,40.833481,-73.857073,10462
910705,0,0,0,4,12,16,40.667746,-73.613418,11510
884798,0,0,0,4,12,16,41.602478,-73.922318,12590
891150,0,0,0,37,0,37,41.222904,-74.294828,10925
884155,0,0,0,4,12,16,40.671202,-73.886064,11207
889399,0,0,0,4,12,16,40.789255,-73.973658,10024
908944,0,0,0,4,12,16,40.762094,-73.873334,11369
901773,0,0,0,4,12,16,40.750408,-73.895409,11372
897103,0,0,0,4,12,16,40.849116,-73.912337,10453
895832,0,0,0,30,0,30,42.085378,-76.048981,13850
908202,0,0,0,2,12,14,40.827371,-73.875295,10472
917478,0,0,0,4,12,16,40.838225,-73.888436,10460
885254,0,0,0,51,0,51,40.855106,-73.901846,10453
904870,0,0,0,2,6,8,43.000627,-75.046673,13357
910242,0,0,0,4,12,16,40.652814,-73.599755,11520
916287,0,0,0,60,0,60,43.178031,-77.591906,14621
905651,16,39,76,16,0,147,41.605949,-73.837082,12590
904016,0,0,0,4,12,16,40.630538,-73.990446,11219
885685,0,23,93,57,0,173,43.195045,-77.933769,14420
905501,0,0,0,4,12,16,43.172928,-77.641861,14606
907171,0,0,0,2,6,8,40.666451,-73.582712,11520
910012,0,0,0,4,12,16,40.672501,-73.791138,11436
907510,0,0,0,4,12,16,40.640058,-73.938645,11203
902201,0,0,0,70,0,70,43.123712,-76.241687,13090
908399,0,0,0,4,12,16,40.842499,-73.888439,10460
914409,0,0,0,100,0,100,40.664266,-73.865805,11208
890633,0,0,0,4,12,16,40.807339,-73.956712,10026
914935,0,0,0,2,6,8,43.183669,-77.607007,14621
910203,0,0,0,2,6,8,40.648619,-73.895655,11236
921709,0,0,0,4,12,16,40.652756,-73.97988,11218
893855,0,0,0,2,12,14,40.84161,-73.880283,10460
899186,0,0,0,4,12,16,40.82677,-73.925507,10451
901353,24,60,103,0,0,187,41.158805,-73.98876,10956
892719,0,0,0,0,12,12,40.838126,-73.867192,10460
886894,0,0,0,4,12,16,40.788901,-73.204256,11722
911796,0,0,0,4,12,16,43.070454,-76.136746,13203
917981,0,0,0,4,12,16,40.694711,-73.953971,11205
883845,0,0,0,4,12,16,41.162708,-74.02623,10956
898548,0,0,0,4,12,16,40.752798,-73.877415,11372
921138,0,0,0,4,12,16,40.734089,-73.538241,11756
913449,0,0,0,4,12,16,40.674155,-73.431674,11758
919767,0,0,0,2,6,8,42.898998,-78.860169,14204
893092,0,14,23,0,0,37,41.025512,-73.765781,10605
890001,0,0,0,4,12,16,40.64245,-74.000169,11220
896569,0,0,0,4,12,16,40.677168,-73.88144,11208
904081,0,0,0,2,6,8,43.187967,-77.603113,14621
917721,0,0,0,4,12,16,40.856699,-73.856862,10461
886559,0,0,0,4,12,16,40.870104,-73.855336,10469
905956,0,0,0,4,12,16,43.16829,-78.681686,14094
899366,0,0,0,137,0,137,40.797335,-73.936105,10035
892593,0,0,0,4,12,16,40.66688,-73.89242,11207
892620,0,0,0,80,0,80,42.896881,-77.418682,14469
906159,0,0,0,2,6,8,40.861654,-73.928316,10040
902531,0,0,0,4,12,16,40.677381,-73.998975,11231
905835,0,0,0,4,12,16,40.8145,-73.916814,10455
898191,0,11,26,7,0,44,42.049561,-73.95844,12477
899487,0,0,0,4,12,16,40.661058,-73.890147,11207
906299,0,0,0,4,12,16,41.699566,-73.852236,12603
885350,0,0,0,0,8,8,40.869768,-73.886143,10458
915643,0,0,0,4,12,16,40.650627,-73.918586,11236
920413,0,0,0,0,12,12,40.829768,-73.870467,10472
898807,0,0,0,4,12,16,40.824899,-73.861186,10473
886476,0,0,0,2,6,8,43.110646,-79.052398,14305
887193,0,0,0,2,6,8,40.756314,-73.811523,11355
883784,0,0,0,4,12,16,40.677557,-73.864049,11208
888151,0,0,0,4,12,16,40.853195,-73.886712,10458
883090,0,0,0,2,6,8,40.813127,-73.907287,10455
900520,0,0,0,2,6,8,42.15366,-76.825395,14845
910575,0,0,0,4,12,16,40.879065,-73.823639,10475
894278,0,0,0,4,12,16,40.911595,-72.903962,11961
885451,0,0,0,4,12,16,40.698988,-73.6182,11550
904228,0,0,0,130,0,130,40.674512,-73.927978,11213
912673,0,0,0,0,11,11,40.833475,-73.879779,10472
901053,0,0,0,4,12,16,40.833416,-73.89498,10459
913879,0,0,0,2,6,8,42.756247,-77.029744,14527
890036,0,0,0,4,12,16,42.123466,-77.032211,14830
886070,0,0,0,4,12,16,40.904467,-73.85317,10470
913922,0,0,0,4,12,16,40.836968,-73.94572,10032
887678,0,0,0,120,0,120,42.085037,-78.433906,14760
916834,0,0,0,4,12,16,40.64751,-73.946113,11203
891626,0,0,0,4,12,16,40.826498,-73.914688,10451
883431,0,0,0,4,12,16,41.125005,-74.074066,10952
889152,0,0,0,0,10,10,40.815028,-73.899032,10455
893063,0,0,0,4,12,16,43.271768,-73.655321,12803
901287,0,0,0,0,12,12,40.832698,-73.92809,10452
887017,0,0,0,4,12,16,40.75544,-73.590574,11590
912888,0,0,0,4,12,16,40.832496,-73.914721,10456
912078,0,0,0,4,12,16,40.726248,-73.805298,11366
920851,0,0,0,4,12,16,40.75758,-73.585799,11590
916029,0,0,0,4,12,16,40.686315,-73.393128,11726
884041,0,0,0,4,12,16,40.646842,-73.597167,11520
888745,8,36,132,0,0,176,40.657668,-73.659756,11563
885934,0,0,0,4,12,16,40.827505,-73.827827,10465
893901,0,0,0,40,0,40,42.933953,-75.845586,13035
907093,0,0,0,0,12,12,40.838075,-73.888526,10460
885663,0,0,0,4,12,16,40.745254,-73.871432,11373
900278,0,0,0,0,12,12,40.876635,-73.900949,10463
916610,0,0,0,0,10,10,43.067101,-76.104764,13206
915179,0,0,0,4,12,16,40.844341,-73.904048,10457
885182,0,0,0,4,12,16,40.959434,-73.883944,10703
919180,0,0,0,10,0,10,42.778565,-73.902188,12304
899146,0,0,0,4,12,16,40.815752,-73.864345,10473
888488,0,0,0,4,12,16,40.828084,-73.891056,10459
913025,0,0,0,4,12,16,40.830918,-73.867248,10472
896888,0,0,0,4,12,16,40.661629,-73.882712,11207
897537,0,0,0,4,12,16,40.846067,-73.101193,11779
905337,0,0,0,21,0,21,40.820598,-73.901056,10459
902812,0,0,0,0,12,12,40.860974,-73.901055,10468
916332,0,0,0,4,12,16,40.664782,-73.991314,11215
896143,0,0,0,4,12,16,40.861906,-73.91914,10034
891454,0,0,72,0,0,72,42.961361,-77.096184,14432
903853,0,0,0,4,12,16,40.817343,-73.888663,10474
894648,0,0,0,160,0,160,40.791114,-73.943974,10029
891692,0,0,0,4,12,16,40.801014,-73.248351,11717
920260,0,0,0,4,12,16,40.863292,-73.928772,10040
900070,0,0,0,140,0,140,43.144267,-77.188172,14505
905115,0,0,0,40,0,40,40.770742,-73.981026,10023
887370,0,0,0,80,0,80,42.865378,-78.279395,14011
912368,0,0,0,4,12,16,40.596368,-73.787089,11692
890973,0,0,0,571,0,571,40.745859,-73.361987,11798
905165,0,0,0,0,12,12,40.762028,-73.74114,11362
886680,8,24,21,0,0,53,40.747123,-73.646579,11501
902003,0,0,0,4,12,16,42.620931,-78.509597,14080
897943,0,0,0,100,0,100,40.618178,-74.084487,10304
887515,0,0,0,2,6,8,44.670845,-75.30638,13658
903435,0,0,0,4,12,16,40.826573,-73.880861,10472
912192,0,0,0,2,12,14,40.867748,-73.884438,10458
893391,0,0,0,0,10,10,40.853171,-73.929685,10040
910109,0,0,0,4,12,16,40.651909,-73.582663,11520
888913,0,0,0,40,0,40,41.925466,-73.979675,12401
911534,0,0,0,2,6,8,43.060521,-73.856883,12020
890315,0,0,0,4,12,16,40.634321,-73.986699,11219
896486,0,0,0,4,12,16,40.845904,-73.883704,10460
909810,0,0,0,4,12,16,40.73022,-73.793888,11365
909834,0,0,0,2,6,8,42.255915,-78.069038,14813
914813,0,0,0,4,12,16,40.722993,-73.819241,11367
886292,7,12,39,0,0,58,41.2043,-73.998153,10923
915967,0,0,0,0,12,12,40.644621,-73.64002,11572
891417,0,0,0,4,12,16,40.670687,-73.985585,11215
886499,0,0,0,0,10,10,40.824433,-73.911875,10451
915066,0,0,0,2,6,8,43.412384,-73.273263,12832
898970,0,0,0,4,12,16,40.661956,-73.881765,11207
888069,0,0,0,4,12,16,40.669368,-73.778321,11434
906465,16,24,39,27,0,106,43.143352,-77.765616,14624
904456,0,0,0,4,12,16,40.844688,-73.887656,10460
887942,0,0,0,4,12,16,41.924841,-73.974835,12401
906740,0,0,0,4,12,16,40.630873,-73.991001,11219
910024,0,0,0,4,12,16,40.655286,-73.734956,11422
891003,0,0,0,0,10,10,40.828673,-73.832255,10465
884061,0,0,0,4,12,16,40.841203,-73.884552,10460
888593,0,0,0,4,12,16,40.692849,-73.847992,11421
904211,0,0,0,2,6,8,40.86683,-73.901349,10468
915288,0,0,0,4,12,16,40.852898,-73.900622,10457
886152,0,0,0,4,12,16,41.166368,-73.858293,10562
899654,0,0,0,2,6,8,43.025403,-76.174664,13207
903013,0,0,0,4,12,16,40.791002,-73.263718,11717
911816,0,0,0,4,12,16,40.893145,-73.858701,10466
906028,0,0,0,4,12,16,41.198441,-73.970028,10927
905983,0,0,0,80,0,80,41.292459,-73.924235,10566
901512,0,0,0,4,12,16,40.724859,-73.876587,11379
900653,0,0,0,0,12,12,40.848095,-73.890814,10457
888468,0,0,0,4,9,13,40.664341,-73.958775,11225
884513,0,0,0,4,12,16,44.004869,-75.785785,13612
890886,0,0,0,4,12,16,41.372004,-73.969549,10928
922003,0,0,0,4,12,16,40.634566,-73.975911,11218
902289,0,0,0,4,12,16,40.613072,-73.956726,11230
885235,0,0,0,4,12,16,41.200521,-73.968416,10927
894507,0,0,0,2,6,8,43.140044,-77.660736,14619
889892,0,0,20,449,0,469,40.763724,-73.957782,10065
907754,0,0,0,4,12,16,40.640562,-73.995531,11219
888798,0,0,0,30,0,30,43.838903,-73.761055,12870
911685,8,24,37,20,0,89,40.654083,-73.589767,11520
883987,0,0,0,2,6,8,42.107671,-76.248566,13827
901909,0,0,0,4,12,16,40.831614,-73.921635,10452
887442,0,0,0,4,12,16,40.687193,-73.94095,11221
891312,0,0,0,4,12,16,40.845902,-73.942126,10032
916806,0,0,0,4,12,16,42.091117,-78.456241,14760
889563,0,0,0,4,12,16,41.681156,-73.840231,12603
887768,0,0,0,4,12,16,40.605055,-73.997082,11214
883667,0,0,0,4,12,16,40.838,-73.887813,10460
914893,0,0,0,4,12,16,40.849286,-73.923007,10453
885432,0,0,0,2,6,8,40.578105,-73.991726,11224
885519,0,0,0,4,12,16,40.648227,-73.960469,11226
907486,0,0,0,4,12,16,42.341869,-75.167077,13775
913633,0,0,0,4,12,16,40.799195,-73.207646,11722
901693,0,0,0,2,12,14,40.834317,-73.918321,10452
896366,0,0,0,2,6,8,44.953322,-74.295506,12926
922754,0,0,0,85,0,85,42.289204,-77.213375,14879
911892,0,0,0,4,12,16,40.845906,-73.865541,10462
909613,0,0,0,4,12,16,40.663477,-73.588922,11520
892917,0,0,0,4,12,16,43.135201,-77.63875,14619
891752,0,0,0,2,6,8,43.033434,-76.156617,13204
914642,0,0,0,0,10,10,40.855156,-73.866542,10462
920239,0,0,0,40,0,40,41.505336,-73.956037,12508
894339,0,0,0,4,12,16,40.675441,-73.98491,11215
892352,0,0,0,4,12,16,40.821871,-73.837116,10465
918154,0,0,6,148,0,154,40.742813,-73.955094,11101
913079,0,0,0,4,12,16,40.855863,-73.896735,10457
888863,0,0,0,4,12,16,43.165713,-75.28561,13403
892052,16,30,0,0,0,46,43.083867,-78.994994,14304
920600,0,0,0,4,12,16,40.818233,-73.820756,10465
922083,0,0,0,4,12,16,42.802662,-73.937933,12307
896529,0,0,0,4,12,16,40.855957,-73.154085,11767
898968,0,0,0,4,12,16,40.869765,-73.883178,10468
890474,0,0,0,4,12,16,43.178685,-77.736492,14606
908982,0,0,0,4,12,16,40.697777,-73.898953,11385
897743,16,24,45,55,0,140,42.165744,-76.836436,14845
906176,0,0,0,4,12,16,40.701796,-73.948702,11206
910273,8,12,31,30,0,81,44.689214,-74.986501,13676
892220,0,0,0,200,0,200,40.668656,-73.983197,11215
892851,0,0,0,2,6,8,42.956566,-78.44853,14036
905910,0,0,0,2,6,8,40.825152,-73.923326,10451
910509,0,0,0,4,12,16,40.75856,-73.898482,11377
895984,0,0,0,2,6,8,43.249992,-75.458129,13440
906112,0,0,0,2,12,14,40.807992,-73.917939,10454
909074,0,0,0,2,6,8,43.121936,-75.222755,13502
889303,0,0,0,4,12,16,40.885033,-73.860035,10467
884675,0,0,0,4,12,16,40.827727,-73.876901,10472
913684,0,0,0,4,12,16,40.831623,-73.930489,10452
885074,0,0,0,2,6,8,42.195594,-77.162333,14821
894686,0,0,0,2,6,8,42.109379,-76.807263,14901
896945,0,0,0,4,12,16,42.701174,-73.634317,12198
907935,0,0,0,2,6,8,43.009595,-76.154477,13207
914266,0,0,0,4,12,16,40.86845,-73.885386,10458
884095,0,0,0,0,10,10,40.874402,-73.886978,10468
886186,0,0,0,40,0,40,42.526,-77.2897,14873
916193,0,0,0,4,12,16,40.815961,-73.903999,10455
906595,0,0,0,4,12,16,43.22425,-77.644379,14616
912714,0,0,0,4,12,16,40.871655,-73.899344,10468
887260,0,0,0,4,12,16,40.826296,-73.905818,10456
892155,0,0,0,248,0,248,40.682265,-73.749588,11413
893210,0,0,0,4,12,16,40.653885,-73.735292,11422
902676,0,0,0,2,6,8,42.746022,-73.659256,12180
911086,0,0,0,2,12,14,40.868381,-73.862613,10467
913545,0,0,0,4,12,16,43.088086,-77.421915,14450
901501,0,0,0,2,6,8,43.145665,-77.632015,14611
893804,0,12,72,0,0,84,42.969614,-73.798915,12020
909421,0,0,0,4,12,16,40.639267,-74.137824,10302
900252,0,0,0,4,12,16,40.871396,-73.891172,10468
892021,0,0,0,4,12,16,40.811966,-73.956636,10027
889421,0,0,0,4,12,16,40.875962,-73.88135,10467
887785,0,0,0,2,6,8,43.055527,-76.207012,13209
920514,0,0,18,20,0,38,42.853967,-77.713978,14480
894584,0,0,0,4,12,16,41.246242,-73.996045,10980
921485,0,0,0,4,12,16,40.85334,-73.885643,10458
911772,0,0,0,4,12,16,40.700388,-73.618806,11550
892542,0,0,0,90,0,90,40.663632,-73.893569,11207
903953,0,0,0,4,12,16,40.634566,-73.975911,11218
907522,0,0,0,4,12,16,40.685131,-73.579514,11575
894905,0,0,0,4,12,16,40.694344,-73.913555,11221
884335,8,22,46,20,0,96,43.220759,-77.942826,14420
901730,0,0,0,407,0,407,40.716789,-73.794488,11432
897009,0,0,0,0,12,12,40.82375,-73.849928,10473
907702,0,0,0,4,12,16,40.630977,-73.986638,11219
902476,0,0,0,4,12,16,40.87666,-73.874681,10467
886797,0,0,0,80,0,80,41.445173,-74.3913,10940
914143,0,0,0,0,12,12,40.837374,-73.823168,10465
906913,0,12,11,0,0,23,40.966009,-72.182042,11937
897987,0,0,0,4,12,16,40.834559,-73.920927,10452
906790,0,0,0,4,12,16,40.687048,-73.86294,11421
911276,0,0,0,4,12,16,40.884542,-73.903948,10463
907375,0,0,0,44,0,44,43.037952,-78.803263,14228
899387,0,0,0,4,12,16,40.814784,-73.924908,10451
900347,0,0,0,4,12,16,40.731743,-73.792171,11365
905484,0,0,0,2,6,8,40.849339,-73.918621,10453
892335,0,0,0,4,12,16,40.6741,-73.8375,11417
905043,0,0,0,4,12,16,40.835752,-73.915204,10456
895103,0,9,35,0,0,44,41.165025,-73.828246,10562
890459,0,0,0,20,0,20,40.67892,-73.920427,11233
891099,0,12,74,0,0,86,41.694968,-73.921853,12601
912608,0,0,36,280,0,316,40.775195,-73.953042,10028
903706,0,0,0,4,12,16,40.695781,-73.899544,11385
911741,0,0,0,0,10,10,40.805743,-73.925538,10454
919838,0,0,0,2,6,8,42.282808,-77.749507,14803
888973,0,0,0,4,12,16,42.057,-76.816288,14904
893064,0,0,0,4,12,16,40.688415,-73.906375,11207
909051,0,0,0,4,12,16,42.661219,-73.779642,12203
889539,0,0,0,289,0,289,43.128982,-77.646622,14619
895513,0,0,0,0,12,12,40.857403,-73.90214,10453
908208,0,0,0,4,12,16,40.838538,-73.866675,10460
893259,0,0,0,2,6,8,43.192881,-77.625332,14615
885716,0,0,0,2,10,12,40.85913,-73.90549,10468
897610,0,0,0,4,12,16,40.66467,-73.952991,11225
898633,0,0,0,4,12,16,40.695181,-73.689793,11003
909951,0,0,0,2,12,14,40.852031,-73.917625,10453
891490,0,0,0,4,12,16,40.831825,-73.930401,10452
915701,0,0,0,4,12,16,40.679592,-73.990398,11231
904021,0,0,0,4,12,16,40.714129,-73.613869,11550
890595,0,0,0,4,12,16,40.880519,-73.876967,10467
899786,0,0,0,4,12,16,40.712709,-73.674264,11010
904549,0,0,0,2,6,8,43.087539,-76.014304,13057
887212,0,0,0,4,12,16,40.763032,-73.82559,11354
891631,0,0,0,4,12,16,40.694885,-73.761613,11412
916331,0,0,0,4,12,16,40.716726,-73.618599,11550
903849,0,0,0,4,12,16,40.876186,-73.90377,10463
907005,0,0,0,2,6,8,43.193645,-77.566267,14609
892736,0,0,0,4,12,16,40.848177,-73.919236,10453
894662,0,0,0,4,12,16,40.690502,-73.864622,11421
885295,0,0,0,4,12,16,40.869488,-73.91547,10034
888590,0,0,0,4,12,16,40.637469,-73.922253,11234
913742,0,0,0,4,12,16,40.552562,-74.1533,10308
886743,0,0,0,2,6,8,40.87217,-73.902065,10468
892550,0,0,0,58,0,58,40.674512,-73.927978,11213
885976,0,0,0,4,12,16,40.701039,-73.817855,11418
906174,0,0,0,4,12,16,40.717856,-73.964197,11249
884437,0,0,0,4,12,16,40.643377,-73.590384,11520
917324,0,0,0,4,12,16,40.645247,-73.593991,11520
893836,0,0,15,0,0,15,42.741374,-73.8241,12205
912056,8,22,28,14,0,72,43.490846,-73.771863,12885
914750,0,0,0,4,12,16,40.771136,-73.558045,11590
888097,0,0,0,120,0,120,40.607136,-73.986663,11204
901120,0,0,0,4,12,16,40.903847,-73.869042,10704
909612,0,0,0,2,6,8,40.539078,-74.143724,10308
905794,0,0,59,0,0,59,41.140517,-74.06526,10977
892656,0,0,0,4,12,16,40.889231,-73.900206,10471
911618,0,0,0,4,12,16,42.409749,-76.477785,14850
897467,0,0,0,0,12,12,42.999652,-76.137965,13205
910119,0,0,0,2,6,8,43.224878,-75.426575,13440
903352,0,18,26,0,0,44,42.702528,-73.880927,12203
918943,0,0,0,2,12,14,40.871415,-73.905291,10463
918354,0,0,0,4,12,16,40.648075,-73.961996,11226
885918,0,0,0,2,6,8,42.95811,-78.861866,14216
897997,0,0,0,2,6,8,43.17499,-77.644558,14613
918518,0,0,0,305,0,305,40.897221,-73.790326,10801
916047,0,0,0,4,12,16,40.596445,-73.792128,11692
908936,0,0,0,40,0,40,43.346136,-73.839239,12846
904093,16,34,39,0,0,89,40.8694,-72.8872,11973
885302,0,0,0,4,12,16,40.836303,-73.887406,10460
883053,0,0,0,4,12,16,40.646388,-73.70005,11581
900557,0,0,0,80,0,80,42.910696,-78.813522,14211
896731,0,0,0,140,0,140,41.023954,-73.790908,10530
914162,0,0,0,4,12,16,40.827983,-73.923761,10452
907270,0,0,0,4,12,16,40.684268,-73.754579,11413
895570,0,0,0,4,12,16,40.877851,-73.860136,10467
898206,0,0,0,4,12,16,40.612105,-74.139809,10314
906358,0,0,0,2,6,8,40.738339,-73.515618,11756
885633,0,0,0,30,0,30,40.916983,-72.661068,11901
921041,0,0,0,4,12,16,40.674508,-73.940475,11213
891355,0,0,0,4,12,16,40.849006,-73.865376,10462
916569,0,0,0,2,6,8,43.167796,-77.652569,14606
893713,0,0,0,4,12,16,40.87762,-73.861761,10467
887598,0,0,0,4,12,16,40.880682,-73.89765,10463
914586,0,0,0,30,0,30,40.81578,-73.904055,10455
918764,0,0,0,2,6,8,42.79606,-73.953101,12303
904916,0,0,0,4,12,16,43.031753,-77.668943,14586
887054,0,0,0,2,6,8,43.371673,-75.480986,13303
905424,0,0,0,4,12,16,40.631396,-73.992522,11219
886967,0,0,0,0,12,12,40.847358,-73.897715,10457
885440,0,0,0,2,6,8,43.160273,-77.646458,14606
883844,0,0,0,4,12,16,40.831067,-73.947391,10031
889210,0,0,0,20,0,20,43.098138,-75.655801,13421
900295,0,22,0,15,0,37,41.394886,-74.463792,10973
892094,0,0,0,4,12,16,40.877292,-73.901848,10463
884761,0,0,0,26,0,26,43.151167,-77.731296,14624
910852,0,0,0,2,6,8,42.949349,-78.88166,14207
902861,0,0,0,4,12,16,40.757934,-73.9123,11103
883389,0,0,0,0,9,9,40.846043,-73.910429,10453
901342,0,0,0,129,0,129,42.441438,-76.502426,14850
900947,8,12,85,0,0,105,43.447322,-76.493952,13126
903901,0,0,0,4,12,16,40.842609,-73.914971,10452
889229,0,0,0,4,12,16,40.857847,-73.931818,10040
908574,0,0,0,4,12,16,40.613546,-73.983757,11204
920762,0,0,0,4,12,16,40.759285,-73.58317,11590
919150,0,0,0,4,12,16,40.7505,-73.873234,11372
898995,0,0,0,4,12,16,40.772681,-73.513139,11801
903126,0,0,0,4,12,16,40.69595,-73.607707,11550
897220,0,0,0,4,12,16,40.629572,-73.993973,11219
887340,0,0,0,0,12,12,40.827777,-73.881725,10472
893330,0,0,0,4,12,16,40.81319,-73.917226,10455
899650,0,0,0,4,12,16,40.826935,-73.890463,10459
921190,0,0,0,4,12,16,40.691636,-73.912719,11221
914699,0,0,0,4,12,16,41.094912,-74.074476,10952
903724,16,7,17,0,0,40,42.875427,-78.847425,14210
889859,0,0,0,2,6,8,41.344803,-73.835896,10579
902639,0,0,0,2,6,8,40.898022,-73.29598,11768
920208,0,0,0,2,6,8,40.598578,-73.794963,11692
892980,0,0,0,4,12,16,40.75463,-73.799292,11358
905766,0,0,0,2,6,8,42.657222,-73.703274,12144
887480,0,0,0,4,12,16,43.016215,-76.14964,13205
889333,0,0,0,102,0,102,40.660309,-73.890313,11207
914860,0,0,0,4,12,16,40.663281,-73.910231,11212
912252,0,0,0,4,12,16,40.802586,-73.405797,11747
899277,0,0,0,54,0,54,40.6047,-74.130941,10314
901366,0,0,0,2,6,8,40.739464,-73.359998,11798
913993,0,0,0,4,12,16,40.623723,-73.988221,11204
900034,0,0,0,4,12,16,40.855156,-73.866542,10462
909891,0,0,0,4,12,16,40.785215,-73.847084,11356
904078,0,0,0,40,0,40,40.741422,-73.821531,11367
896130,0,0,0,2,6,8,43.136802,-76.109745,13212
901979,0,0,0,4,12,16,40.850513,-73.908824,10453
916819,0,0,0,2,6,8,43.071538,-75.282854,13501
919961,0,0,0,0,9,9,40.833117,-73.876542,10472
886922,0,0,0,2,6,8,43.1114,-77.807,14514
894574,0,0,0,100,0,100,42.900734,-78.869658,14202
904178,0,0,0,4,12,16,40.674526,-73.9238,11233
894968,0,0,0,4,12,16,42.111417,-77.227372,14801
895032,0,0,0,0,12,12,40.837265,-73.911917,10456
888373,0,0,0,2,6,8,43.150138,-73.753466,12831
884712,0,0,0,4,12,16,40.679385,-73.887536,11207
922035,0,0,0,60,0,60,43.021713,-74.372125,12095
887904,0,0,0,2,6,8,40.905549,-72.631858,11901
892245,0,0,0,2,6,8,40.638446,-73.900442,11236
897847,0,0,0,4,12,16,40.616988,-73.922479,11234
914503,0,0,0,4,12,16,40.658462,-73.938855,11203
890797,0,0,0,4,12,16,40.866526,-73.88617,10458
906508,0,0,0,70,0,70,40.676152,-73.758254,11413
919415,0,0,0,4,12,16,40.73659,-73.280697,11706
906062,0,0,0,60,0,60,40.639185,-73.706978,11557
889393,0,0,0,4,12,16,40.679074,-73.846508,11417
916940,0,0,0,0,12,12,40.861411,-73.903065,10468
889255,0,0,0,22,0,22,43.158507,-77.585263,14607
918098,0,0,0,4,12,16,40.850572,-73.895245,10457
908075,0,0,0,4,12,16,40.863606,-73.863793,10467
888034,0,0,0,4,12,16,44.916966,-73.927916,12923
916340,20,25,39,0,0,84,43.044517,-76.152354,13204
902270,0,0,0,4,12,16,40.692221,-73.578612,11553
897273,0,0,0,4,12,16,40.82419,-73.860936,10473
892138,0,0,0,2,6,8,43.187097,-77.549112,14609
903560,0,0,0,140,0,140,40.693701,-73.91302,11221
886548,0,0,0,4,12,16,40.825672,-73.952272,10031
885554,0,0,0,4,12,16,40.737942,-73.368843,11704
913097,0,0,0,4,12,16,42.843182,-76.691784,13160
908519,0,0,0,4,12,16,40.882646,-73.884063,10467
900213,0,0,0,30,0,30,40.845576,-73.940248,10033
895811,0,0,0,4,12,16,43.145097,-73.748013,12831
904348,0,0,0,0,6,6,40.690878,-73.913445,11221
905677,0,0,0,4,12,16,40.794168,-73.214775,11722
894103,0,0,0,2,6,8,42.092724,-76.823505,14901
889146,0,0,0,4,12,16,40.751434,-73.854132,11368
916101,0,0,0,2,6,8,40.779083,-73.341742,11746
885183,0,0,0,4,12,16,40.851045,-73.895593,10457
887465,0,0,0,0,12,12,40.815483,-73.904693,10455
907819,0,0,0,4,12,16,40.640247,-73.939027,11203
884141,16,15,24,30,0,85,42.576073,-77.590068,14572
890985,0,0,0,2,6,8,40.678918,-73.880434,11208
898335,0,0,0,0,7,7,40.823167,-73.918167,10451
893392,0,0,0,4,12,16,40.679015,-73.994044,11231
890148,0,0,0,2,6,8,42.363296,-77.51811,14843
913682,0,0,0,4,12,16,40.732043,-73.797,11365
910046,0,0,0,2,12,14,40.87971,-73.873076,10467
903000,0,0,0,2,6,8,40.850939,-73.882572,10460
915001,0,0,0,2,6,8,42.148097,-77.047276,14830
888748,0,0,0,2,6,8,42.947844,-73.839068,12019
887742,0,0,0,4,12,16,40.852929,-73.914122,10453
905401,0,0,0,540,0,540,40.781984,-73.978039,10024
892208,0,0,0,4,12,16,40.627955,-73.989763,11219
896508,0,0,0,2,6,8,42.17093,-75.129759,13856
886283,0,0,0,4,12,16,40.832036,-73.91677,10456
884258,0,0,0,4,12,16,40.696894,-73.66384,11552
920257,0,0,0,4,12,16,40.703165,-73.700626,11003
897950,0,0,0,2,6,8,43.075951,-76.120809,13206
906662,0,0,0,4,12,16,40.851455,-73.92027,10453
894287,0,0,0,4,12,16,40.693012,-73.587342,11553
912764,0,0,0,4,12,16,40.696467,-73.902036,11385
892782,0,0,0,4,12,16,40.702437,-73.808961,11435
905942,0,0,0,4,12,16,40.791453,-73.843102,11356
909165,0,0,0,4,12,16,40.762536,-73.239699,11717
917919,0,0,0,2,12,14,40.842224,-73.88673,10460
909702,0,0,0,2,6,8,42.420832,-79.308993,14063
902708,0,0,0,4,12,16,43.306938,-73.587821,12839
886400,0,0,0,4,12,16,40.642463,-73.935405,11203
890235,0,0,0,153,0,153,40.67713,-73.883617,11208
888071,0,0,0,4,12,16,40.632659,-73.899891,11236
918060,0,0,0,4,12,16,40.690648,-73.734178,11411
913370,4,12,8,0,0,24,40.855174,-73.349754,11743
892390,0,0,0,2,6,8,43.240785,-77.664332,14616
887235,0,0,35,0,0,35,41.190655,-73.73594,10549
894714,0,0,0,4,12,16,42.408466,-79.236542,14063
891064,0,0,0,2,6,8,43.148737,-77.652468,14611
891231,0,0,0,4,12,16,40.642182,-73.896016,11236
898875,0,0,0,4,12,16,40.760978,-73.760852,11361
909485,0,0,0,90,0,90,40.727026,-73.703709,11001
885023,0,0,0,4,12,16,40.628605,-73.904815,11236
921994,0,0,0,208,0,208,40.851522,-73.91863,10453
884563,0,0,0,2,6,8,40.852834,-73.863759,10462
893095,16,17,18,0,0,51,42.975817,-78.802163,14226
913876,0,0,0,20,0,20,40.817391,-73.914322,10455
908651,0,0,0,187,0,187,40.998459,-73.671759,10573
909222,0,0,0,4,12,16,40.81431,-73.919876,10455
901748,0,0,0,2,6,8,43.20642,-76.465689,13027
898852,0,0,0,4,12,16,40.838094,-73.902804,10457
890576,0,0,0,4,12,16,40.664911,-73.770087,11434
900778,0,0,0,2,6,8,43.029282,-76.189453,13207
901279,0,0,0,4,12,16,40.827173,-73.894846,10459
906289,0,0,0,2,6,8,42.743077,-73.893942,12303
883522,0,0,0,4,12,16,40.835728,-73.884378,10460
887859,0,0,0,4,12,16,43.105123,-79.031329,14305
919401,0,0,0,2,6,8,43.16732,-77.650317,14606
889785,0,0,0,2,6,8,43.08804,-76.236111,13209
888075,0,0,0,0,10,10,40.932464,-73.888872,10701
892696,0,0,0,0,12,12,40.841502,-73.923589,10452
901050,0,0,249,0,0,249,40.773948,-73.502065,11801
888231,0,0,0,0,12,12,40.832101,-73.888494,10460
891405,0,0,0,40,0,40,43.073243,-75.323236,13413
911163,0,0,0,20,0,20,42.934622,-75.372175,13480
924217,0,0,0,86,0,86,43.16535,-77.575095,14609
889481,0,0,0,220,0,220,40.876752,-73.881476,10467
898465,0,0,0,4,12,16,40.639447,-74.001164,11219
883625,0,0,0,4,12,16,40.848714,-73.828966,10461
912968,0,0,0,2,12,14,40.860539,-73.900339,10468
918367,0,0,0,4,12,16,40.853065,-73.910083,10453
899419,0,0,0,4,12,16,40.641849,-74.084267,10301
889028,0,0,0,4,12,16,42.102032,-77.23715,14801
902748,0,0,0,127,0,127,40.795146,-73.948163,10029
907347,0,0,0,4,12,16,43.168912,-77.652974,14606
892863,0,0,0,4,12,16,41.459865,-74.09428,12553
920976,0,0,0,4,12,16,40.83647,-73.915353,10456
885881,0,0,0,20,0,20,42.940176,-74.167932,12010
883210,0,0,0,4,12,16,40.88297,-73.852358,10469
893281,0,0,0,4,12,16,40.869924,-73.870326,10467
915707,0,0,0,50,0,50,43.646154,-76.077533,13145
891558,0,0,0,4,12,16,40.696238,-73.949557,11206
910428,0,0,0,4,12,16,40.833818,-73.927875,10452
889683,0,0,0,4,12,16,41.002409,-73.670959,10573
885733,0,0,0,4,12,16,40.709611,-73.631973,11550
914314,0,0,0,4,12,16,40.63948,-73.987719,11219
899532,0,0,0,60,0,60,43.281653,-76.14974,13036
907074,0,0,0,2,6,8,42.817513,-76.070352,13020
894459,0,0,0,115,0,115,40.788741,-73.944326,10029
895217,0,0,0,0,12,12,40.849419,-73.905561,10457
884619,16,20,37,0,0,73,43.068264,-77.435286,14450
903783,16,9,0,0,0,25,40.838078,-73.707991,11050
900756,0,0,0,4,12,16,40.60761,-73.965727,11223
897050,0,0,0,4,12,16,40.828089,-73.877305,10472
889716,0,0,0,4,12,16,41.696324,-73.934626,12601
915408,0,0,0,2,6,8,40.91286,-72.637451,11901
905294,0,0,0,4,12,16,40.85658,-73.865445,10462
891663,0,0,0,4,12,16,43.191841,-77.647427,14613
917042,0,0,0,4,12,16,40.814668,-73.850445,10473
886879,0,0,0,4,12,16,40.845641,-73.822936,10465
892429,0,0,0,2,6,8,40.871703,-73.902498,10468
884003,0,0,0,16,0,16,40.757051,-73.824214,11355
899099,0,0,0,2,6,8,40.913662,-73.824011,10553
904684,0,0,0,4,12,16,42.968056,-78.660073,14031
903215,0,0,0,4,12,16,40.711485,-73.588813,11553
899496,8,11,15,0,0,34,42.846921,-73.944562,12302
917600,0,0,0,2,12,14,40.885093,-73.838306,10466
909551,0,0,0,4,12,16,40.782949,-72.860484,11967
886180,0,0,0,2,6,8,43.186778,-77.606698,14621
899833,0,0,0,4,12,16,40.699221,-73.75709,11412
926503,0,0,0,4,12,16,43.05685,-75.889019,13037
911439,40,30,57,0,0,127,42.165838,-77.110785,14870
902574,0,0,0,4,12,16,40.631609,-73.995903,11219
892293,0,0,0,120,0,120,40.780585,-73.976682,10023
895618,0,0,0,4,12,16,40.653917,-73.598503,11520
920316,0,0,0,4,12,16,40.880591,-73.858153,10467
915906,8,24,63,0,0,95,40.73841,-73.179958,11730
890059,8,17,18,0,0,43,43.033329,-75.00099,13350
910674,0,0,0,2,10,12,40.836821,-73.915875,10452
908720,0,0,0,4,12,16,42.926845,-78.827653,14215
896773,0,0,0,0,12,12,40.826095,-73.917077,10451
917233,0,0,0,4,12,16,40.835406,-73.865284,10460
905101,0,0,0,4,12,16,40.845313,-73.857604,10462
901152,0,0,0,0,12,12,40.814894,-73.915314,10455
912336,0,0,0,20,0,20,43.113096,-77.568089,14618
916988,0,0,0,0,12,12,40.697328,-73.593595,11553
900875,0,0,0,4,12,16,40.847898,-73.920919,10453
907461,0,22,0,0,0,22,41.33573,-74.160676,10950
895697,0,0,0,2,10,12,40.833608,-73.918987,10452
915086,0,0,0,4,12,16,40.812131,-73.917808,10454
907178,0,0,0,140,0,140,40.811053,-73.960845,10027
911226,0,0,0,4,12,16,40.667413,-73.375833,11757
898686,16,23,34,27,0,100,41.538335,-73.900329,12524
886859,0,0,0,92,0,92,41.572607,-74.484407,12790
895258,0,0,0,130,0,130,40.65813,-73.879358,11207
912829,0,0,0,2,6,8,42.097836,-76.063828,13760
898084,0,0,0,4,12,16,40.650729,-73.581413,11520
904975,13,11,37,0,0,61,42.772952,-73.751943,12047
885596,0,0,0,4,12,16,40.643871,-73.951895,11226
893642,0,0,0,4,12,16,40.611159,-74.071503,10305
886032,0,0,0,2,6,8,42.083661,-76.795752,14904
913240,0,0,0,74,0,74,40.730691,-74.002795,10014
913175,0,0,0,4,12,16,40.592348,-73.796912,11692
912498,0,0,0,4,12,16,41.327989,-74.184319,10950
892601,0,0,0,51,0,51,40.603825,-73.99809,11214
910831,0,0,0,2,6,8,42.1756,-76.753348,14845
910360,0,0,0,4,12,16,40.850375,-73.936906,10033
900422,0,0,0,4,12,16,40.83351,-73.93909,10032
914776,0,0,0,4,12,16,43.014943,-76.147205,13205
915372,0,0,0,4,12,16,40.909801,-73.898778,10471
911604,0,0,0,0,10,10,40.889334,-73.856069,10466
883542,20,27,52,20,0,119,43.22456,-77.323967,14519
893177,0,0,0,40,0,40,42.623558,-73.830362,12054
898244,0,0,0,2,6,8,43.137313,-76.140895,13212
909288,0,0,0,4,12,16,41.815593,-73.868868,12538
917353,0,0,0,4,12,16,42.088367,-76.820439,14901
920218,0,0,0,2,6,8,43.244261,-78.195005,14411
883668,0,0,0,4,12,16,40.85659,-73.864993,10462
924462,0,0,0,110,0,110,40.705311,-73.635346,11550
885105,0,0,0,2,6,8,40.951639,-72.912572,11778
889324,0,0,0,4,12,16,40.871226,-73.893007,10468
904059,0,0,0,0,10,10,42.121137,-75.992888,13790
901209,8,24,92,0,0,124,43.171182,-76.300187,13027
902991,0,0,0,2,6,8,44.033022,-75.841789,13616
900438,0,0,0,103,0,103,40.658832,-73.889327,11207
905604,0,0,0,4,12,16,40.876178,-73.88365,10458
907873,0,0,0,4,12,16,42.483311,-79.319742,14048
918280,0,0,0,2,8,10,40.864893,-73.924289,10034
897433,0,0,0,2,6,8,42.359905,-78.450121,14737
905015,0,0,0,4,12,16,42.725084,-73.70106,12189
901410,0,0,0,0,10,10,40.840142,-73.88168,10460
896109,0,0,0,0,10,10,41.555958,-74.049735,12550
897673,0,0,0,175,0,175,40.66348,-73.927101,11212
899708,0,0,0,4,12,16,40.734163,-73.853914,11375
915723,0,0,0,4,12,16,40.682137,-73.889431,11207
910807,0,0,0,4,12,16,42.904274,-73.93819,12019
917847,0,0,0,4,12,16,40.626212,-73.989888,11204
918599,0,0,0,4,12,16,40.752251,-73.883352,11372
915149,0,0,0,2,12,14,40.871037,-73.864405,10467
913625,0,12,0,0,0,12,40.781949,-73.475045,11803
890743,0,0,0,2,6,8,43.011639,-75.033794,13357
884881,0,0,0,4,12,16,42.415062,-73.624805,12184
886187,0,12,15,0,0,27,42.525026,-77.290087,14873
894793,0,0,0,0,12,12,40.878596,-73.862401,10467
910943,0,0,0,4,12,16,40.855616,-73.864645,10462
894783,0,0,0,4,12,16,40.858094,-73.896054,10458
887106,24,24,33,16,0,97,42.159582,-77.089476,14870
883189,0,0,0,2,6,8,40.827983,-73.920398,10451
893050,0,0,0,4,12,16,40.693356,-73.905562,11237
888294,0,0,0,4,12,16,40.702627,-73.629957,11550
886503,0,0,0,4,12,16,40.697777,-73.422224,11701
921775,0,0,0,20,0,20,42.768322,-73.687402,12047
889815,0,0,0,231,0,231,40.693294,-73.908361,11207
918685,0,0,0,4,12,16,40.751233,-73.8566,11368
916874,0,0,0,4,12,16,40.71698,-73.705066,11001
887578,0,0,0,2,6,8,43.182257,-77.582,14621
891243,0,0,0,40,0,40,40.696864,-73.65135,11552
901186,0,0,0,4,12,16,40.864504,-73.920614,10034
920472,0,0,0,4,12,16,40.833124,-73.872305,10472
914811,0,0,0,4,12,16,41.189996,-74.025769,10970
907594,0,0,0,4,12,16,40.633126,-73.982633,11204
925225,0,0,0,4,12,16,40.723585,-73.816172,11367
895682,0,0,0,4,12,16,43.168381,-77.627334,14608
895392,0,0,0,4,12,16,40.834085,-73.886328,10460
887266,0,0,0,2,12,14,43.15373,-77.634833,14611
906684,0,0,15,0,0,15,43.110207,-74.263132,12117
906101,0,0,0,2,12,14,43.167906,-77.584827,14605
884314,0,0,0,0,8,8,40.85832,-73.863257,10467
905557,0,0,0,4,12,16,40.864504,-73.920614,10034
902934,0,0,0,2,8,10,40.69417,-73.90998,11221
904446,0,0,0,4,12,16,43.286847,-77.729099,14468
896261,0,0,0,128,0,128,40.702277,-73.953024,11206
901589,0,0,0,4,12,16,40.819464,-73.922064,10451
900994,15,12,10,7,0,44,43.040139,-76.160127,13204
915859,0,0,0,60,0,60,44.134142,-75.72182,13673
886229,0,0,0,4,12,16,40.660499,-73.578811,11520
902237,0,0,0,4,12,16,40.634011,-73.999187,11219
893459,8,12,13,0,0,33,43.174369,-76.119095,13039
887328,0,0,0,2,6,8,40.730583,-73.812447,11367
888203,0,0,0,199,0,199,43.166669,-77.61052,14605
900021,0,0,52,0,0,52,40.978843,-73.68405,10580
906526,0,0,0,4,12,16,40.694611,-73.594257,11553
898780,0,0,0,4,12,16,40.739155,-73.35696,11798
910949,0,0,0,2,12,14,40.860041,-73.870507,10467
908232,0,0,0,17,0,17,40.696767,-73.897239,11385
892286,0,0,0,79,0,79,40.848743,-73.714552,11050
908993,8,7,16,10,0,41,43.233457,-77.171086,14589
909737,0,0,0,2,6,8,42.844853,-78.83168,14220
913401,0,0,0,4,12,16,40.866853,-73.930752,10034
890940,0,0,0,4,12,16,40.85296,-73.914116,10453
923485,0,0,0,2,6,8,41.525611,-73.97664,12508
900155,0,0,0,30,0,30,43.456778,-76.510961,13126
919677,0,0,0,4,12,16,40.857319,-73.901051,10453
921936,0,0,0,4,12,16,40.833456,-73.91281,10456
918878,0,0,0,4,12,16,40.644541,-73.614973,11510
918552,0,0,0,0,10,10,40.879528,-73.897211,10463
916527,0,0,0,0,12,12,40.706168,-73.587195,11553
903648,0,0,0,4,12,16,40.661406,-73.835196,11414
886426,0,0,0,4,12,16,40.831825,-73.930401,10452
894055,0,0,0,4,12,16,40.85124,-73.887965,10457
899231,0,0,0,4,12,16,40.837781,-72.867703,11967
895878,0,0,0,2,6,8,44.690238,-75.501931,13669
900717,0,0,0,4,12,16,40.884565,-73.878508,10467
895173,0,0,0,51,0,51,40.510491,-74.230731,10307
914945,0,0,0,0,10,10,40.837102,-73.906626,10456
915513,0,0,0,217,0,217,40.660086,-73.904912,11212
896467,0,0,0,4,12,16,40.664829,-73.957361,11225
889089,0,0,0,4,12,16,40.684054,-73.803845,11435
908013,0,0,0,173,0,173,41.085332,-73.862117,10591
895197,0,0,0,4,12,16,40.636985,-73.899962,11236
906825,0,0,0,2,6,8,43.058112,-76.106572,13206
888014,0,0,0,2,6,8,42.791267,-73.919682,12304
891920,0,0,0,2,6,8,42.080106,-75.956412,13850
883380,0,0,0,0,12,12,40.850282,-73.832235,10461
910641,0,0,0,2,10,12,40.836433,-73.924179,10452
903766,0,0,0,4,12,16,40.716274,-73.611522,11550
897066,0,0,0,4,12,16,40.673259,-73.883397,11208
896684,0,0,0,164,0,164,40.657119,-73.874211,11239
905841,0,0,0,0,12,12,40.856785,-73.901371,10453
902537,0,0,151,0,0,151,40.762529,-73.525898,11801
913978,0,0,0,0,12,12,40.852747,-73.898772,10457
907493,0,0,0,4,12,16,40.903266,-73.835644,10550
920714,0,0,0,0,12,12,40.833941,-73.896874,10456
908462,0,0,0,2,6,8,43.19263,-77.809244,14559
890094,0,0,0,4,12,16,40.876002,-73.858896,10469
898814,0,0,0,4,12,16,40.744897,-73.515617,11801
901011,0,0,0,2,6,8,40.68938,-73.351389,11704
915680,0,0,0,4,12,16,40.869956,-73.858654,10469
886216,0,0,0,4,12,16,40.763452,-73.881322,11369
902229,0,0,0,4,12,16,40.675034,-73.949317,11216
901759,0,0,0,140,0,140,40.757751,-73.823008,11355
925146,0,0,0,30,0,30,42.911394,-78.86148,14209
895647,0,0,0,2,6,8,43.060341,-76.100343,13206
912669,0,0,0,2,6,8,44.759795,-75.367852,13669
909153,0,0,0,4,12,16,40.921532,-73.865332,10704
904214,0,0,0,160,0,160,40.640824,-74.000648,11220
919743,0,0,0,4,12,16,40.639177,-73.95774,11226
889672,7,12,15,0,0,34,40.909237,-73.783999,10801
894218,0,0,0,4,12,16,40.571768,-74.098597,10306
915841,0,0,0,4,12,16,40.759574,-73.885923,11369
907583,0,0,0,4,12,16,40.770174,-73.089651,11716
914468,0,0,0,4,12,16,40.855401,-73.863713,10462
898758,24,36,67,14,0,141,40.768876,-73.426027,11747
902935,0,0,0,2,6,8,42.89684,-78.892175,14201
889218,0,0,0,2,6,8,44.590627,-75.167071,13617
901291,0,0,0,4,12,16,40.848342,-73.939125,10033
920779,0,0,24,0,0,24,41.508024,-73.981586,12508
892860,0,0,0,2,12,14,40.840679,-73.887986,10460
900354,22,42,90,0,0,154,40.951279,-73.827213,10707
907095,0,0,0,2,12,14,40.819911,-73.913978,10455
888711,0,0,0,2,10,12,40.817875,-73.923886,10451
908990,0,0,0,2,6,8,43.134206,-76.491598,13080
918834,0,0,0,4,12,16,43.301289,-76.417417,13069
895201,0,0,0,100,0,100,40.609302,-74.103973,10301
884649,0,0,0,0,12,12,40.825848,-73.889306,10459
895865,0,0,0,4,12,16,40.654051,-73.608274,11510
896632,0,0,0,4,12,16,41.803031,-74.877946,12791
906113,0,0,0,0,12,12,40.879116,-73.874786,10467
906849,0,0,0,2,12,14,40.61712,-74.082276,10304
888490,0,0,0,4,12,16,40.864578,-73.927924,10040
902694,0,0,0,2,6,8,43.252789,-77.638909,14612
912717,0,0,0,130,0,130,40.64911,-73.975848,11218
904734,0,0,0,2,6,8,41.367612,-73.968751,10928
898095,0,0,0,2,6,8,40.676983,-73.961764,11238
902860,0,0,0,4,12,16,43.05254,-76.128754,13203
906522,0,0,20,19,0,39,40.708788,-74.002278,10038
893135,0,0,0,4,12,16,40.660269,-73.578012,11520
911136,0,0,0,2,6,8,42.115291,-75.942833,13905
898327,0,0,0,140,0,140,40.816418,-73.922989,10451
909454,0,0,0,2,6,8,43.234502,-77.655341,14616
891461,0,0,0,4,12,16,43.144112,-77.649204,14619
900824,0,0,0,4,12,16,40.695093,-73.911599,11221
883168,0,0,0,4,12,16,40.948187,-73.87539,10701
917146,0,0,0,4,12,16,44.650905,-73.570207,12962
897391,0,0,0,4,12,16,43.337904,-75.745948,13316
919295,0,0,0,4,12,16,40.83202,-73.918583,10456
898256,0,0,0,4,12,16,40.689192,-73.869945,11208
889909,0,0,0,4,12,16,42.805658,-73.930589,12307
883758,0,0,0,4,12,16,40.843456,-73.847819,10461
899302,0,0,0,4,12,16,40.846816,-73.936196,10033
884803,0,0,0,4,12,16,41.312678,-74.176002,10950
893629,0,0,0,2,6,8,40.79191,-73.938199,10029
892477,8,10,21,0,0,39,43.009759,-78.879807,14150
894194,0,0,0,2,10,12,40.831057,-73.921963,10452
886665,0,0,0,4,12,16,40.683984,-73.800293,11436
908641,0,0,0,4,12,16,40.615001,-74.120003,10314
900092,0,0,0,4,12,16,40.641536,-73.892809,11236
901275,0,0,0,2,6,8,40.821078,-73.940211,10030
915746,0,0,0,4,12,16,40.653997,-73.663898,11563
913982,0,0,0,33,0,33,40.869263,-73.893568,10468
911254,0,0,0,4,12,16,41.699637,-73.884601,12603
892714,0,0,0,0,10,10,40.848531,-73.910394,10453
911337,0,0,0,50,0,50,40.643884,-73.979457,11218
900450,0,0,0,4,12,16,40.58626,-73.961047,11235
903492,0,0,0,2,6,8,42.15115,-78.722851,14779
913866,0,0,0,4,12,16,40.67962,-73.82842,11420
886064,0,0,0,2,6,8,40.842143,-73.91038,10457
915285,0,0,0,115,0,115,40.806248,-73.94823,10027
887132,0,0,0,4,12,16,40.849468,-73.906387,10453
888162,0,0,0,4,12,16,40.869502,-73.863183,10467
896834,0,0,0,4,12,16,40.847539,-73.906857,10457
917541,0,0,0,4,12,16,40.827983,-73.920398,10451
888470,0,0,0,0,12,12,40.839185,-73.916784,10452
913282,8,12,38,0,0,58,42.29511,-74.001205,12413
902025,0,0,0,4,12,16,40.866393,-73.930146,10034
912149,0,0,0,4,12,16,41.016583,-73.677697,10573
895792,15,23,15,0,0,53,42.049779,-73.960096,12477
916290,0,0,0,4,12,16,40.634458,-74.005054,11219
888677,16,34,34,16,0,100,42.990031,-78.757752,14221
921168,0,0,0,0,5,5,44.044067,-75.858417,13637
912775,0,0,0,4,12,16,41.440488,-74.413903,10940
918958,0,0,0,2,6,8,41.510879,-73.780722,12533
884536,0,0,0,4,12,16,43.198847,-77.689673,14626
887529,0,0,0,4,12,16,40.840759,-73.005351,11763
914670,0,0,0,4,12,16,40.635603,-73.993382,11219
883483,8,12,0,0,0,20,41.688994,-73.907564,12603
906022,0,0,0,4,12,16,40.710972,-73.805136,11432
891609,0,0,0,167,0,167,40.902492,-73.777962,10801
909493,0,0,0,2,6,8,43.194085,-77.647337,14615
919478,0,0,0,128,0,128,40.797326,-73.966628,10025
891424,0,0,0,2,6,8,40.841397,-73.867801,10460
917993,0,0,0,4,12,16,40.70929,-73.851487,11375
895456,0,0,0,4,12,16,43.128513,-76.104714,13212
892595,0,0,0,4,12,16,40.7984,-73.948331,10026
899572,0,0,0,4,12,16,42.92179,-78.848516,14208
912982,0,0,0,4,12,16,42.66573,-77.715179,14545
913086,0,0,0,4,12,16,40.864888,-73.924265,10034
916412,0,0,0,4,12,16,40.79111,-73.214469,11722
902570,0,0,0,4,12,16,40.878151,-73.864011,10467
907650,0,0,0,2,6,8,40.663759,-73.89842,11207
917966,0,0,0,2,6,8,42.692745,-74.934664,13348
891281,8,12,60,0,0,80,42.918607,-78.734797,14043
911698,0,0,0,4,12,16,40.824791,-73.881393,10472
897277,0,0,0,4,12,16,44.848399,-74.285024,12953
903225,0,0,0,40,0,40,43.272984,-73.585187,12828
919498,0,0,0,4,8,12,40.592045,-73.797824,11692
913637,0,0,0,4,12,16,40.821307,-73.906474,10456
885515,0,0,0,4,12,16,40.830474,-73.917689,10456
887276,0,0,0,4,12,16,40.676635,-73.958894,11238
885351,0,0,0,4,12,16,40.715775,-73.589559,11553
920488,0,0,0,2,6,8,40.858459,-73.900376,10468
920031,0,0,0,4,12,16,40.812828,-73.918397,10454
901699,0,0,0,0,10,10,40.871088,-73.889944,10468
922102,0,0,0,56,0,56,43.163045,-78.677956,14094
916032,0,0,0,4,12,16,40.695545,-73.610546,11550
922999,0,0,0,2,6,8,40.824433,-73.911875,10451
920240,0,0,0,40,0,40,41.49482,-73.971254,12508
907911,0,0,0,68,0,68,40.758591,-73.939372,11101
888865,0,0,0,4,12,16,40.664531,-73.854012,11414
910029,16,24,39,0,0,79,43.113096,-77.568089,14618
902345,0,0,0,2,12,14,40.86307,-73.898864,10468
920265,0,0,0,2,6,8,43.139165,-77.639211,14619
896252,0,0,0,2,6,8,40.835722,-73.914505,10456
899840,0,0,0,4,12,16,40.706357,-73.912535,11385
887189,0,0,0,2,6,8,40.873111,-72.975895,11953
906796,0,0,0,4,12,16,42.786575,-73.906148,12304
893455,0,0,0,2,6,8,42.340836,-77.329249,14810
908204,0,0,0,0,10,10,40.844384,-73.909243,10457
921950,0,0,0,4,12,16,42.803291,-73.929155,12307
919502,0,0,0,0,4,4,43.978849,-75.918721,13601
904028,0,0,0,4,12,16,40.871999,-73.880128,10467
922195,0,0,0,82,0,82,42.664086,-73.770056,12206
897734,0,0,0,4,12,16,40.81426,-73.862066,10473
903652,0,0,0,2,6,8,42.710795,-75.200349,13315
915481,0,0,0,4,12,16,40.634179,-73.891724,11236
884043,0,0,0,4,12,16,40.854652,-73.907898,10453
915185,0,0,0,4,12,16,40.641227,-73.906701,11236
894712,0,0,0,4,12,16,40.795281,-73.247706,11717
902765,16,60,112,17,0,205,40.726317,-73.716071,11001
886478,0,0,0,2,6,8,40.910011,-73.847851,10550
888074,0,0,0,4,12,16,40.725429,-73.564018,11554
892149,0,0,0,4,12,16,40.911048,-73.892962,10705
900218,0,0,0,2,12,14,40.895051,-73.857587,10466
887995,27,36,0,0,0,63,40.941265,-73.897469,10701
913190,0,0,0,4,12,16,40.703177,-73.588064,11553
910917,0,0,62,0,0,62,40.904709,-73.829463,10550
898923,0,0,0,4,12,16,40.652069,-73.672604,11563
883952,0,0,0,4,12,16,40.831,-73.846075,10462
902640,0,0,0,4,12,16,40.838235,-73.910991,10456
887441,0,0,0,4,12,16,40.824505,-73.938349,10039
885125,0,0,0,72,0,72,40.678612,-73.946748,11216
913022,0,0,0,4,12,16,40.865437,-73.88795,10458
912382,0,0,0,4,12,16,40.75724,-73.769895,11361
889319,0,0,0,0,12,12,40.869765,-73.883178,10458
901451,0,0,0,4,12,16,40.692358,-73.389269,11757
916467,0,0,0,4,12,16,40.8251,-73.894009,10459
914104,0,0,14,142,0,156,40.707121,-74.01358,10006
894464,0,0,0,4,12,16,40.861476,-73.911954,10468
903962,0,0,0,2,5,7,40.711833,-73.981749,10002
896277,0,0,0,2,6,8,42.732032,-73.660491,12180
901644,0,0,0,4,12,16,40.924868,-73.784706,10801
902328,0,0,0,0,12,12,40.893145,-73.858701,10466
921410,0,0,0,2,6,8,40.757689,-73.314828,11729
920217,0,0,0,2,6,8,42.897192,-78.818844,14212
906412,0,0,0,4,12,16,40.674,-73.8722,11208
892466,0,0,0,4,12,16,40.667,-73.899606,11207
901745,0,0,0,0,10,10,40.84654,-73.905471,10457
889465,0,0,30,0,0,30,42.871098,-78.835271,14210
891846,0,12,24,0,0,36,42.760519,-73.933025,12303
916745,0,0,0,4,12,16,40.858405,-73.906759,10453
887841,0,0,0,4,12,16,40.641803,-73.635528,11572
921661,0,0,0,90,0,90,40.674995,-73.736625,11422
905299,0,0,0,4,12,16,42.337617,-76.495028,14883
888240,0,0,0,4,12,16,40.847484,-73.908899,10453
906767,0,0,0,60,0,60,41.296961,-73.908394,10566
887525,0,0,0,4,12,16,40.701057,-73.88186,11385
899953,0,0,0,0,9,9,40.547323,-74.214219,10309
897217,0,0,0,4,12,16,40.84822,-73.827937,10461
905511,0,0,0,4,12,16,43.791654,-75.528991,13367
898468,0,0,0,4,12,16,40.82159,-73.900636,10459
909847,0,0,0,4,12,16,40.762119,-73.214178,11717
906541,0,0,0,4,12,16,40.93557,-73.885766,10701
890317,0,0,0,4,12,16,40.602533,-73.747445,11691
901166,0,0,0,4,12,16,40.879359,-73.877774,10467
895117,0,0,0,30,0,30,40.816968,-73.900704,10455
891723,0,0,0,4,12,16,44.278855,-73.418613,12936
905443,0,0,0,4,12,16,43.011857,-76.159445,13207
923575,0,0,0,4,12,16,40.684884,-73.801448,11435
885252,0,0,0,150,0,150,40.74712,-73.854377,11368
893956,0,0,0,13,0,13,40.602288,-73.751426,11691
911535,0,0,0,4,12,16,40.67008,-73.393269,11726
914546,0,0,0,0,12,12,40.818442,-73.894993,10459
897619,0,0,0,2,6,8,43.070407,-75.097524,13340
908345,0,0,0,4,12,16,40.86899,-73.92296,10034
884065,0,0,84,0,0,84,40.7352,-73.5019,11756
905185,0,0,0,4,12,16,41.128,-74.0668,10952
894813,16,22,17,0,0,55,42.876153,-78.851492,14210
918703,0,0,0,2,6,8,43.053934,-76.180958,13204
904201,0,0,0,4,12,16,40.869843,-73.895088,10468
918447,0,0,0,4,12,16,40.754799,-73.322868,11729
892718,0,0,0,4,12,16,40.759913,-73.593441,11590
896970,0,0,0,0,12,12,40.852681,-73.903796,10453
906372,0,0,0,4,12,16,40.754172,-73.864732,11368
913610,0,0,0,4,12,16,42.355576,-77.343206,14810
906726,0,0,0,0,10,10,40.830634,-73.893467,10459
899187,0,0,0,4,12,16,40.605518,-74.144617,10314
895928,0,0,0,4,12,16,40.856652,-73.900018,10457
886500,0,0,0,4,12,16,40.786422,-73.818755,11357
915072,0,0,0,4,12,16,40.670789,-73.985796,11215
891278,0,0,0,4,12,16,40.83535,-73.922553,10452
905612,0,0,0,4,12,16,40.637591,-73.998151,11219
897693,0,0,0,2,6,8,40.727481,-73.859655,11374
910252,0,0,0,2,6,8,40.853103,-73.908992,10453
901944,0,0,0,10,0,10,42.649524,-75.784316,13155
903907,0,0,0,4,12,16,40.634542,-73.985671,11219
910400,0,0,0,0,12,12,40.816362,-73.819613,10465
911806,0,0,0,60,0,60,43.231197,-76.139178,13029
900665,0,0,0,4,12,16,40.818169,-73.865233,10473
911998,0,0,0,4,12,16,40.65122,-74.010151,11232
901355,0,0,0,4,12,16,40.849981,-73.859115,10462
890532,0,0,0,2,6,8,42.122014,-77.196264,14870
913452,0,0,0,4,12,16,43.579272,-73.338717,12887
893775,0,0,0,2,6,8,40.846585,-73.906141,10457
914940,0,0,0,4,12,16,42.900374,-78.851253,14211
903042,0,0,0,2,6,8,41.589069,-73.694318,12570
922239,0,0,0,4,12,16,40.84591,-73.908244,10457
920340,0,0,0,4,12,16,40.829375,-73.919351,10456
895803,0,0,0,4,12,16,42.976022,-77.995828,14482
909607,0,0,0,4,12,16,40.655086,-73.631321,11570
899369,0,0,0,2,6,8,42.718988,-73.840894,12205
899811,0,0,0,2,6,8,41.712245,-73.878343,12603
907739,0,0,0,2,8,10,40.848289,-73.937898,10033
896368,0,0,0,4,12,16,40.855037,-73.868574,10462
888327,0,0,0,4,12,16,40.629956,-73.90044,11236
895625,0,0,0,4,12,16,40.843442,-73.868836,10460
889562,0,0,0,4,12,16,41.123195,-74.072427,10952
911074,0,0,0,4,12,16,40.880682,-73.89765,10463
892339,0,0,0,4,12,16,40.633839,-73.99438,11219
890992,0,0,0,4,12,16,40.823736,-73.914409,10451
914410,0,0,0,4,12,16,40.681115,-73.87128,11208
896960,0,0,0,4,12,16,40.67215,-73.575084,11575
909621,0,0,0,2,6,8,43.998945,-75.986843,13634
900519,0,0,0,2,10,12,40.859716,-73.894993,10458
892351,0,0,0,0,12,12,40.852375,-73.906523,10453
887746,0,0,0,4,12,16,40.870394,-73.893577,10468
905019,0,0,0,4,12,16,40.745125,-73.864655,11368
906071,0,0,0,40,0,40,41.181334,-73.77728,10514
905096,0,0,0,4,12,16,40.84591,-73.908244,10457
906158,0,0,0,4,12,16,41.061343,-73.767799,10603
907226,0,0,0,4,12,16,40.814259,-73.018803,11763
886074,0,0,0,0,10,10,40.831921,-73.863377,10472
897992,0,0,0,4,12,16,40.664705,-73.914959,11212
896521,0,0,0,4,12,16,40.746617,-73.344828,11729
891755,0,0,0,4,12,16,40.856044,-73.893385,10458
904082,0,0,0,4,12,16,43.052848,-76.129956,13204
890141,0,0,0,44,0,44,42.798672,-73.892958,12309
920613,0,0,0,4,12,16,40.791129,-73.65253,11577
900101,0,0,0,0,12,12,40.84878,-73.907274,10453
912885,0,0,0,4,12,16,40.695507,-73.955494,11205
899733,0,0,0,4,12,16,40.945515,-73.887665,10703
912870,0,0,0,4,12,16,40.866016,-73.919837,10034
906211,0,0,0,2,6,8,40.658676,-73.884085,11207
883432,0,0,0,0,10,10,40.8202,-73.902695,10459
905908,0,0,0,4,12,16,41.119437,-74.081855,10952
902266,0,0,0,4,12,16,40.841525,-73.91393,10452
904483,0,0,0,4,12,16,41.194268,-74.05793,10970
907428,0,0,0,2,6,8,43.078306,-76.149499,13208
909078,0,0,0,4,12,16,40.822891,-73.950628,10031
885949,0,0,0,0,12,12,42.329884,-75.976929,13862
893216,0,0,0,4,12,16,40.849436,-73.936609,10033
908882,0,0,0,4,12,16,40.745642,-73.197713,11752
883311,0,0,0,123,0,123,40.688479,-73.971119,11205
898332,0,0,0,4,12,16,40.630136,-73.991271,11219
898028,0,0,0,4,12,16,40.63182,-73.991632,11219
919175,0,0,0,4,12,16,40.826643,-73.925582,10451
892266,0,0,0,2,6,8,40.638541,-73.590748,11520
893689,0,0,0,114,0,114,40.597682,-74.070395,10305
885573,0,0,0,4,12,16,40.637931,-73.99649,11219
884697,0,0,0,4,12,16,40.678098,-73.605058,11510
889197,0,0,0,215,0,215,40.947187,-73.78076,10804
886353,0,0,0,4,12,16,40.832712,-73.910616,10456
919004,0,0,0,0,10,10,40.83972,-73.904329,10457
912359,0,0,0,4,12,16,40.724102,-73.746228,11428
917131,0,0,0,4,12,16,41.24432,-73.988597,10980
886716,0,0,0,4,12,16,42.304201,-75.400253,13838
912183,0,0,0,93,0,93,40.77806,-73.77731,11360
899653,0,0,0,0,10,10,40.824394,-73.915926,10451
884908,0,0,0,2,8,10,43.138709,-77.633902,14611
915633,0,0,0,4,12,16,40.869159,-73.892415,10468
903120,0,0,0,4,12,16,40.653695,-73.606899,11510
900774,0,0,0,4,12,16,40.907868,-73.832047,10550
883597,0,0,0,4,12,16,42.795529,-73.946886,12303
903469,0,24,98,0,0,122,40.65045,-73.558256,11566
923925,0,0,0,60,0,60,43.135884,-78.683739,14094
884197,0,0,0,4,12,16,40.818744,-73.86506,10473
888927,0,0,0,4,12,16,40.670573,-73.727446,11580
914229,0,0,0,2,6,8,43.180427,-77.585222,14621
901777,0,0,0,4,12,16,41.101773,-74.05681,10977
886806,0,0,0,2,6,8,40.804071,-73.13076,11779
921867,0,0,0,50,0,50,43.305971,-76.405309,13069
909814,8,0,9,0,0,17,43.084898,-76.855857,14433
917278,0,0,0,40,0,40,42.63493,-74.560086,12149
884795,0,0,0,4,12,16,40.881902,-73.880972,10467
907610,0,0,0,4,12,16,42.980111,-78.763048,14221
920873,0,0,0,30,0,30,42.74978,-73.56694,12180
884506,0,0,0,4,12,16,40.657359,-73.733716,11422
914616,0,0,0,2,12,14,40.836187,-73.918138,10452
895505,0,0,0,0,8,8,40.865552,-73.887821,10458
911737,0,0,0,2,6,8,43.18244,-77.646779,14613
901516,0,0,0,4,12,16,40.709498,-73.585622,11553
898522,0,0,0,2,6,8,40.740598,-73.275903,11706
904460,0,0,0,65,0,65,40.677102,-74.011444,11231
889944,0,0,33,7,0,40,41.599922,-74.287733,12566
918562,0,0,0,4,12,16,40.601515,-74.078831,10305
886890,0,0,0,4,12,16,40.829629,-73.882129,10472
916005,0,0,0,20,0,20,42.128087,-76.028132,13760
890648,0,0,0,4,12,16,40.854871,-73.933669,10040
919000,0,0,0,2,6,8,40.682772,-73.60002,11575
917490,0,0,16,0,0,16,42.103895,-76.045779,13760
890600,0,0,0,4,12,16,40.69669,-73.600233,11553
908816,0,0,0,4,12,16,40.707286,-73.914847,11385
907511,0,0,0,4,12,16,42.65558,-73.791303,12208
883301,0,0,0,0,10,10,40.843859,-73.883152,10460
892619,0,0,0,70,0,70,42.89204,-77.279435,14424
898972,0,0,0,4,12,16,40.681957,-73.98318,11217
913750,0,0,0,2,6,8,44.752245,-74.994041,13668
904898,0,0,0,198,0,198,40.595896,-73.781708,11691
905986,0,0,0,60,0,60,41.278704,-73.923308,10566
907294,0,0,0,4,12,16,40.602789,-73.748259,11691
915430,0,0,0,4,12,16,40.773709,-73.846728,11354
907761,0,0,0,2,6,8,40.820352,-73.894108,10459
913882,0,0,0,4,12,16,40.87058,-73.901887,10468
903194,0,0,0,2,6,8,42.756028,-73.679544,12180
883123,0,0,0,4,12,16,40.637591,-73.998151,11219
901905,0,0,0,4,12,16,40.792131,-73.247668,11717
883768,0,0,0,20,0,20,40.955698,-73.868977,10710
892919,0,0,0,4,12,16,41.368377,-73.753872,10541
914037,0,0,0,0,8,8,40.837019,-73.890128,10460
898176,0,0,0,4,12,16,41.435315,-74.401,10940
900271,0,0,0,2,6,8,43.009696,-76.144891,13205
904012,0,0,0,0,12,12,40.818307,-73.815449,10465
916605,0,0,0,0,9,9,40.850408,-73.913795,10453
907173,0,0,0,4,12,16,40.639104,-73.985559,11218
908185,0,0,0,0,12,12,43.030047,-76.154673,13205
911893,0,0,0,4,12,16,40.832396,-73.872149,10472
888153,0,0,0,4,12,16,43.187109,-77.575259,14609
918505,0,0,0,2,6,8,40.679625,-73.921575,11233
912054,0,0,0,4,12,16,41.005187,-73.676547,10573
885815,0,0,0,4,12,16,40.853948,-73.937442,10033
884208,0,0,0,0,12,12,40.849345,-73.910088,10453
883612,0,0,0,4,12,16,40.850002,-73.896129,10457
892044,0,0,0,0,10,10,40.838684,-73.912632,10456
886562,0,0,0,0,12,12,40.829299,-73.892083,10459
885400,0,0,0,80,0,80,41.448289,-74.450965,10940
885452,0,0,0,2,10,12,40.848505,-73.920668,10453
913554,0,0,0,4,12,16,40.754758,-73.779561,11361
907355,0,0,16,0,0,16,42.534128,-78.410902,14009
903587,0,0,0,4,12,16,40.6837,-73.842554,11416
920821,0,0,0,20,0,20,42.253433,-78.649909,14536
886982,0,0,0,60,0,60,42.733123,-73.845391,12205
887689,0,0,0,4,12,16,41.933793,-74.005466,12401
910277,0,0,0,4,12,16,41.603339,-73.868873,12590
922122,0,0,0,40,0,40,41.02574,-72.471306,11935
901124,0,0,0,0,10,10,40.859982,-73.910109,10453
885179,0,0,0,2,12,14,40.662941,-73.894742,11207
917682,0,0,0,4,12,16,40.827821,-73.869454,10472
889285,0,0,0,2,6,8,40.643903,-73.926439,11203
922382,0,0,0,516,0,516,40.72081,-73.861368,11374
895986,0,0,0,4,12,16,40.619894,-73.937172,11234
907962,0,0,0,84,0,84,40.738861,-73.821295,11367
897538,0,0,0,4,12,16,40.694231,-73.610311,11550
892141,0,0,0,4,12,16,40.721998,-73.70504,11001
916185,0,0,0,2,12,14,40.852289,-73.927514,10040
906596,0,0,0,4,12,16,40.625882,-73.981807,11204
896146,0,0,0,4,12,16,40.841092,-73.926026,10452
909399,0,0,0,2,6,8,43.013835,-76.284612,13215
903861,0,0,0,4,12,16,41.123571,-74.068684,10952
921308,8,24,36,20,0,88,42.825081,-73.733701,12065
900394,0,0,0,80,0,80,42.976301,-75.599379,13409
894841,0,0,0,4,12,16,40.746576,-73.239337,11706
893367,0,0,0,4,12,16,42.767252,-73.679093,12180
887387,0,0,0,40,0,40,40.830378,-73.87245,10472
906899,0,0,0,4,12,16,43.165508,-78.701624,14094
904983,0,0,0,4,10,14,42.911766,-75.148237,13491
905174,0,0,0,2,6,8,42.107435,-75.968284,13790
895051,0,0,0,66,0,66,41.073924,-73.814158,10523
899524,0,0,0,4,12,16,41.124905,-74.077462,10952
890333,0,0,0,4,12,16,43.21556,-75.461014,13440
885666,0,0,0,4,12,16,40.635292,-73.990787,11219
918790,0,0,0,4,12,16,40.673526,-73.914902,11233
886649,0,0,0,4,12,16,40.658783,-73.58189,11520
898394,0,0,0,4,12,16,40.698832,-73.825365,11418
891819,0,0,0,4,12,16,40.854398,-73.915216,10453
900030,0,0,0,0,10,10,40.862614,-73.924902,10034
913400,0,0,0,75,0,75,40.815344,-73.955176,10027
904298,0,0,0,4,12,16,40.860977,-73.904649,10468
904077,0,0,0,4,12,16,40.871034,-73.900211,10468
891163,0,0,0,4,12,16,40.775624,-72.866055,11967
889409,0,0,0,4,12,16,40.725757,-73.857836,11374
905653,0,0,0,4,12,16,40.666196,-73.430428,11758
886305,0,12,16,15,0,43,43.320005,-77.927866,14464
902200,0,0,0,4,12,16,43.064272,-76.153786,13208
906267,0,0,0,4,12,16,43.067661,-76.146776,13208
903558,0,0,0,2,6,8,42.874677,-73.781988,12065
896178,0,0,0,2,6,8,41.920248,-74.56337,12725
911512,0,0,0,2,6,8,40.805192,-72.85789,11950
888039,0,0,0,4,12,16,40.833833,-73.869915,10472
908409,0,0,0,4,12,16,40.97723,-73.716013,10528
897545,0,0,0,4,12,16,42.933976,-78.810259,14215
913590,0,0,0,4,12,16,40.86709,-73.066093,11720
909973,0,0,0,50,0,50,40.680501,-73.910331,11233
903015,0,0,0,4,12,16,40.601033,-73.943778,11229
921752,0,0,0,4,12,16,42.973096,-74.350803,12095
911813,0,0,0,16,0,16,40.586221,-73.946502,11235
887961,0,0,0,4,12,16,40.753449,-73.567806,11590
903335,0,0,0,4,12,16,43.169215,-77.617003,14605
883862,31,24,32,0,0,87,43.057368,-76.233658,13219
893066,0,0,0,2,6,8,40.733179,-73.369851,11704
889800,0,0,0,4,12,16,43.487755,-73.770401,12885
885239,0,0,0,2,12,14,40.810049,-73.851039,10473
894498,0,0,0,2,10,12,40.793265,-73.20093,11722
919795,0,0,0,4,12,16,40.85913,-73.90549,10468
899540,0,0,18,0,0,18,42.904364,-78.85327,14208
907561,0,0,0,103,0,103,40.749755,-73.721861,11426
890887,0,0,0,64,0,64,40.756193,-73.789458,11358
885791,0,0,0,4,12,16,40.738593,-73.859827,11368
893849,0,0,0,4,12,16,40.704398,-73.88788,11385
902279,0,0,0,15,0,15,40.665738,-73.885532,11207
903113,0,0,0,2,6,8,41.619349,-74.066097,12589
904683,0,0,224,0,0,224,41.277701,-73.788814,10598
919148,0,0,0,4,12,16,40.625752,-74.163875,10303
926067,0,0,0,0,10,10,40.6357,-74.1167,10310
904346,0,0,0,4,12,16,40.848129,-73.935989,10033
905555,0,0,0,4,12,16,40.883384,-73.901687,10463
905964,0,0,0,4,12,16,40.697761,-73.591069,11553
894102,0,0,0,4,12,16,41.223319,-73.99689,10980
884642,0,0,0,4,12,16,40.822248,-73.876532,10473
907066,0,0,0,2,6,8,42.094063,-75.868853,13903
885920,0,0,0,2,6,8,40.650629,-73.929445,11203
896553,24,52,63,0,0,139,40.738819,-73.234546,11706
892648,0,0,0,0,12,12,40.867188,-73.893912,10468
888776,0,0,0,4,12,16,40.830666,-73.850038,10462
899782,0,0,0,2,6,8,42.098533,-76.824701,14901
904135,0,0,0,0,10,10,40.857141,-73.899726,10458
890204,0,0,0,4,12,16,40.708,-73.4829,11783
898376,0,0,0,4,12,16,40.655493,-73.708232,11581
901109,0,0,0,4,12,16,40.644067,-74.010386,11220
906357,0,0,0,2,12,14,40.829264,-73.918602,10456
908690,0,0,0,110,0,110,40.719618,-73.977504,10002
910764,0,0,0,2,6,8,40.803946,-73.256069,11717
887134,0,0,0,2,12,14,40.825334,-73.878613,10472
886066,0,0,0,4,12,16,40.779862,-72.8612,11967
900534,0,0,0,4,12,16,40.831743,-73.928904,10452
895830,0,0,0,30,0,30,42.064642,-76.044753,13850
899229,0,0,0,4,12,16,40.865346,-73.896198,10468
902698,0,0,0,4,12,16,40.7227,-73.81762,11367
907177,0,0,0,4,12,16,40.847753,-73.893754,10457
900141,0,0,0,171,0,171,40.688009,-73.799964,11435
921033,0,0,0,2,6,8,41.539631,-73.97237,12590
904909,0,0,0,94,0,94,40.815667,-73.901769,10455
908921,0,0,0,2,6,8,43.214892,-75.463324,13440
918025,0,0,0,4,12,16,40.846384,-73.924807,10453
886976,0,0,0,4,12,16,40.844234,-73.936096,10033
891390,0,0,0,152,0,152,40.558924,-74.155164,10308
891168,0,0,0,2,10,12,40.834936,-73.920423,10452
886860,0,0,0,115,0,115,41.645252,-74.698517,12701
883412,0,0,0,4,12,16,40.649804,-73.915511,11236
892371,0,0,0,40,0,40,42.786515,-78.752344,14127
911211,0,0,0,4,12,16,40.74866,-73.319036,11729
892281,0,0,0,117,0,117,40.643096,-74.020884,11220
893641,0,0,0,4,12,16,40.611159,-74.071503,10305
884765,0,0,0,4,12,16,40.721976,-73.773664,11423
891177,0,0,0,4,12,16,43.019354,-76.144017,13205
885583,0,0,0,4,12,16,40.848237,-73.914401,10453
909549,0,0,0,129,0,129,40.755813,-73.830269,11355
884574,0,0,0,4,12,16,40.615191,-73.935595,11234
895246,0,0,0,61,0,61,40.651334,-73.913936,11236
905668,0,0,0,0,10,10,40.830096,-73.898176,10459
883370,0,0,0,4,12,16,40.734601,-73.850257,11375
898844,0,0,0,4,12,16,40.682292,-73.807463,11420
903934,0,0,0,0,10,10,41.717267,-73.863783,12603
897008,0,0,0,2,6,8,42.317904,-78.86916,14719
883550,0,0,0,4,12,16,40.959234,-73.866186,10710
899637,0,0,0,2,12,14,40.839387,-73.912974,10456
891010,0,0,51,0,0,51,42.709781,-78.013426,14530
917667,0,0,0,4,12,16,40.854839,-73.860508,10462
908746,0,0,0,4,12,16,40.687537,-73.868056,11208
915581,0,0,0,4,12,16,40.685376,-73.358518,11757
919078,0,0,0,4,12,16,42.824356,-78.069595,14591
899382,0,0,0,0,12,12,40.850041,-73.901968,10457
920332,0,0,0,4,12,16,40.72913,-73.259193,11706
896924,0,0,20,40,0,60,41.061099,-72.431964,11971
909808,0,0,0,4,12,16,40.724088,-73.73709,11428
913988,0,0,0,4,12,16,42.913005,-78.855549,14208
886819,0,0,0,0,8,8,40.838464,-73.917555,10452
921169,0,0,0,4,12,16,41.190291,-74.027489,10970
901985,0,0,0,2,6,8,42.175518,-76.843768,14845
912239,0,0,0,4,12,16,40.715276,-73.588689,11553
911482,0,0,0,4,12,16,40.859155,-73.929312,10040
884978,0,0,0,4,12,16,40.868732,-73.852611,10469
903142,0,0,0,4,12,16,40.857449,-73.895557,10458
896127,0,0,0,47,0,47,40.644907,-73.954569,11226
902987,0,0,0,4,12,16,40.866522,-73.89276,10458
898612,0,0,0,2,6,8,43.142975,-77.630028,14611
884883,0,0,0,2,6,8,41.702835,-73.91698,12601
918614,0,0,0,4,12,16,40.846242,-73.904846,10457
883211,0,0,0,4,12,16,40.653512,-73.686231,11563
894338,0,0,0,4,12,16,42.930718,-78.824501,14215
900099,0,0,0,4,12,16,40.838139,-73.84817,10461
886912,0,0,0,44,0,44,43.012107,-78.8058,14228
915948,0,0,0,10,0,10,43.103451,-74.777638,13329
895557,0,0,0,4,12,16,42.674757,-73.823138,12203
890712,0,0,0,139,0,139,40.589589,-73.805555,11693
903704,0,0,0,93,0,93,40.714833,-73.963129,11211
891486,0,0,0,4,12,16,40.837376,-73.924185,10452
900943,0,0,0,4,12,16,42.821745,-73.924371,12308
885676,0,0,0,4,12,16,42.827757,-73.897033,12309
920809,0,0,0,4,12,16,40.729505,-73.821921,11367
911755,0,0,0,4,12,16,40.862894,-73.893181,10458
891475,0,0,0,2,6,8,43.168386,-77.542731,14609
898015,0,0,0,40,0,40,40.787042,-73.193513,11722
916885,0,0,0,2,6,8,43.238146,-77.648819,14616
886543,0,0,0,2,6,8,42.77604,-73.932562,12303
888535,0,0,0,4,12,16,40.874737,-73.880275,10467
915128,16,26,0,0,0,42,41.447242,-74.39763,10940
889993,0,0,0,4,12,16,40.722015,-73.817338,11367
920436,0,0,0,4,12,16,40.74177,-73.267825,11706
916375,0,0,0,4,12,16,40.83354,-73.941327,10032
888099,0,0,0,166,0,166,40.624694,-74.005235,11219
918353,0,0,0,4,10,14,40.693324,-73.361263,11757
916056,0,0,0,4,12,16,40.700235,-73.318686,11702
910202,0,0,0,2,6,8,40.812498,-73.915136,10455
914747,8,10,17,0,0,35,42.977362,-78.815211,14226
885953,0,0,0,20,0,20,42.689809,-73.36587,12022
897496,0,0,0,48,0,48,40.71397,-73.844372,11375
901852,0,0,0,4,12,16,40.660253,-73.575985,11520
885186,0,0,0,325,0,325,44.363988,-75.20119,13652
911611,0,0,0,4,12,16,40.669255,-73.58834,11520
912074,0,11,9,5,0,25,42.873882,-78.82527,14206
886174,0,0,0,168,0,168,42.901797,-73.698782,12118
884093,0,0,0,2,6,8,42.800305,-73.932773,12307
918547,0,0,0,4,12,16,41.615918,-74.23572,12589
885421,0,0,0,4,12,16,42.794413,-73.949068,12303
885445,0,0,0,4,12,16,40.83466,-73.030061,11738
883054,24,22,39,30,0,115,42.958688,-78.715431,14221
885867,0,0,0,4,12,16,40.701084,-73.422142,11701
905350,0,0,0,4,12,16,40.649988,-73.593197,11520
884282,0,0,0,117,0,117,40.823214,-73.897065,10459
892078,0,0,0,4,12,16,40.615507,-73.992096,11204
890888,0,0,0,102,0,102,40.697431,-73.74061,11411
902998,0,0,0,4,12,16,40.682752,-73.980561,11217
884440,0,0,0,4,12,16,40.712283,-73.630646,11550
896724,0,0,0,113,0,113,40.848946,-73.696366,11050
896215,0,0,0,4,12,16,40.709992,-73.70645,11003
886282,0,0,0,0,10,10,40.84155,-73.920721,10452
901441,0,0,0,0,10,10,40.628474,-74.075742,10304
898204,0,0,0,0,12,12,40.817581,-73.814671,10465
900008,0,0,0,98,0,98,42.339068,-75.167126,13775
921866,0,0,0,50,0,50,43.323635,-76.404782,13069
905183,0,0,0,4,12,16,40.842319,-73.912583,10452
918738,0,0,0,2,8,10,40.837183,-73.903167,10456
917912,0,0,0,75,0,75,42.667536,-73.790364,12203
921843,0,0,0,4,12,16,40.687206,-73.472837,11758
887607,0,0,0,4,12,16,40.72614,-73.824253,11367
885654,0,0,0,4,12,16,40.703004,-73.731752,11429
886422,0,0,0,4,12,16,40.870023,-73.885065,10458
883823,0,0,0,67,0,67,43.053545,-76.171532,13204
890937,0,0,0,2,12,14,40.831597,-73.901226,10456
916565,0,0,0,4,12,16,41.646284,-73.931094,12601
885031,0,0,0,4,12,16,44.034695,-75.719496,13619
911595,0,0,0,2,6,8,40.819975,-73.91938,10451
887046,0,0,0,4,12,16,40.849379,-73.898743,10457
896464,0,0,0,4,12,16,43.156951,-78.699706,14094
900293,21,20,31,0,0,72,41.02585,-73.791364,10530
903904,0,0,0,4,12,16,40.696656,-73.419898,11701
909350,0,0,0,2,6,8,40.849564,-73.887921,10457
898981,0,0,0,4,12,16,40.758102,-73.889816,11370
911011,0,0,0,4,12,16,40.643274,-73.959464,11212
894624,0,0,0,4,12,16,43.162279,-77.568234,14609
891760,0,0,0,4,12,16,40.671383,-73.992926,11215
887354,0,0,0,200,0,200,40.739241,-73.882521,11373
920498,0,0,0,2,6,8,40.8666,-73.902032,10468
897156,0,0,0,150,0,150,40.826279,-73.947062,10031
890458,0,0,0,180,0,180,42.254789,-73.77874,12534
907514,0,0,0,80,0,80,40.793044,-73.204986,11722
893195,0,0,0,4,12,16,40.736682,-73.367206,11704
901208,8,10,54,0,0,72,43.310187,-76.401335,13069
889258,0,0,0,23,0,23,40.690839,-73.916228,11221
906922,0,0,0,2,6,8,43.065211,-76.140809,13203
892977,0,0,0,4,12,16,40.636776,-73.981697,11218
914122,0,0,0,2,12,14,40.805916,-73.927028,10454
895920,0,0,0,4,12,16,40.806091,-73.920551,10454
900420,0,0,0,2,6,8,43.068393,-76.150791,13208
886799,0,0,0,80,0,80,41.461355,-74.421122,10940
894900,0,0,0,2,6,8,43.030828,-77.717907,14586
913555,0,0,0,4,12,16,40.645746,-73.597925,11520
904046,0,0,0,2,6,8,42.697878,-73.697648,12180
907405,0,0,0,4,12,16,40.764163,-73.864039,11369
918485,0,0,0,124,0,124,40.737748,-73.756612,11364
911148,0,0,0,2,6,8,41.207954,-73.976804,10993
916833,0,0,0,4,12,16,43.186063,-77.545776,14609
919951,0,0,0,0,10,10,40.840125,-73.911877,10457
902182,0,0,0,4,12,16,40.808926,-73.927367,10454
914832,0,0,0,40,0,40,42.159746,-77.089478,14870
891100,0,10,30,7,0,47,41.054588,-74.019214,10965
905598,0,0,0,0,12,12,40.839803,-73.91591,10452
892336,0,0,0,4,12,16,40.860775,-73.907733,10468
888957,7,17,17,0,0,41,41.208716,-73.99216,10923
912008,0,0,0,4,12,16,40.860408,-73.839748,10469
897978,0,0,0,4,12,16,40.828745,-73.850096,10472
923961,0,0,0,45,0,45,43.010328,-78.893665,14150
909949,0,0,0,25,0,25,40.781151,-73.945305,10128
919897,0,0,0,2,6,8,40.775629,-73.209355,11722
887911,15,24,44,22,0,105,42.444957,-75.079148,13820
903583,0,0,0,4,12,16,40.64167,-73.997372,11219
889546,0,0,0,2,6,8,40.830466,-73.922297,10452
889850,0,0,0,0,6,6,40.743641,-74.003633,10011
906720,6,13,9,22,0,50,43.164065,-77.601239,14605
910554,16,34,0,0,0,50,42.862586,-73.794394,12065
894537,0,0,0,4,12,16,43.190272,-77.557655,14609
914973,0,0,0,4,12,16,40.760382,-73.223145,11717
920969,0,0,0,4,12,16,40.739941,-73.777016,11365
892306,0,0,0,40,0,40,43.07449,-78.188994,14058
903339,0,0,0,57,0,57,40.823783,-73.899186,10459
896545,0,0,0,2,6,8,43.031636,-76.158936,13207
903845,0,0,0,0,12,12,41.012787,-73.760561,10605
899531,16,24,31,25,0,96,43.210512,-77.59685,14617
883996,0,0,0,4,12,16,40.848916,-73.91355,10453
910281,0,0,0,1,6,7,40.82017,-73.876567,10473
911883,0,0,0,4,12,16,40.690877,-73.82084,11419
890802,0,0,21,0,0,21,40.763902,-72.850121,11951
885766,0,0,0,4,12,16,40.634458,-74.005054,11219
891660,0,0,0,2,12,14,40.807339,-73.956712,10026
900749,0,0,0,2,6,8,42.824332,-75.588188,13346
909020,0,0,0,4,12,16,40.87564,-73.857739,10469
892140,0,0,0,4,12,16,40.843501,-73.906894,10457
886881,0,0,0,2,12,14,40.838075,-73.888526,10460
893582,0,0,0,4,12,16,40.860329,-73.905708,10468
902523,0,0,0,4,12,16,40.854083,-73.914708,10453
886761,0,0,22,0,0,22,42.262506,-73.81769,12051
888848,8,10,12,13,0,43,43.163263,-77.641468,14606
906821,0,0,0,175,0,175,40.637164,-73.936885,11210
891242,0,0,0,70,0,70,40.790192,-73.645709,11577
889911,0,0,0,4,12,16,40.699419,-73.536004,11710
917339,0,0,0,4,12,16,40.667205,-73.931953,11213
890067,0,0,0,4,12,16,42.639843,-73.779486,12209
895404,0,0,0,4,12,16,40.749869,-73.858124,11368
908471,0,0,0,4,12,16,40.799293,-73.184772,11722
905782,0,0,0,4,12,16,43.166792,-77.560117,14609
904414,0,0,0,4,12,16,40.82159,-73.900636,10459
904974,0,0,0,2,6,8,40.818175,-73.903399,10455
918937,0,0,0,4,12,16,40.657661,-73.84607,11414
912175,0,0,0,4,12,16,40.808362,-73.914248,10454
896620,0,0,0,4,12,16,40.714918,-73.584679,11553
911342,0,0,0,4,12,16,40.82718,-73.897989,10459
887267,0,0,0,4,12,16,40.816901,-73.858308,10473
915893,0,0,0,4,12,16,40.841426,-73.855757,10462
901566,0,0,0,4,12,16,44.534187,-74.975548,13625
902928,0,0,0,2,6,8,41.615918,-74.23572,12589
886207,0,0,0,4,12,16,40.917135,-73.90026,10705
893982,0,0,18,0,0,18,41.3923,-74.322241,10924
914808,0,0,0,4,12,16,40.875308,-73.608928,11560
901531,0,0,0,4,12,16,40.640948,-73.940609,11203
895681,0,0,0,2,6,8,43.184215,-77.570348,14609
914159,0,0,0,2,6,8,42.161852,-76.818098,14845
907596,0,0,0,34,0,34,40.744274,-73.911743,11377
921574,0,0,0,2,12,14,40.823101,-73.894632,10459
895720,0,0,0,2,6,8,43.141452,-77.656032,14619
888199,0,0,0,30,0,30,40.63688,-73.582754,11520
894352,0,0,0,4,12,16,40.866679,-73.896731,10468
886925,0,40,39,0,0,79,40.878102,-73.435249,11743
915077,0,0,0,39,0,39,40.641065,-73.965579,11226
912087,0,0,0,4,12,16,44.295221,-75.401508,13642
898691,0,0,0,4,12,16,40.850207,-73.900501,10457
891430,0,0,0,4,12,16,40.626442,-73.936564,11210
912768,0,0,0,2,6,8,40.915098,-73.823011,10553
909741,0,0,0,4,12,16,40.77275,-73.224904,11729
913366,0,0,0,4,12,16,40.735351,-73.897678,11377
921986,0,0,0,85,0,85,43.190764,-77.551491,14609
896951,0,0,0,85,0,85,40.678904,-73.976589,11217
922506,0,0,0,2,6,8,43.09685,-76.146744,13211
908225,0,0,0,4,12,16,40.75972,-73.221352,11717
898779,0,0,0,2,6,8,43.061858,-76.119833,13206
918895,0,0,0,2,6,8,40.815516,-73.90054,10455
888474,0,0,0,4,12,16,41.310753,-74.175007,10950
896901,0,0,0,0,12,12,40.85624,-73.884698,10458
899260,0,0,0,4,12,16,40.705278,-73.60961,11550
906016,0,0,0,4,12,16,40.658702,-73.892727,11207
892783,0,0,0,4,12,16,42.078415,-77.22308,14801
887875,6,12,19,0,0,37,40.71064,-73.502688,11756
908003,0,0,0,4,12,16,40.62323,-73.93541,11234
902923,0,0,0,0,12,12,42.38873,-76.482829,14850
889115,0,0,0,230,0,230,43.987329,-75.646299,13619
898861,0,0,0,2,12,14,40.863025,-73.895106,10458
896683,0,0,0,4,12,16,40.848901,-73.914713,10453
887239,0,0,0,2,6,8,41.006108,-73.666142,10573
909488,0,0,0,4,12,16,40.643738,-74.091477,10301
917592,0,0,0,4,12,16,40.663133,-73.990053,11215
891924,0,0,148,0,0,148,40.898533,-73.80227,10803
920722,8,10,15,18,0,51,43.052421,-78.844973,14120
892600,0,0,0,136,0,136,40.741005,-73.88161,11373
898247,0,0,0,4,12,16,40.660318,-73.594437,11520
902404,0,0,0,4,12,16,40.828227,-73.894377,10459
917341,0,0,0,4,12,16,40.637708,-73.998283,11219
889864,0,0,0,4,12,16,40.819858,-73.864254,10473
914779,0,0,0,4,12,16,42.666342,-74.235269,12157
891056,32,44,60,0,0,136,40.777624,-73.0384,11772
908588,0,0,0,4,12,16,40.817437,-73.814634,10465
919405,0,0,20,20,0,40,42.405988,-78.609393,14171
884340,0,0,0,2,6,8,43.143276,-77.648364,14619
883520,0,0,0,4,12,16,40.870888,-73.905586,10463
883185,0,0,0,2,6,8,43.017099,-76.128962,13210
921484,0,0,0,2,6,8,44.656467,-73.557517,12962
902438,0,0,0,4,12,16,43.190776,-77.694624,14626
884714,0,0,0,4,12,16,40.709672,-73.389658,11757
885111,0,0,0,4,12,16,40.947517,-73.868046,10701
908952,0,0,0,2,6,8,41.173738,-73.843747,10562
891347,0,0,0,4,12,16,40.714411,-73.611862,11550
900427,0,0,0,4,12,16,40.63271,-74.000106,11219
883678,0,0,0,4,12,16,40.841063,-73.886341,10460
899407,0,0,0,4,12,16,40.760163,-73.57802,11590
910800,0,0,0,0,12,12,40.846975,-73.895217,10457
892538,0,0,0,0,10,10,40.825321,-73.918298,10451
883621,0,12,33,0,0,45,40.816789,-73.500951,11791
902023,0,0,0,2,6,8,40.79656,-73.947532,10029
897401,0,0,0,4,12,16,40.637591,-73.998151,11219
892699,0,0,0,4,12,16,40.850589,-73.862225,10462
884851,0,0,0,4,12,16,40.691986,-73.408873,11726
896101,0,0,0,4,12,16,40.752135,-73.578279,11590
915304,0,0,0,4,12,16,40.891269,-73.834692,10466
915708,0,0,0,4,12,16,40.704553,-73.961388,11211
885703,0,0,0,2,6,8,40.767425,-73.358539,11798
902252,0,0,0,20,0,20,41.502388,-73.976387,12508
919413,0,0,0,4,12,16,40.769698,-73.567625,11590
889490,0,0,0,4,12,16,41.450222,-74.5215,10940
908224,0,0,18,0,0,18,41.09145,-73.931335,10960
902086,0,0,0,4,12,16,40.836142,-73.927902,10452
910935,0,0,0,4,12,16,40.831827,-73.943244,10032
920787,0,0,0,4,12,16,40.685421,-73.778969,11434
887108,0,0,0,2,6,8,42.780186,-74.019649,12306
891536,0,0,0,90,0,90,43.169637,-77.571889,14609
898288,0,0,0,60,0,60,40.790044,-73.942648,10029
897035,0,0,0,4,12,16,40.83535,-73.922553,10452
906061,0,0,0,60,0,60,40.650136,-73.717938,11581
899590,0,0,0,4,12,16,40.788307,-73.218479,11722
893899,0,0,0,30,0,30,42.780104,-73.957875,12306
887569,0,0,0,4,12,16,40.848667,-73.904162,10457
907035,0,0,0,2,6,8,42.186844,-76.807097,14845
886501,0,0,0,4,12,16,40.668818,-73.583864,11520
888587,0,0,0,4,12,16,43.170269,-77.575541,14609
904546,0,0,0,0,12,12,40.639068,-73.596547,11520
918623,0,0,0,4,12,16,40.92484,-72.657294,11901
883986,0,0,0,2,6,8,42.105316,-75.883252,13904
884105,8,36,78,0,0,122,40.981049,-73.724984,10528
921228,0,0,0,0,12,12,40.640696,-73.998748,11219
896388,0,0,0,4,12,16,40.66877,-73.87595,11208
885527,8,12,8,35,0,63,42.914082,-78.855634,14208
885337,0,0,0,4,12,16,43.129957,-75.487174,13440
899508,0,0,0,4,12,16,41.808051,-74.745254,12754
920470,0,0,0,4,12,16,40.837712,-73.88671,10460
921289,0,0,0,4,12,16,40.642713,-73.990036,11218
911659,0,0,0,2,6,8,42.791896,-73.9206,12304
886083,0,0,0,4,12,16,40.820114,-73.920535,10451
887457,0,0,0,4,12,16,40.892884,-73.045471,11784
910633,0,0,0,4,12,16,40.63783,-74.000161,11219
913105,0,0,0,4,12,16,40.612857,-74.086945,10304
910211,0,0,0,131,0,131,41.009027,-73.672897,10573
890902,0,0,0,4,12,16,40.679599,-73.869666,11208
920146,0,0,0,2,6,8,43.508429,-76.26284,13114
922056,0,0,0,70,0,70,40.806978,-72.996659,11763
920310,0,0,0,4,12,16,40.831159,-73.850485,10462
896272,0,0,0,4,12,16,40.864129,-73.870167,10467
886218,0,0,0,4,12,16,42.838279,-78.796899,14220
884257,0,0,0,4,12,16,40.697167,-73.66238,11552
906525,0,0,0,4,12,16,40.873171,-73.84623,10469
899946,0,0,0,4,12,16,40.942769,-73.897241,10701
917184,0,0,0,183,0,183,40.798422,-73.949397,10026
887319,0,0,0,4,12,16,43.07778,-76.133414,13208
902612,0,0,0,4,12,16,40.852425,-73.90239,10457
896755,0,0,0,4,12,16,44.701857,-75.476641,13669
892210,0,0,0,4,12,16,40.714224,-73.591573,11553
902754,0,0,0,188,0,188,40.608192,-73.764897,11691
909164,0,0,0,0,9,9,40.672227,-73.725318,11580
913144,0,0,0,2,6,8,42.694622,-73.81188,12205
923584,0,20,15,0,0,35,42.979945,-78.824518,14223
886357,0,0,0,4,12,16,40.712241,-73.591885,11553
883880,0,0,0,4,12,16,40.606784,-74.114892,10314
892193,0,0,0,2,6,8,40.737082,-73.687002,11040
902622,0,0,0,4,12,16,40.89402,-73.830615,10550
916995,0,0,0,4,12,16,40.625386,-73.977385,11204
918158,0,0,0,4,12,16,40.704278,-73.783872,11433
892716,0,0,0,0,12,12,40.855195,-73.90815,10453
892096,0,0,0,4,12,16,40.694999,-73.40815,11701
915517,8,12,16,0,0,36,44.158098,-75.320849,13648
905417,0,0,0,4,12,16,43.848936,-74.419829,12812
900716,0,0,0,2,6,8,40.865881,-73.855591,10469
900163,0,0,0,4,12,16,40.721021,-73.374155,11704
913227,0,0,0,4,12,16,40.761715,-73.781195,11361
894732,0,0,0,2,6,8,41.937856,-74.033553,12401
919551,0,0,0,4,12,16,40.602997,-73.987662,11214
886017,0,0,0,2,6,8,42.913591,-78.817001,14211
910845,0,0,0,4,12,16,40.665497,-73.957233,11225
897786,0,0,0,4,12,16,40.67798,-73.608706,11510
889235,0,0,0,4,12,16,40.884343,-73.865657,10467
914547,16,24,21,21,0,82,40.75937,-73.621005,11568
899061,0,0,0,4,12,16,40.869248,-73.884139,10458
888005,0,12,8,86,0,106,42.158261,-77.094359,14870
903330,0,0,0,2,6,8,40.803111,-73.253964,11717
912983,0,0,0,2,6,8,41.137545,-74.020343,10956
912520,0,0,0,2,6,8,42.883653,-77.290598,14424
907654,0,0,0,1,6,7,40.856402,-73.895291,10458
903781,0,0,56,0,0,56,40.837245,-73.708059,11050
885240,0,0,0,4,12,16,40.842663,-73.911757,10457
907700,0,0,0,2,6,8,40.766448,-73.224422,11717
905722,0,0,0,4,12,16,43.102364,-76.195031,13090
898155,0,0,0,4,12,16,40.828599,-73.395916,11746
893047,0,0,0,4,12,16,42.944784,-78.818761,14215
906288,0,0,0,4,12,16,40.88311,-73.848318,10466
888084,0,0,0,4,12,16,40.694895,-73.856258,11421
897247,0,0,0,0,10,10,40.637785,-74.130433,10302
889013,0,0,36,34,0,70,43.00097,-76.195643,13215
920007,0,0,0,4,12,16,40.683521,-73.878065,11208
909894,0,0,0,4,12,16,40.672779,-73.779414,11434
901049,0,0,0,4,12,16,40.659596,-73.989264,11215
902343,0,0,0,0,12,12,40.905237,-73.853263,10470
890268,15,23,0,0,0,38,40.915592,-73.8734,10704
889335,0,0,0,124,0,124,40.667791,-73.897867,11207
907871,0,0,0,4,12,16,43.146984,-76.394373,13027
915052,0,0,0,4,12,16,40.656261,-73.924228,11203
924075,0,0,0,50,0,50,40.920547,-72.664558,11901
918370,0,0,0,4,12,16,40.845357,-73.908546,10457
905042,0,0,0,2,6,8,40.634429,-73.638864,11572
912543,0,0,0,4,12,16,40.836797,-73.918267,10452
906791,0,0,0,4,12,16,40.842716,-73.892266,10457
887490,0,0,0,4,12,16,43.170177,-76.149389,13041
893483,0,0,0,160,0,160,40.710428,-73.812314,11435
914497,0,0,0,2,6,8,42.230297,-77.191763,14821
916859,16,23,0,0,0,39,41.7594,-74.597681,12788
905273,0,0,0,0,10,10,40.829817,-73.920656,10451
894974,0,0,0,0,12,12,40.856617,-73.864069,10462
897625,0,0,0,4,12,16,40.85598,-73.863949,10462
901404,0,0,0,4,12,16,40.633533,-73.958147,11230
904170,0,0,0,4,12,16,40.879723,-73.872264,10467
885292,0,0,0,4,12,16,40.664531,-73.587291,11520
904027,0,0,0,4,12,16,40.871714,-73.885094,10458
921771,0,0,0,4,12,16,40.854563,-73.908053,10453
888429,0,0,0,278,0,278,40.913396,-73.890499,10705
897849,0,0,0,4,12,16,40.65342,-73.876748,11239
914994,0,0,0,4,12,16,40.797308,-73.947025,10029
908060,0,0,0,2,12,14,40.854927,-73.901994,10453
887527,0,0,0,2,12,14,40.867641,-73.86332,10467
887205,0,0,0,4,12,16,40.757624,-73.797913,11358
893271,0,0,0,2,6,8,40.746774,-73.295467,11706
886483,0,0,0,2,6,8,40.74715,-73.906551,11377
918131,0,0,0,4,12,16,42.644768,-73.756549,12202
889721,0,0,0,4,12,16,40.642242,-74.004336,11220
885361,0,0,0,2,6,8,40.832971,-73.855365,10462
902327,0,0,0,4,12,16,40.900766,-73.833163,10550
914331,0,0,0,4,12,16,40.826711,-73.948787,10031
914910,0,0,0,4,12,16,40.760894,-73.862078,11369
922023,0,0,0,44,0,44,40.882985,-73.587355,11560
891629,0,0,0,4,12,16,40.742571,-73.369221,11798
905105,0,0,0,4,12,16,41.187707,-74.054764,10970
884047,0,0,0,2,6,8,40.825314,-73.882039,10472
910353,0,0,0,2,6,8,40.833117,-73.876542,10472
892735,0,0,0,4,12,16,40.854317,-73.864996,10462
897263,0,0,0,0,10,10,40.69694,-73.977121,11205
901966,0,0,0,4,12,16,40.910754,-73.893528,10705
892455,0,0,0,4,12,16,40.628144,-74.156228,10303
911779,0,0,0,4,12,16,40.674386,-73.791128,11436
